OPE ID,School,State,Zip Code,School Type,20152016Qtr2_Dependent Students,20152016Qtr2_Independent Students,Quarterly Total,YTD_20152016Qtr2_Dependent Students,YTD_20152016Qtr2_Independent Students,Award Year To Date Total
00100200,ALABAMA AGRCLTL & MECHL UNIV            ,AL,35762-1357,Public       ,1676,1164,2840,5376,2379,7755
00100300,FAULKNER UNIVERSITY                     ,AL,36109-3398,Private      ,436,1354,1790,1653,2526,4179
00100400,UNIVERSITY OF MONTEVALLO                ,AL,35115-6000,Public       ,735,463,1198,2177,946,3123
00100500,ALABAMA STATE UNIVERSITY                ,AL,36101-0000,Public       ,2191,1623,3814,7420,3463,10883
00100700,CENTRAL ALABAMA COMMUNITY COLLEGE       ,AL,35011-0000,Public       ,304,462,766,974,880,1854
00100800,ATHENS STATE UNIVERSITY                 ,AL,35611-1999,Public       ,354,1205,1559,683,2054,2737
00100900,AUBURN UNIVERSITY                       ,AL,36849-5113,Public       ,3202,2096,5298,17338,5050,22388
00101200,BIRMINGHAM SOUTHERN COLLEGE             ,AL,35254-0002,Private      ,342,202,544,2089,475,2564
00101300,CALHOUN COMMUNITY COLLEGE               ,AL,35609-0000,Public       ,1769,2481,4250,3577,4187,7764
00101500,ENTERPRISE STATE COMMUNITY COLLEGE      ,AL,36331-1300,Public       ,314,412,726,771,723,1494
00101600,UNIVERSITY OF NORTH ALABAMA             ,AL,35632-0001,Public       ,1806,1085,2891,4531,1934,6465
00101700,GADSDEN STATE COMMUNITY COLLEGE         ,AL,35903-2269,Public       ,880,1498,2378,2091,2686,4777
00101800,GEORGE C WALLACE COMMUNITY COLLEGE      ,AL,36303-0943,Public       ,705,1344,2049,1694,2337,4031
00101900,HUNTINGDON COLLEGE                      ,AL,36106-2148,Private      ,469,264,733,1300,482,1782
00102000,JACKSONVILLE STATE UNIVERSITY           ,AL,36265-1602,Public       ,2051,1782,3833,5546,3263,8809
00102100,JEFFERSON DAVIS COMMUNITY COLLEGE       ,AL,36427-2790,Public       ,224,234,458,429,434,863
00102200,JEFFERSON STATE COMMUNITY COLLEGE       ,AL,35215-3098,Public       ,1756,2562,4318,3404,4623,8027
00102300,JUDSON COLLEGE                          ,AL,36756-2504,Private      ,111,45,156,279,101,380
00102400,UNIVERSITY OF WEST ALABAMA              ,AL,35470-0000,Public       ,775,1197,1972,2101,2169,4270
00102600,MARION MILITARY INSTITUTE               ,AL,36756-3214,Public       ,179,24,203,472,53,525
00102800,MILES COLLEGE                           ,AL,35064-2697,Private      ,788,376,1164,2051,757,2808
00102900,UNIVERSITY OF MOBILE                    ,AL,36613-0000,Private      ,622,624,1246,1475,1132,2607
00103000,BISHOP STATE COMMUNITY COLLEGE          ,AL,36603-5898,Public       ,789,1444,2233,1451,2527,3978
00103100,NORTHEAST ALABAMA STATE CMNTY COLG      ,AL,35986-0159,Public       ,419,473,892,782,754,1536
00103300,OAKWOOD COLLEGE                         ,AL,35896-0001,Private      ,552,349,901,1386,659,2045
00103400,ALABAMA SOUTHERN COMMUNITY COLLEGE      ,AL,36460-5698,Public       ,417,294,711,844,499,1343
00103600,SAMFORD UNIVERSITY                      ,AL,35229-7000,Private      ,601,1098,1699,3503,2226,5729
00103800,SNEAD STATE COMMUNITY COLLEGE           ,AL,35957-0734,Public       ,508,579,1087,1385,1082,2467
00104000,SOUTHERN UNION STATE COMMUNITY CLG      ,AL,36276-0000,Public       ,1204,1028,2232,2770,1977,4747
00104100,SPRING HILL COLLEGE                     ,AL,36608-1791,Private      ,501,256,757,2341,560,2901
00104400,STILLMAN COLLEGE                        ,AL,35403-0000,Private      ,515,229,744,1526,457,1983
00104600,TALLADEGA COLLEGE                       ,AL,35160-2354,Private      ,318,132,450,978,315,1293
00104700,TROY UNIVERSITY                         ,AL,36082-0001,Public       ,2616,5442,8058,7304,10216,17520
00105000,TUSKEGEE UNIVERSITY                     ,AL,36088-1645,Private      ,956,401,1357,4768,1154,5922
00105100,UNIVERSITY OF ALABAMA (THE)             ,AL,35487-0120,Public       ,5403,3561,8964,26015,7734,33749
00105200,UNIVERSITY OF ALABAMA AT BIRMINGHAM     ,AL,35294-1150,Public       ,3099,4592,7691,9421,8840,18261
00105500,UNIVERSITY OF ALABAMA IN HUNTSVILLE     ,AL,35899-0001,Public       ,1581,1621,3202,4529,2826,7355
00105700,UNIVERSITY OF SOUTH ALABAMA             ,AL,36688-0002,Public       ,3616,3884,7500,9114,7244,16358
00105900,LAWSON STATE COMMUNITY COLLEGE          ,AL,35221-1798,Public       ,779,1092,1871,1568,1896,3464
00105901,LAWSON STATE COMMUNITY COLLEGE - BESSEME,AL,35021-0308,Public       ,264,436,700,550,810,1360
00106000,FAULKNER STATE COMMUNITY COLLEGE        ,AL,36507-2698,Public       ,1440,1207,2647,2670,2157,4827
00526000,J.F. DRAKE STATE TECH COLLEGE           ,AL,35811-1584,Public       ,234,579,813,407,980,1387
00569100,SHELTON STATE COMMUNITY CLG             ,AL,35405-4017,Public       ,1171,1216,2387,2555,2140,4695
00569200,REID STATE TECHNICAL COLLEGE            ,AL,36401-0000,Public       ,88,213,301,142,324,466
00569700,NORTHWEST- SHOALS COMMUNITY COLLEGE     ,AL,35661-0000,Public       ,602,736,1338,1449,1209,2658
00569900,GEORGE C WALLACE STATE CMTY COLLEGE     ,AL,36703-0000,Public       ,359,501,860,670,885,1555
00573300,BEVILL STATE CMTY COLLEGE-WALKER        ,AL,35148-0000,Public       ,548,837,1385,1529,1594,3123
00573400,H. COUNCILL TRENHOLM STATE TECH COLLEGE ,AL,36108-0020,Public       ,288,598,886,489,1071,1560
00573401,H. C. TRENHOLM ST TECH COL-PATTERSON CAM,AL,36116-2612,Public       ,172,348,520,316,659,975
00787100,GEORGE C WALLACE STATE CMTY CLG         ,AL,35077-2000,Public       ,1561,1504,3065,2852,2448,5300
00831000,AUBURN UNIVERSITY-MONTGOMERY            ,AL,36124-0000,Public       ,1255,1396,2651,4119,2994,7113
00898800,LURLEEN B WALLACE COMMUNITY COLLEGE     ,AL,36420-0418,Public       ,268,351,619,779,636,1415
01055400,CONCORDIA COLLEGE                       ,AL,36701-3323,Private      ,308,154,462,619,276,895
01218200,CHATTAHOOCHEE VALLEY CMTY CLG           ,AL,36869-7917,Public       ,382,658,1040,773,1177,1950
01303906,SOUTH UNIVERSITY - MONTGOMERY           ,AL,36116-1120,Proprietary  ,102,520,622,206,890,1096
02170600,UNITED STATES SPORTS ACADEMY            ,AL,36526-7055,Private      ,6,203,209,22,380,402
02199700,HERITAGE CHRISTIAN UNIVERSITY           ,AL,35630-0000,Private      ,7,29,36,18,44,62
02270400,SOUTHEASTERN BIBLE COLLEGE              ,AL,35244-2083,Private      ,36,94,130,75,159,234
02285000,PAUL MITCHELL THE SCHOOL HUNTSVILLE     ,AL,35758-0000,Proprietary  ,31,56,87,50,107,157
02296000,PRINCE INSTITUTE OF PROFESSIONAL STUDIES,AL,36117-0000,Proprietary  ,6,40,46,14,82,96
02341000,FORTIS COLLEGE                          ,AL,36609-0000,Proprietary  ,245,856,1101,398,1479,1877
02503400,AMRIDGE UNIVERSITY                      ,AL,36124-0000,Private      ,24,296,320,62,553,615
03010600,VIRGINIA COLLEGE                        ,AL,35209-5154,Proprietary  ,1531,7736,9267,2221,12901,15122
03010602,VIRGINIA COLLEGE - HUNTSVILLE           ,AL,35801-5608,Proprietary  ,82,260,342,150,553,703
03010607,VIRGINIA COLLEGE - MOBILE               ,AL,36608-1626,Proprietary  ,56,216,272,109,448,557
03010616,VIRGINIA COLLEGE - MONTGOMERY           ,AL,36117-2802,Proprietary  ,86,290,376,172,607,779
03026516,REMINGTON COLLEGE - MOBILE              ,AL,36609-5593,Private      ,68,158,226,135,336,471
03032500,ALABAMA STATE CLG BARBER STYLING        ,AL,35215-0000,Proprietary  ,29,50,79,61,108,169
03361400,FORTIS COLLEGE                          ,AL,36535-0000,Proprietary  ,52,191,243,77,368,445
03459300,SOUTHEASTERN SCHOOL OF COSMETOLOGY      ,AL,35228-0000,Private      ,5,25,30,14,51,65
03709302,EDWARD VIA VIRGINIA COLLEGE OF OSTEOPATH,AL,36832-6330,Private      ,0,2,2,0,2,2
03783300,BLUE CLIFF CAREER COLLEGE               ,AL,63306-4749,Proprietary  ,20,95,115,37,164,201
03894300,HUNTSVILLE BIBLE COLLEGE                ,AL,35811-0000,Private      ,5,75,80,18,126,144
04066300,CARDIAC AND VASCULAR INSTITUTE OF ULTRAS,AL,36604-1411,Proprietary  ,23,92,115,43,158,201
04067300,SELMA UNIVERSITY                        ,AL,36701-0000,Private      ,71,92,163,134,222,356
04121500,COLUMBIA SOUTHERN UNIVERSITY            ,AL,36561-3815,Proprietary  ,214,6202,6416,404,11416,11820
04149200,XCELL ACADEMY-A PAUL MITCHELL PARTNER SC,AL,35216-4990,Proprietary  ,43,53,96,74,124,198
04187200,NEW BEGINNING COLLEGE OF COSMETOLOGY    ,AL,35950-2415,Proprietary  ,16,45,61,34,83,117
04187300,HAIR ACADEMY (THE)                      ,AL,36111-2201,Proprietary  ,17,38,55,34,78,112
04197500,UNIVERSITY ACADEMY OF HAIR DESIGN       ,AL,35476-3100,Proprietary  ,15,22,37,31,49,80
04211000,SALON PROFESSIONAL ACADEMY (THE)        ,AL,35816-1849,Proprietary  ,20,40,60,41,81,122
04217900,NUNATION SCHOOL OF COSMETOLOGY          ,AL,35064-2222,Proprietary  ,0,3,3,8,19,27
04226700,ALABAMA COLLEGE OF OSTEOPATHIC MEDICINE ,AL,36303-2251,Private      ,7,349,356,31,596,627
00111100,ALLAN HANCOCK COLLEGE                   ,CA,93454-6399,Public       ,1281,1974,3255,4068,3852,7920
00111300,ANTELOPE VALLEY COLLEGE                 ,CA,93536-5426,Public       ,1823,3479,5302,6348,7980,14328
00111600,ART CENTER COLLEGE OF DESIGN            ,CA,91103-1999,Private      ,202,239,441,1692,1174,2866
00111700,AZUSA PACIFIC UNIVERSITY                ,CA,91702-7000,Private      ,801,1988,2789,9487,6674,16161
00111800,BAKERSFIELD COLLEGE                     ,CA,93305-1299,Public       ,1872,3531,5403,10657,8857,19514
00111900,BARSTOW COMMUNITY COLLEGE               ,CA,92311-6608,Public       ,246,926,1172,894,2191,3085
00112000,AMER BAPT SEM OF THE WEST-BERKELEY      ,CA,94704-0000,Private      ,0,23,23,8,53,61
00112200,BIOLA UNIVERSITY                        ,CA,90639-0001,Private      ,600,586,1186,5613,1848,7461
00112300,BROOKS INSTITUTE                        ,CA,93103-1809,Proprietary  ,38,68,106,282,250,532
00112400,CABRILLO COLLEGE                        ,CA,95003-3194,Public       ,695,1235,1930,4061,3394,7455
00112500,CALIFORNIA BAPTIST UNIVERSITY           ,CA,92504-3297,Private      ,588,1451,2039,7498,5157,12655
00112700,CALIFORNIA COLLEGE OF THE ARTS          ,CA,94107-2206,Private      ,284,340,624,2054,1325,3379
00113100,CALIFORNIA INSTITUTE OF TECHNOLOGY      ,CA,91125-0001,Private      ,179,102,281,3632,551,4183
00113200,CALIFORNIA INSTITUTE OF THE ARTS        ,CA,91355-2397,Private      ,190,174,364,2537,1440,3977
00113300,CALIFORNIA LUTHERAN UNIVERSITY          ,CA,91360-2787,Private      ,329,477,806,4869,1360,6229
00113400,CALIFORNIA MARITIME ACADEMY             ,CA,94590-8181,Public       ,64,42,106,1198,365,1563
00113700,CALIF STATE UNIV-FULLERTON              ,CA,92831-3599,Public       ,2035,3300,5335,51874,21540,73414
00113800,"CALIFORNIA STATE UNIVERSITY, EAST BAY   ",CA,94542-3000,Public       ,793,2484,3277,17959,11961,29920
00113900,CALIF STATE UNIV-LONG BEACH             ,CA,90840-0006,Public       ,2086,3175,5261,59339,24179,83518
00114000,CALIF STATE UNIV-LOS ANGELES            ,CA,90032-4226,Public       ,1468,3339,4807,39459,21767,61226
00114100,"CALIF STATE UNIV, DOMINGUEZ HILLS       ",CA,90747-0001,Public       ,651,2328,2979,19548,14510,34058
00114200,CALIF STATE UNIV SAN BERNARDINO         ,CA,92407-2397,Public       ,1064,2366,3430,22579,12878,35457
00114300,CAL POLY STATE UNIVERSITY               ,CA,93407-0001,Public       ,934,465,1399,42467,4520,46987
00114400,CALIF STATE POLYTECHNIC UNIV POMONA     ,CA,91768-2500,Public       ,1024,1319,2343,38668,11904,50572
00114600,CALIF STATE UNIV - CHICO                ,CA,95929-0001,Public       ,1105,1113,2218,25179,6707,31886
00114700,CALIF STATE UNIV - FRESNO               ,CA,93740-8026,Public       ,1331,2250,3581,28695,12027,40722
00114900,HUMBOLDT STATE UNIVERSITY               ,CA,95521-8299,Public       ,498,605,1103,14258,4539,18797
00115000,CALIF STATE UNIV-SACRAMENTO             ,CA,95819-6044,Public       ,1653,2888,4541,35240,18763,54003
00115100,SAN DIEGO STATE UNIVERSITY              ,CA,92182-1690,Public       ,2626,3704,6330,60323,18798,79121
00115300,CALIF STATE UNIV-NORTHRIDGE             ,CA,91330-8307,Public       ,2180,3656,5836,47660,21677,69337
00115400,SAN FRANCISCO STATE UNIVERSITY          ,CA,94132-1740,Public       ,1604,2563,4167,39760,15972,55732
00115500,SAN JOSE STATE UNIVERSITY               ,CA,95192-0036,Public       ,1594,3087,4681,34631,15657,50288
00115600,SONOMA STATE UNIVERSITY                 ,CA,94928-3609,Public       ,599,615,1214,14328,3423,17751
00115700,CALIF STATE UNIV-STANISLAUS             ,CA,95382-0299,Public       ,469,992,1461,11042,5924,16966
00116100,CERRITOS COLLEGE                        ,CA,90650-6296,Public       ,2198,3203,5401,14289,9953,24242
00116200,CHABOT COLLEGE                          ,CA,94545-2400,Public       ,1229,2131,3360,5483,5110,10593
00116300,CHAFFEY COLLEGE                         ,CA,91737-9400,Public       ,2509,4160,6669,12577,10910,23487
00116400,CHAPMAN UNIVERSITY                      ,CA,92866-1099,Private      ,508,686,1194,11832,3880,15712
00116500,CHURCH DIV SCH OF THE PACIFIC           ,CA,94709-0000,Private      ,0,17,17,1,61,62
00116600,CITRUS COLLEGE                          ,CA,91741-1899,Public       ,1231,1571,2802,8090,5237,13327
00116900,CLAREMONT GRADUATE UNIVERSITY           ,CA,91711-0000,Private      ,3,367,370,27,1403,1430
00117000,CLAREMONT MCKENNA COLLEGE               ,CA,91711-6400,Private      ,94,23,117,3672,181,3853
00117100,HARVEY MUDD COLLEGE                     ,CA,91711-5990,Private      ,49,10,59,2718,85,2803
00117200,PITZER COLLEGE                          ,CA,91711-6101,Private      ,150,29,179,2572,173,2745
00117300,POMONA COLLEGE                          ,CA,91711-6301,Private      ,229,45,274,4599,245,4844
00117400,SCRIPPS COLLEGE                         ,CA,91711-3948,Private      ,112,17,129,1929,123,2052
00117600,WEST HILLS COMMUNITY COLLEGE            ,CA,93210-1399,Public       ,278,466,744,1357,977,2334
00117700,COGSWELL POLYTECHNICAL COLLEGE          ,CA,94089-1210,Proprietary  ,57,35,92,542,214,756
00117800,COLLEGE OF MARIN                        ,CA,94904-2590,Public       ,132,334,466,918,1226,2144
00117801,COLG OF MARIN-INDIAN VALLEY CMPS        ,CA,94949-0000,Public       ,40,127,167,293,410,703
00117900,NOTRE DAME DE NAMUR UNIVERSITY          ,CA,94002-1997,Private      ,102,293,395,1415,974,2389
00118100,COLLEGE OF SAN MATEO                    ,CA,94402-3784,Public       ,520,698,1218,2986,1952,4938
00118200,COLLEGE OF THE DESERT                   ,CA,92260-9305,Public       ,883,1633,2516,5152,4431,9583
00118300,HOLY NAMES UNIVERSITY                   ,CA,94619-1699,Private      ,82,217,299,853,685,1538
00118500,COLLEGE OF THE REDWOODS                 ,CA,95501-9300,Public       ,521,1071,1592,2168,2557,4725
00118600,COLLEGE OF THE SEQUOIAS                 ,CA,93277-2234,Public       ,1444,2080,3524,6272,5056,11328
00118700,COLLEGE OF THE SISKIYOUS                ,CA,96094-2899,Public       ,137,258,395,827,744,1571
00118701,COLLEGE OF THE SISKIYOUS - YREKA CENTER ,CA,96097-9538,Public       ,17,78,95,106,232,338
00119000,CONTRA COSTA COLLEGE                    ,CA,94806-3195,Public       ,398,864,1262,1976,2355,4331
00119100,DIABLO VALLEY COLLEGE                   ,CA,94523-1544,Public       ,991,1515,2506,5519,4398,9917
00119200,CUESTA COLLEGE                          ,CA,93403-8106,Public       ,760,1071,1831,3696,2748,6444
00119300,CYPRESS COLLEGE                         ,CA,90630-5897,Public       ,1254,1855,3109,9973,6556,16529
00119600,DOMINICAN UNIVERSITY OF CALIFORNIA      ,CA,94901-2298,Private      ,88,231,319,2460,992,3452
00119700,EL CAMINO COLLEGE                       ,CA,90506-0002,Public       ,2597,3458,6055,13708,9736,23444
00119701,COMPTON COMMUNITY COLLEGE               ,CA,90221-5393,Public       ,582,1349,1931,3070,3901,6971
00119900,FOOTHILL COLLEGE                        ,CA,94022-4597,Public       ,591,1255,1846,3458,3349,6807
00120000,FULLER THEOLOGICAL SEMINARY             ,CA,91182-0000,Private      ,3,352,355,12,1764,1776
00120100,FULLERTON COLLEGE                       ,CA,92832-2095,Public       ,1842,2130,3972,13381,7190,20571
00120200,GAVILAN COLLEGE                         ,CA,95020-9599,Public       ,517,695,1212,1651,1461,3112
00120300,GLENDALE COMMUNITY COLLEGE              ,CA,91208-2894,Public       ,1385,2080,3465,8366,6696,15062
00120500,GOLDEN GATE UNIVERSITY                  ,CA,94105-2967,Private      ,43,605,648,207,1955,2162
00120600,GOLDEN WEST COLLEGE                     ,CA,92647-2748,Public       ,1409,2057,3466,8242,5774,14016
00120700,GRADUATE THEOLOGICAL UNION              ,CA,94709-0000,Private      ,0,33,33,1,214,215
00120800,GROSSMONT COLLEGE                       ,CA,92020-1799,Public       ,1398,2453,3851,7918,7494,15412
00120900,HARTNELL COMMUNITY COLLEGE              ,CA,93901-1697,Public       ,916,961,1877,3929,2499,6428
00121200,HUMPHREYS COLLEGE                       ,CA,95207-3896,Private      ,29,243,272,229,720,949
00121400,IMPERIAL VALLEY COLLEGE                 ,CA,92251-9787,Public       ,874,1037,1911,3808,2397,6205
00121500,LA SIERRA UNIVERSITY                    ,CA,92515-3332,Private      ,243,301,544,3390,1167,4557
00121600,UNIVERSITY OF LA VERNE                  ,CA,91750-4443,Private      ,350,1368,1718,5843,5276,11119
00121700,LASSEN COLLEGE                          ,CA,96130-3000,Public       ,140,162,302,430,363,793
00121800,LOMA LINDA UNIVERSITY                   ,CA,92350-0001,Private      ,143,964,1107,1130,5071,6201
00121900,LONG BEACH CITY COLLEGE                 ,CA,90808-1780,Public       ,1915,3154,5069,15355,11052,26407
00122000,MASTER'S COLLEGE & SEMINARY (THE)       ,CA,91321-1200,Private      ,105,130,235,1255,367,1622
00122300,LOS ANGELES CITY COLLEGE                ,CA,90029-3588,Public       ,1472,3846,5318,8652,12277,20929
00122400,LOS ANGELES HARBOR COLLEGE              ,CA,90744-2397,Public       ,593,1129,1722,3805,4036,7841
00122600,LOS ANGELES PIERCE COLLEGE              ,CA,91371-0001,Public       ,1707,2718,4425,11101,9315,20416
00122700,LOS ANGELES TRADE TECH COLLEGE          ,CA,90015-4181,Public       ,1130,3365,4495,5874,10313,16187
00122800,LOS ANGELES VALLEY COLLEGE              ,CA,91401-4096,Public       ,1304,2505,3809,7855,8636,16491
00122900,SO CA UNIV  HEALTH SCIENCES             ,CA,90604-4051,Private      ,8,214,222,44,605,649
00123000,MARSHALL B. KETCHUM UNIVERSITY          ,CA,92831-1699,Private      ,5,212,217,11,600,611
00123200,AMERICAN RIVER COLLEGE                  ,CA,95841-4286,Public       ,2136,5430,7566,12791,16762,29553
00123300,SACRAMENTO CITY COLLEGE                 ,CA,95822-1386,Public       ,1853,4076,5929,12935,13144,26079
00123600,MENLO COLLEGE                           ,CA,94027-4301,Private      ,106,28,134,1099,154,1253
00123700,MERCED COMMUNITY COLLEGE                ,CA,95348-2898,Public       ,1047,1601,2648,5712,4376,10088
00123800,MILLS COLLEGE                           ,CA,94613-1301,Private      ,93,283,376,1365,1427,2792
00123900,MIRACOSTA COLLEGE                       ,CA,92056-3899,Public       ,977,2272,3249,4620,5667,10287
00124000,MODESTO JUNIOR COLLEGE                  ,CA,95350-5800,Public       ,1847,3149,4996,9281,9215,18496
00124200,MONTEREY PENINSULA COLLEGE              ,CA,93940-4799,Public       ,605,867,1472,2747,2192,4939
00124300,MOUNT ST MARYS COLLEGE                  ,CA,90049-1599,Private      ,184,568,752,3522,2237,5759
00124500,MT. SAN ANTONIO COLLEGE                 ,CA,91789-1399,Public       ,2549,3512,6061,17357,11845,29202
00124600,MT SAN JACINTO COLLEGE                  ,CA,92583-2399,Public       ,2061,3815,5876,8277,9508,17785
00124700,NAPA VALLEY COLLEGE                     ,CA,94558-6236,Public       ,568,795,1363,2545,2011,4556
00124900,OCCIDENTAL COLLEGE                      ,CA,90041-3314,Private      ,108,38,146,4804,290,5094
00125000,ORANGE COAST COLLEGE - FIN AID OFF      ,CA,92628-5005,Public       ,2111,3026,5137,12306,8182,20488
00125100,OTIS COLLEGE OF ART AND DESIGN          ,CA,90045-3505,Private      ,192,194,386,1759,660,2419
00125200,HOPE INTERNATIONAL UNIVERSITY           ,CA,92631-0000,Private      ,115,256,371,867,799,1666
00125300,FRESNO PACIFIC UNIVERSITY               ,CA,93702-4798,Private      ,229,966,1195,2247,3237,5484
00125400,PACIFIC LUTHERAN THEOLOGICAL SEM        ,CA,94708-0000,Private      ,0,6,6,2,42,44
00125500,PACIFIC OAKS COLLEGE                    ,CA,91103-3606,Private      ,13,375,388,54,1177,1231
00125600,PACIFIC SCHOOL OF RELIGION              ,CA,94709-0000,Private      ,0,25,25,1,144,145
00125800,PACIFIC UNION COLLEGE                   ,CA,94508-9797,Private      ,371,143,514,1787,426,2213
00125900,PALO VERDE COLLEGE                      ,CA,92225-0000,Public       ,63,128,191,163,255,418
00126000,PALOMAR COLLEGE                         ,CA,92069-1486,Public       ,2114,3174,5288,9047,7369,16416
00126100,PASADENA CITY COLLEGE                   ,CA,91106-2003,Public       ,2310,3157,5467,15884,9685,25569
00126200,POINT LOMA NAZARENE UNIVERSITY          ,CA,92106-2899,Private      ,381,471,852,4133,1272,5405
00126600,LANEY COLLEGE                           ,CA,94607-4893,Public       ,676,2239,2915,3340,5471,8811
00126700,MERRITT COLLEGE                         ,CA,94619-3196,Public       ,430,1398,1828,2123,3530,5653
00126800,PORTERVILLE COLLEGE                     ,CA,93257-6059,Public       ,486,763,1249,2043,1663,3706
00126900,RIO HONDO COLLEGE                       ,CA,90601-1699,Public       ,1417,1945,3362,10111,6328,16439
00127000,RIVERSIDE CITY COLLEGE                  ,CA,92506-1299,Public       ,2627,4117,6744,16913,13241,30154
00127200,SAN BERNARDINO VALLEY COLLEGE           ,CA,92410-2798,Public       ,1416,3149,4565,8408,9941,18349
00127300,SAN DIEGO CITY COLLEGE                  ,CA,92101-4787,Public       ,1659,3898,5557,9257,10557,19814
00127500,SAN DIEGO MESA COLLEGE                  ,CA,92111-4996,Public       ,1881,3422,5303,9895,9414,19309
00127800,SAN FRANCISCO CONSERVATORY OF MUSIC     ,CA,94122-4498,Private      ,33,67,100,255,315,570
00127900,SAN FRANCISCO THEOLOGICAL SEMINARY      ,CA,94960-0000,Private      ,0,23,23,10,56,66
00128000,SAN JOAQUIN DELTA COLLEGE               ,CA,95207-6370,Public       ,1384,2413,3797,8401,7871,16272
00128100,WILLIAM JESSUP UNIVERSITY               ,CA,95765-3707,Private      ,135,188,323,1205,571,1776
00128200,SAN JOSE CITY COLLEGE                   ,CA,95128-2797,Public       ,658,1620,2278,4219,4521,8740
00128400,SANTA ANA COLLEGE                       ,CA,92706-3398,Public       ,1036,1936,2972,8227,5916,14143
00128500,SANTA BARBARA CITY COLLEGE              ,CA,93109-2394,Public       ,1630,1866,3496,8292,4488,12780
00128600,SANTA MONICA COLLEGE                    ,CA,90405-1644,Public       ,3158,3624,6782,17446,9903,27349
00128700,SANTA ROSA JUNIOR COLLEGE               ,CA,95401-4395,Public       ,927,1706,2633,5250,4585,9835
00128800,CLAREMONT SCHOOL OF THEOLOGY            ,CA,91711-0000,Private      ,1,87,88,8,237,245
00128900,SHASTA COLLEGE                          ,CA,96049-7692,Public       ,685,1496,2181,3107,3714,6821
00129000,SIERRA COLLEGE                          ,CA,95677-3397,Public       ,1917,3084,5001,7553,7187,14740
00129100,SIMPSON UNIVERSITY                      ,CA,96003-8606,Private      ,85,252,337,1138,941,2079
00129200,SOLANO COMMUNITY COLLEGE                ,CA,94534-3197,Public       ,697,1488,2185,3193,3981,7174
00129300,VANGUARD UNIVERSITY OF SOUTHERN CA      ,CA,92626-6597,Private      ,128,253,381,2163,938,3101
00129400,SOUTHWESTERN COLLEGE                    ,CA,91910-7299,Public       ,1392,2061,3453,8900,6572,15472
00129500,SOUTHWESTERN LAW SCHOOL                 ,CA,90010-1106,Private      ,6,329,335,57,1899,1956
00129600,DOMINICAN SCH PHILOSOPHY & THEOLOGY     ,CA,94709-0000,Private      ,0,4,4,4,30,34
00129900,ST JOHN'S SEMINARY COLLEGE              ,CA,93010-0000,Private      ,0,2,2,3,8,11
00130200,SAINT MARY'S COLLEGE OF CALIFORNIA      ,CA,94556-2744,Private      ,242,372,614,4846,1228,6074
00130500,STANFORD UNIVERSITY                     ,CA,94305-6106,Private      ,1734,549,2283,25664,2727,28391
00130501,STANFORD UNIVERSITY - SCHOOL OF MEDICINE,CA,94305-5404,Private      ,31,165,196,208,747,955
00130502,STANFORD UNIVERSITY - GRADUATE SCHOOL OF,CA,94305-7298,Private      ,10,417,427,79,2054,2133
00130503,STANFORD UNIVERSITY - STANFORD LAW SCHOO,CA,94305-8610,Private      ,22,266,288,151,1937,2088
00130700,FRESNO CITY COLLEGE                     ,CA,93741-0002,Public       ,2418,5089,7507,15130,13547,28677
00130800,REEDLEY COLLEGE                         ,CA,93654-2099,Public       ,1411,1779,3190,6885,4408,11293
00130900,TAFT COLLEGE                            ,CA,93268-2317,Public       ,321,578,899,1622,1336,2958
00131200,"UNIVERSITY OF CALIFORNIA, BERKELEY      ",CA,94720-1520,Public       ,1653,2524,4177,60937,17219,78156
00131300,UNIVERSITY OF CALIFORNIA-DAVIS          ,CA,95616-8558,Public       ,981,1443,2424,57503,14291,71794
00131400,UNIVERSITY OF CALIFORNIA-IRVINE         ,CA,92697-2825,Public       ,846,1390,2236,64737,13280,78017
00131500,UNIVERSITY OF CALIFORNIA (UCLA)         ,CA,90095-9000,Public       ,2120,3266,5386,77358,23592,100950
00131502,UNIV OF CALIFORNIA LOS ANG SCH MED      ,CA,90095-0000,Public       ,21,109,130,231,988,1219
00131503,UNIV OF CALIFORNIA LOS ANG DENTAL       ,CA,90095-0000,Public       ,7,37,44,104,180,284
00131600,UNIVERSITY OF CALIFORNIA-RIVERSIDE      ,CA,92521-0209,Public       ,860,1211,2071,43452,9188,52640
00131700,UNIVERSITY OF CALIFORNIA-SAN DIEGO      ,CA,92093-0013,Public       ,991,1275,2266,57430,10225,67655
00131900,UNIVERSITY OF CALIFORNIA-SFRANCISCO     ,CA,94143-0246,Public       ,165,554,719,1418,3992,5410
00132000,UNIVERSITY OF CALIFORNIA-SANTA BARB     ,CA,93106-3180,Public       ,966,622,1588,55851,6938,62789
00132100,UNIVERSITY OF CALIFORNIA-SANTA CRUZ     ,CA,95064-0001,Public       ,758,509,1267,40213,5168,45381
00132200,UNIVERSITY OF REDLANDS                  ,CA,92373-0999,Private      ,174,740,914,5364,2624,7988
00132500,UNIVERSITY OF SAN FRANCISCO             ,CA,94117-1080,Private      ,396,1422,1818,12510,6503,19013
00132600,SANTA CLARA UNIVERSITY                  ,CA,95053-4956,Private      ,380,598,978,10457,2678,13135
00132604,JESUIT SCHOOL OF THEOLOGY - BERKELEY    ,CA,94709-1193,Private      ,1,10,11,1,51,52
00132800,UNIVERSITY OF SOUTHERN CALIFORNIA       ,CA,90089-0914,Private      ,1330,6169,7499,42177,24903,67080
00132900,UNIVERSITY OF THE PACIFIC               ,CA,95211-0197,Private      ,312,521,833,8867,2913,11780
00132901,UNIVERSITY OF THE PACIFIC - MCGEORGE SCH,CA,95817-2799,Private      ,17,161,178,152,1061,1213
00132902,UNIV OF THE PACIFIC SCH OF DENT         ,CA,94115-0000,Private      ,3,79,82,53,606,659
00133400,VENTURA COLLEGE                         ,CA,93003-3899,Public       ,1041,1350,2391,5328,3734,9062
00133500,VICTOR VALLEY COLLEGE                   ,CA,92395-5849,Public       ,1289,2571,3860,5783,6760,12543
00133800,WEST VALLEY COLLEGE                     ,CA,95070-5697,Public       ,577,788,1365,2392,1910,4302
00134100,WESTMONT COLLEGE                        ,CA,93108-1099,Private      ,209,21,230,2441,131,2572
00134200,WHITTIER COLLEGE                        ,CA,90601-0000,Private      ,208,111,319,3985,479,4464
00134201,WHITTIER COLLEGE - COLLEGE OF LAW       ,CA,92626-1501,Private      ,3,248,251,30,944,974
00134300,WOODBURY UNIVERSITY                     ,CA,91510-7846,Private      ,89,155,244,1170,717,1887
00134400,YUBA COLLEGE                            ,CA,95901-7699,Public       ,745,1450,2195,3195,3463,6658
00177212,TRINITY INTERNATIONAL UNIV-CA           ,CA,92705-0000,Private      ,1,78,79,3,194,197
00188100,ASHFORD UNIVERSITY                      ,CA,92123-1406,Proprietary  ,526,26844,27370,1154,51654,52808
00274100,AMERICAN JEWISH UNIVERSITY              ,CA,90077-1599,Private      ,10,42,52,66,114,180
00301002,ANTIOCH UNIV/LOS ANGELES                ,CA,90230-7615,Private      ,5,275,280,47,759,806
00301003,ANTIOCH  UNIV/SANTA BARBARA             ,CA,93101-0000,Private      ,27,172,199,613,478,1091
00369110,MIDDLEBURY COLLEGE - MONTEREY INSTITUTE ,CA,93940-2691,Private      ,7,136,143,34,723,757
00394700,UC-HASTINGS COLLEGE OF THE LAW          ,CA,94102-0000,Public       ,3,177,180,29,2469,2498
00394800,SAN FRANCISCO ART INSTITUTE             ,CA,94133-2299,Private      ,183,217,400,1269,795,2064
00408000,STARR KING SCHOOL FOR THE MINISTRY      ,CA,94709-1299,Private      ,0,20,20,1,69,70
00448000,DE ANZA COLLEGE                         ,CA,95014-5793,Public       ,1325,1776,3101,8197,5104,13301
00448100,OHLONE COLLEGE                          ,CA,94539-5847,Public       ,641,858,1499,3112,2319,5431
00448400,JOHN F. KENNEDY UNIVERSITY              ,CA,94523-4817,Private      ,6,308,314,34,894,928
00449400,EVEREST COLLEGE                         ,CA,92408-3752,Proprietary  ,36,90,126,228,326,554
00449401,EVEREST COLLEGE - SANTA ANA             ,CA,92701-4559,Proprietary  ,34,68,102,134,220,354
00449402,EVEREST COLLEGE - ONTARIO               ,CA,91761-8525,Proprietary  ,33,100,133,145,426,571
00450200,CITY COLLEGE OF SAN FRANCISCO           ,CA,94112-0000,Public       ,1064,3352,4416,6629,8170,14799
00563800,DOWNEY ADULT SCHOOL                     ,CA,90241-5610,Public       ,79,243,322,211,535,746
00565500,HACIENDA LA PUENTE ADULT EDUC CTR       ,CA,91746-0000,Public       ,60,179,239,171,378,549
00616500,LA CNTY CLG OF NURSING & ALLD HLTH      ,CA,90033-1018,Public       ,29,115,144,176,467,643
00672000,COLLEGE OF ALAMEDA                      ,CA,94501-2109,Public       ,405,963,1368,2178,2657,4835
00673100,CASA LOMA COLLEGE                       ,CA,91405-4523,Private      ,49,191,240,116,398,514
00697300,CANADA COLLEGE                          ,CA,94061-1099,Public       ,230,519,749,1146,1323,2469
00697500,LINCOLN UNIVERSITY                      ,CA,94612-2801,Private      ,4,30,34,35,89,124
00701200,SAMUEL MERRITT COLLEGE                  ,CA,94609-3108,Private      ,45,551,596,345,2237,2582
00704700,LOS ANGELES SOUTHWEST COLLEGE           ,CA,90047-4810,Public       ,546,1688,2234,2989,5813,8802
00705000,BELLUS ACADEMY                          ,CA,91950-3616,Proprietary  ,39,61,100,91,108,199
00711500,MOORPARK COLLEGE                        ,CA,93021-1695,Public       ,1043,1198,2241,5102,3210,8312
00713000,NEWBERRY SCHOOLS OF BEAUTY              ,CA,91344-7404,Proprietary  ,13,43,56,40,66,106
00714200,LYLE'S COLLEGE OF BEAUTY                ,CA,93710-3948,Proprietary  ,27,63,90,71,113,184
00716400,BRYAN COLLEGE                           ,CA,90057-0000,Proprietary  ,68,840,908,124,1380,1504
00718700,NORTH ADRIAN'S COLLEGE OF BEAUTY        ,CA,95350-2381,Proprietary  ,21,50,71,68,97,165
00719000,WYOTECH                                 ,CA,94539-7663,Proprietary  ,24,33,57,138,147,285
00720300,SALON SUCCESS ACADEMY                   ,CA,91786-4060,Proprietary  ,32,50,82,70,93,163
00720400,MODERN BEAUTY ACADEMY                   ,CA,93030-7016,Proprietary  ,11,19,30,31,45,76
00720900,REDONDO BEACH BEAUTY COLLEGE            ,CA,90278-3111,Proprietary  ,5,15,20,11,25,36
00723400,HEALD COLLEGE                           ,CA,94105-2206,Proprietary  ,20,39,59,197,488,685
00723404,HEALD COLLEGE - CONCORD                 ,CA,94520-0000,Proprietary  ,22,81,103,344,784,1128
00723405,HEALD COLLEGE - MILPITAS                ,CA,95035-8008,Proprietary  ,14,54,68,318,764,1082
00723406,HEALD COLLEGE - HAYWARD                 ,CA,94545-2352,Proprietary  ,21,50,71,370,655,1025
00723407,HEALD COLLEGE - MODESTO                 ,CA,95368-9095,Proprietary  ,16,42,58,411,552,963
00723408,HEALD COLLEGE - ROSEVILLE               ,CA,95678-5303,Proprietary  ,10,48,58,290,768,1058
00723409,HEALD COLLEGE - SALINAS                 ,CA,93906-5100,Proprietary  ,13,26,39,301,446,747
00723410,HEALD COLLEGE - STOCKTON                ,CA,95210-5667,Proprietary  ,22,95,117,477,836,1313
00723411,HEALD COLLEGE - RANCHO CORDOVA          ,CA,95670-6005,Proprietary  ,4,28,32,206,645,851
00723412,HEALD COLLEGE - FRESNO                  ,CA,93704-1706,Proprietary  ,24,89,113,651,1044,1695
00725300,FEDERICO BEAUTY INSTITUTE               ,CA,95834-1905,Proprietary  ,81,158,239,196,274,470
00729600,COLEMAN COLLEGE                         ,CA,92123-0000,Private      ,32,180,212,133,376,509
00732909,ITT TECHNICAL INSTITUTE                 ,CA,92868-3506,Proprietary  ,152,612,764,304,1145,1449
00732971,ITT TECHNICAL INSTITUTE                 ,CA,95670-6047,Proprietary  ,104,579,683,219,1062,1281
00732976,ITT TECHNICAL INSTITUTE                 ,CA,92408-3519,Proprietary  ,227,798,1025,601,1673,2274
00732981,ITT TECHNICAL INSTITUTE                 ,CA,92123-2662,Proprietary  ,162,900,1062,431,1608,2039
00732985,ITT TECHNICAL INSTITUTE                 ,CA,91773-2933,Proprietary  ,102,431,533,232,1016,1248
00732989,ITT TECHNICAL INSTITUTE                 ,CA,90502-1356,Proprietary  ,104,531,635,217,1006,1223
00732994,ITT TECHNICAL INSTITUTE                 ,CA,91342-3664,Proprietary  ,123,501,624,246,929,1175
00746901,HUSSIAN SCHOOL OF ART-RELATIVITY CAMPUS ,CA,90017-2019,Proprietary  ,33,6,39,110,15,125
00747600,MARINELLO SCHOOLS OF BEAUTY             ,CA,90023-2666,Proprietary  ,63,129,192,178,276,454
00747602,MARINELLO SCHOOLS OF BEAUTY - SPA ACADEM,CA,90048-5101,Proprietary  ,24,58,82,68,116,184
00747603,MARINELLO SCHOOLS OF BEAUTY - INGLEWOOD ,CA,90301-2306,Proprietary  ,27,72,99,93,137,230
00747604,MARINELLO SCHOOLS OF BEAUTY - RESEDA    ,CA,91335-4218,Proprietary  ,6,19,25,41,40,81
00747606,MARINELLO SCHOOLS OF BEAUTY - WEST COVIN,CA,91790-2805,Proprietary  ,24,62,86,59,94,153
00747607,MARINELLO SCHOOLS OF BEAUTY - SAN BERNAR,CA,92410-3261,Proprietary  ,31,107,138,117,195,312
00747608,MARINELLO SCHOOLS OF BEAUTY - ONTARIO   ,CA,91762-2113,Proprietary  ,33,83,116,98,150,248
00747609,MARINELLO SCHOOLS OF BEAUTY - WHITTIER  ,CA,90601-4107,Proprietary  ,21,39,60,58,90,148
00747610,MARINELLO SCHOOLS OF BEAUTY - LOMITA    ,CA,90717-1460,Proprietary  ,18,50,68,40,80,120
00747611,MARINELLO SCHOOLS OF BEAUTY - SAN DIEGO ,CA,92126-4217,Proprietary  ,39,137,176,138,236,374
00747612,MARINELLO SCHOOLS OF BEAUTY - EL CAJON  ,CA,92020-2503,Proprietary  ,36,79,115,70,116,186
00747613,MARINELLO SCHOOLS OF BEAUTY - VICTORVILL,CA,92392-5496,Proprietary  ,34,97,131,85,182,267
00747614,MARINELLO SCHOOLS OF BEAUTY - ANAHEIM   ,CA,92801-4622,Proprietary  ,31,59,90,91,95,186
00747615,MARINELLO SCHOOLS OF BEAUTY - SIMI VALLE,CA,93065-2801,Proprietary  ,2,15,17,18,26,44
00753100,ACADEMY OF ART UNIVERSITY               ,CA,94105-3410,Proprietary  ,1136,2481,3617,4824,6273,11097
00753600,COSUMNES RIVER COLLEGE                  ,CA,95823-5799,Public       ,1277,2554,3831,8537,8265,16802
00754802,WESTWOOD COLLEGE OF TECHNOLOGY          ,CA,92801-0000,Proprietary  ,58,99,157,326,366,692
00754803,WESTWOOD COLLEGE OF TECHNOLOGY          ,CA,91786-0000,Proprietary  ,86,112,198,449,537,986
00760700,CONCORDE CAREER INSTITUTE               ,CA,91606-3134,Proprietary  ,87,178,265,233,458,691
00770700,COLUMBIA COLLEGE                        ,CA,95370-8580,Public       ,252,381,633,1020,1027,2047
00771300,SKYLINE COLLEGE                         ,CA,94066-1698,Public       ,617,998,1615,3121,2406,5527
00793000,CONCORDE CAREER INSTITUTE               ,CA,92108-0000,Proprietary  ,65,252,317,182,615,797
00799300,CALIF STATE UNIV BAKERSFIELD            ,CA,93311-1022,Public       ,617,1297,1914,11700,6294,17994
00807100,CONCORDE CAREER INSTITUTE               ,CA,92840-9201,Proprietary  ,54,203,257,158,488,646
00807300,BUTTE COMMUNITY COLLEGE                 ,CA,95965-0000,Public       ,1427,2309,3736,6241,5717,11958
00809000,EVEREST COLLEGE                         ,CA,91803-1310,Proprietary  ,9,15,24,87,133,220
00853700,CONCORDE CAREER INSTITUTE               ,CA,92401-0000,Proprietary  ,89,249,338,290,565,855
00859600,WEST LOS ANGELES COLLEGE                ,CA,90230-3500,Public       ,746,1867,2613,4340,6079,10419
00859700,FEATHER RIVER COLLEGE                   ,CA,95971-9124,Public       ,127,116,243,581,320,901
00884400,CALIFORNIA CHRISTIAN COLLEGE            ,CA,93703-3599,Private      ,11,35,46,71,99,170
00884600,WRIGHT INSTITUTE                        ,CA,94704-0000,Private      ,0,218,218,2,438,440
00890300,COLLEGE OF THE CANYONS                  ,CA,91355-1899,Public       ,1282,1615,2897,7168,4549,11717
00891800,SADDLEBACK COLLEGE                      ,CA,92692-3699,Public       ,1051,1787,2838,4832,4974,9806
00902200,ASSOCIATED TECHNICAL COLLEGE            ,CA,90017-0000,Proprietary  ,26,126,152,90,214,304
00903200,EMPIRE COLLEGE                          ,CA,95403-2122,Proprietary  ,31,139,170,84,268,352
00927200,CRAFTON HILLS COLLEGE                   ,CA,92399-1799,Public       ,637,1041,1678,3359,3005,6364
00950900,SKILLS & BUSINESS EDUCATION CENTER      ,CA,95824-1529,Public       ,54,202,256,213,553,766
00974800,CARRINGTON COLLEGE                      ,CA,95826-3203,Proprietary  ,664,1537,2201,1818,3761,5579
00974801,CARRINGTON COLLEGE  - SAN LEANDRO CAMPUS,CA,94578-3711,Proprietary  ,0,0,0,6,28,34
00974802,CARRINGTON COLLEGE  - PLEASANT HILL CAMP,CA,94523-1984,Proprietary  ,0,0,0,10,29,39
00974803,CARRINGTON COLLEGE  - STOCKTON          ,CA,95207-5509,Proprietary  ,0,0,0,26,38,64
00974804,CARRINGTON COLLEGE  - CITRUS HEIGHTS    ,CA,95621-5577,Proprietary  ,0,0,0,14,16,30
00974807,CARRINGTON COLLEGE  - SAN JOSE          ,CA,95119-1325,Proprietary  ,0,0,0,42,59,101
00998900,SANTA BARBARA BUSINESS COLLEGE          ,CA,93111-0000,Proprietary  ,39,167,206,230,400,630
01011100,CERRO-COSO COMMUNITY COLLEGE            ,CA,93555-9571,Public       ,204,758,962,665,1607,2272
01014900,PEPPERDINE UNIVERSITY                   ,CA,90263-0000,Private      ,332,1378,1710,8131,4876,13007
01034000,LOS MEDANOS COLLEGE                     ,CA,94565-5197,Public       ,649,1153,1802,2978,3143,6121
01036500,CHARLES R DREW UNIV OF MED & SCI        ,CA,90059-0000,Private      ,21,172,193,109,795,904
01039500,UNIVERSITY OF SAN DIEGO                 ,CA,92110-2492,Private      ,652,1124,1776,16343,5143,21486
01039501,UNIVERSITY OF SAN DIEGO - SCHOOL OF LAW ,CA,92110-2492,Private      ,20,326,346,164,2122,2286
01044100,PARDEE RAND GRADUATE SCHOOL             ,CA,90407-2138,Private      ,0,2,2,1,14,15
01047400,MARYMOUNT COLLEGE OF PALOS VERDES       ,CA,90275-0000,Private      ,81,44,125,1006,238,1244
01085400,THOMAS JEFFERSON SCHOOL OF LAW          ,CA,92110-0000,Private      ,2,323,325,23,1084,1107
01110700,EVEREST  COLLEGE                        ,CA,92801-5231,Proprietary  ,30,40,70,174,215,389
01110900,EVEREST COLLEGE                         ,CA,91335-4631,Proprietary  ,21,49,70,85,173,258
01111200,FIDM-FASHION INSTITUTE OF DESIGN        ,CA,90015-1421,Proprietary  ,678,436,1114,3846,1427,5273
01111700,ALLIANT INTERNATIONAL UNIVERSITY        ,CA,92131-1799,Private      ,25,391,416,192,1603,1795
01111705,ALLIANT INTERNATIONAL UNIVERSITY - LOS A,CA,91803-1360,Private      ,1,100,101,5,527,532
01111706,ALLIANT INTERNATIONAL UNIVERSITY - SAN F,CA,94133-1221,Private      ,5,131,136,38,553,591
01111707,ALLIANT INTERNATIONAL UNIVERSITY - FRESN,CA,93727-2014,Private      ,6,89,95,50,396,446
01112300,EVEREST COLLEGE                         ,CA,90247-4163,Proprietary  ,6,31,37,72,177,249
01146000,NATIONAL UNIVERSITY                     ,CA,92037-1011,Private      ,142,4111,4253,585,11330,11915
01162600,PRACTICAL SCHOOLS                       ,CA,92805-0000,Proprietary  ,33,80,113,176,377,553
01164900,LOYOLA MARYMOUNT UNIVERSITY             ,CA,90045-0000,Private      ,469,752,1221,12692,2890,15582
01164901,LMU  - LOYOLA LAW SCHOOL                ,CA,90015-0019,Private      ,21,310,331,136,2186,2322
01167200,MENDOCINO COLLEGE                       ,CA,95482-3000,Public       ,274,550,824,1060,1370,2430
01170700,NORTH-WEST COLLEGE                      ,CA,91790-2097,Proprietary  ,109,172,281,218,340,558
01179200,FRANCISCAN SCHOOL OF THEOLOGY           ,CA,94709-0000,Private      ,0,11,11,0,26,26
01182000,SAN DIEGO MIRAMAR COLLEGE               ,CA,92126-0000,Public       ,943,2123,3066,4767,5722,10489
01186500,CALIFORNIA HAIR DESIGN ACADEMY          ,CA,92115-0000,Proprietary  ,28,69,97,71,118,189
01186600,LU ROSS ACADEMY                         ,CA,93001-2927,Proprietary  ,39,94,133,99,184,283
01202600,BELLUS ACADEMY                          ,CA,92021-6247,Proprietary  ,14,48,62,63,93,156
01203100,SAN DIEGO CHRISTIAN COLLEGE             ,CA,92019-1157,Private      ,93,165,258,784,575,1359
01215400,CALIFORNIA INSTITUTE OF INTEGRAL STUDIES,CA,94103-2557,Private      ,11,495,506,42,1143,1185
01231600,MANCHESTER BEAUTY COLLEGE               ,CA,93726-5306,Proprietary  ,4,4,8,49,44,93
01231700,TULARE BEAUTY COLLEGE                   ,CA,93274-3432,Proprietary  ,0,1,1,10,9,19
01244600,UNIVERSAL COLLEGE OF BEAUTY             ,CA,90044-0044,Proprietary  ,11,35,46,44,84,128
01245200,EVERGREEN VALLEY COLLEGE                ,CA,95135-1598,Public       ,724,1401,2125,4334,4076,8410
01255000,LOS ANGELES MISSION COLLEGE             ,CA,91342-3200,Public       ,727,1210,1937,4945,4421,9366
01265000,MARINELLO SCHOOL OF BEAUTY              ,CA,91502-2828,Proprietary  ,34,94,128,83,152,235
01265001,MARINELLO SCHOOL OF BEAUTY - PALMDALE   ,CA,93550-4686,Proprietary  ,18,37,55,55,78,133
01284200,OXNARD COLLEGE                          ,CA,93030-0000,Public       ,603,971,1574,2946,2623,5569
01287200,NORTH-WEST COLLEGE                      ,CA,91768-3199,Proprietary  ,122,261,383,312,613,925
01287300,WYOTECH                                 ,CA,90810-3800,Proprietary  ,54,116,170,290,408,698
01287301,WYOTECH - EVEREST  COLLEGE              ,CA,90034-3158,Proprietary  ,7,20,27,82,121,203
01287302,WYOTECH - EVEREST  COLLEGE              ,CA,91746-3412,Proprietary  ,21,28,49,86,137,223
01290700,LAKE TAHOE COMMUNITY COLLEGE            ,CA,96150-4524,Public       ,99,200,299,462,591,1053
01291200,MTI COLLEGE                             ,CA,95841-0000,Proprietary  ,74,282,356,346,1003,1349
01294200,ROSEMEAD BEAUTY SCHOOL                  ,CA,91770-1639,Proprietary  ,11,96,107,18,118,136
01298400,PROFESSIONAL INSTITUTE OF BEAUTY        ,CA,91731-2613,Proprietary  ,2,13,15,5,17,22
01298500,HAIR CALIFORNIA BEAUTY ACADEMY          ,CA,92867-7127,Proprietary  ,2,12,14,8,29,37
01298900,OCEANSIDE COLLEGE OF BEAUTY             ,CA,92054-5393,Proprietary  ,12,41,53,45,97,142
01301000,LANCASTER BEAUTY SCHOOL                 ,CA,93534-3098,Proprietary  ,21,65,86,51,125,176
01307400,AMERICAN BEAUTY COLLEGE                 ,CA,91790-2906,Proprietary  ,11,22,33,36,49,85
01309500,SALON SUCCESS ACADEMY                   ,CA,92879-0000,Proprietary  ,36,78,114,77,148,225
01310300,CALIFORNIA WESTERN SCHOOL OF LAW        ,CA,92101-0000,Private      ,10,276,286,78,1315,1393
01324000,LYTLE'S REDWOOD EMPIRE BEAUTY CLG       ,CA,95403-0000,Proprietary  ,44,67,111,88,139,227
02054900,MARINELLO SCHOOL OF BEAUTY              ,CA,92630-0000,Proprietary  ,34,65,99,53,104,157
02054902,MARINELLO SCHOOL OF BEAUTY - BAKERSFIELD,CA,93309-5001,Proprietary  ,55,119,174,247,246,493
02054903,MARINELLO SCHOOL OF BEAUTY - VISALIA    ,CA,93277-6228,Proprietary  ,13,24,37,96,82,178
02059800,PARIS BEAUTY COLLEGE                    ,CA,94520-2611,Proprietary  ,9,42,51,33,74,107
02061600,WAYNES COLLEGE OF BEAUTY                ,CA,93906-2830,Proprietary  ,19,27,46,57,59,116
02063500,COASTLINE COMMUNITY COLLEGE             ,CA,92708-0000,Public       ,411,2561,2972,2192,5818,8010
02064300,SIERRA COLLEGE OF BEAUTY                ,CA,95340-0000,Proprietary  ,8,24,32,54,72,126
02065700,CALIFORNIA BEAUTY COLLEGE               ,CA,95354-0000,Proprietary  ,15,34,49,83,112,195
02070500,CONCORDIA UNIVERSITY                    ,CA,92612-0000,Private      ,261,1203,1464,2872,2612,5484
02075800,SOUTHERN CA INST OF ARCHITECTURE        ,CA,90013-0000,Private      ,23,75,98,163,325,488
02086400,MARINELLO SCHOOL OF BEAUTY              ,CA,95050-0000,Proprietary  ,20,46,66,48,114,162
02086401,MARINELLO SCHOOL OF BEAUTY - SEASIDE    ,CA,93955-3615,Proprietary  ,26,58,84,54,92,146
02086402,MARINELLO SCHOOL OF BEAUTY - SAN MATEO  ,CA,94401-3801,Proprietary  ,10,35,45,29,70,99
02086403,MARINELLO SCHOOL OF BEAUTY - HAYWARD    ,CA,94541-5111,Proprietary  ,18,48,66,69,121,190
02086404,MARINELLO SCHOOL OF BEAUTY - CASTRO VALL,CA,94546-5506,Proprietary  ,12,16,28,24,39,63
02091200,ELEGANCE INTERNATIONAL                  ,CA,90028-0000,Proprietary  ,46,81,127,158,213,371
02091700,KAPLAN COLLEGE                          ,CA,92123-1509,Proprietary  ,146,522,668,485,1454,1939
02091702,KAPLAN COLLEGE - CHULA VISTA            ,CA,91910-5342,Proprietary  ,52,94,146,170,230,400
02096100,FIELDING GRADUATE UNIVERSITY            ,CA,93105-0000,Private      ,0,218,218,5,644,649
02099200,AMERICAN CONSERVATORY THEATER           ,CA,94108-0000,Private      ,21,47,68,62,223,285
02110200,COLUMBIA COLLEGE                        ,CA,91356-0000,Private      ,88,47,135,466,161,627
02110800,CALIFORNIA COLLEGE SAN DIEGO            ,CA,92108-3821,Proprietary  ,352,1074,1426,1657,1943,3600
02111300,CUYAMACA COLLEGE                        ,CA,92019-0000,Public       ,639,1365,2004,3588,4525,8113
02119100,MISSION COLLEGE                         ,CA,95054-1897,Public       ,547,1307,1854,2829,3339,6168
02120600,SAYBROOK GRADUATE SCHOOL                ,CA,94111-1920,Private      ,1,211,212,5,468,473
02120601,SAYBROOK UNIVERSITY -  WESTIN HOTEL     ,CA,94030-3120,Private      ,0,43,43,0,84,84
02120700,SAN JOAQUIN VALLEY COLLEGE              ,CA,93291-0000,Proprietary  ,639,1565,2204,1735,3336,5071
02125000,CAREER ACADEMY OF BEAUTY                ,CA,92845-0000,Proprietary  ,15,63,78,41,103,144
02128200,"VICTOR VALLEY BEAUTY COLLEGE, INC       ",CA,92392-0000,Proprietary  ,36,69,105,105,154,259
02128300,INSTITUTE FOR BUSINESS & TECHNOLOGY     ,CA,95050-0000,Proprietary  ,26,156,182,76,315,391
02128301,INSTITUTE FOR BUSINESS & TECHNOLOGY - NA,CA,95670-6351,Proprietary  ,16,94,110,40,225,265
02138300,PALO ALTO UNIVERSITY                    ,CA,94304-1337,Private      ,11,286,297,68,962,1030
02161800,MUSICIANS INSTITUTE                     ,CA,90028-6157,Proprietary  ,180,224,404,673,526,1199
02167800,ESTES INSTITUTE OF COSMETOLOGY          ,CA,93291-0000,Proprietary  ,10,33,43,68,75,143
02178700,CITRUS HEIGHTS BEAUTY COLLEGE           ,CA,95610-1410,Proprietary  ,27,57,84,89,131,220
02179937,WESTERN STATE COLLEGE OF LAW            ,CA,92831-3014,Proprietary  ,3,186,189,22,650,672
02179938,"ART INSTITUTE OF CALIFORNIA, HOLLYWOOD  ",CA,91601-3112,Proprietary  ,303,343,646,1489,957,2446
02179941,"ART INSTITUTE OF CALIFORNIA, LOS ANGELES",CA,90405-3035,Proprietary  ,349,393,742,1937,1168,3105
02179947,"ART INSTITUTE OF CALIFORNIA, SAN DIEGO  ",CA,92108-4423,Proprietary  ,329,595,924,1764,1590,3354
02185800,MOLER BARBER COLLEGE                    ,CA,94611-0000,Proprietary  ,9,42,51,36,101,137
02188400,SIERRA VALLEY COLLEGE OF COURT REPORTING,CA,93726-0000,Proprietary  ,10,60,70,42,114,156
02208600,MADERA BEAUTY COLLEGE                   ,CA,93637-3519,Proprietary  ,1,5,6,36,24,60
02211000,SALON SUCCESS ACADEMY                   ,CA,92405-0000,Proprietary  ,17,32,49,58,83,141
02220000,COLLEEN O'HARA BEAUTY ACADEMY           ,CA,92701-0000,Proprietary  ,3,9,12,19,32,51
02220200,CALIFORNIA CULINARY ACADEMY             ,CA,94102-3336,Proprietary  ,55,110,165,263,328,591
02221300,MARINELLO SCHOOL OF BEAUTY              ,CA,92553-0000,Proprietary  ,31,70,101,101,138,239
02221303,MARINELLO SCHOOL OF BEAUTY - SAN RAFAEL ,CA,94901-3224,Proprietary  ,9,26,35,25,47,72
02222000,AMERICAN FILM INSTITUTE                 ,CA,90027-0000,Private      ,65,252,317,366,717,1083
02226000,EAST LOS ANGELES COLLEGE                ,CA,91754-0000,Public       ,2031,3238,5269,13381,11124,24505
02228500,LIFE CHIROPRACTIC COLLEGE WEST          ,CA,94545-0000,Private      ,2,315,317,13,537,550
02230900,FREDRICK & CHARLES BEAUTY COLLEGE       ,CA,95501-0000,Proprietary  ,11,28,39,50,71,121
02231900,GEMOLOGICAL INSTITUTE OF AMERICA        ,CA,92008-4698,Private      ,12,100,112,37,231,268
02236400,"THANH LE COLG, SCH OF COSMETOLOGY       ",CA,92840-0000,Proprietary  ,1,5,6,4,11,15
02237200,PHILLIPS GRADUATE INSTITUTE             ,CA,91316-0000,Private      ,1,48,49,7,141,148
02241800,AMERICAN CAREER COLLEGE                 ,CA,90004-0000,Proprietary  ,356,921,1277,1106,2383,3489
02242700,BERKELEY CITY COLLEGE                   ,CA,94704-0000,Public       ,580,1248,1828,3245,3307,6552
02255400,INTERNATIONAL SCHOOL OF COSMETOLOGY     ,CA,90250-0000,Proprietary  ,82,96,178,128,158,286
02258600,AVALON SCHOOL OF COSMETOLOGY            ,CA,94501-4569,Proprietary  ,29,86,115,85,146,231
02262400,YESHIVA OHR ELCHONON CHABAD             ,CA,90046-0000,Private      ,14,1,15,76,2,78
02267600,INSTITUTE OF TRANSPERSONAL PSYCHLGY     ,CA,94303-4624,Proprietary  ,2,114,116,9,211,220
02270600,LIFE PACIFIC COLLEGE                    ,CA,91773-0000,Private      ,84,70,154,412,192,604
02276800,WESTMINSTER SEMINARY CALIFORNIA         ,CA,92027-0000,Private      ,1,15,16,7,120,127
02277400,SOUTH COAST COLLEGE                     ,CA,92868-2616,Proprietary  ,31,114,145,143,273,416
02282300,ALHAMBRA BEAUTY COLLEGE                 ,CA,91802-0000,Proprietary  ,9,32,41,17,43,60
02285100,HILLTOP BEAUTY SCHOOL                   ,CA,94014-0000,Proprietary  ,5,38,43,10,42,52
02298000,DESIGN INSTITUTE OF SAN DIEGO           ,CA,92121-0000,Proprietary  ,29,78,107,146,209,355
02304300,"PLATT COLLEGE, SAN DIEGO                ",CA,92115-0000,Proprietary  ,28,94,122,133,204,337
02306300,KAPLAN COLLEGE                          ,CA,95368-0000,Proprietary  ,52,172,224,144,351,495
02306302,KAPLAN COLLEGE - FRESNO                 ,CA,93612-3802,Proprietary  ,26,86,112,131,248,379
02309500,CLOVIS ADULT EDUC                       ,CA,93611-0000,Public       ,37,125,162,165,296,461
02330500,LAGUNA COLLEGE OF ART AND DESIGN        ,CA,92651-0000,Private      ,97,58,155,733,254,987
02332800,CENTER FOR EMPLOYMENT TRAINING          ,CA,95110-0000,Private      ,127,601,728,233,901,1134
02338500,GLENDALE CAREER COLLEGE                 ,CA,91203-1207,Proprietary  ,56,156,212,175,319,494
02338700,MARINELLO SCHOOL OF BEAUTY              ,CA,94103-1600,Proprietary  ,20,43,63,78,102,180
02338701,MARINELLO SCHOOL OF BEAUTY - CHICO      ,CA,95928-7184,Proprietary  ,18,75,93,77,112,189
02338702,MARINELLO SCHOOL OF BEAUTY - REDDING    ,CA,96001-1023,Proprietary  ,8,55,63,47,126,173
02338703,MARINELLO SCHOOL OF BEAUTY - FRESNO     ,CA,93711-3246,Proprietary  ,43,98,141,147,189,336
02342400,ACADEMY OF RADIO BROADCASTING           ,CA,92647-3809,Proprietary  ,14,35,49,49,100,149
02343400,BELLUS ACADEMY                          ,CA,92064-4633,Proprietary  ,63,159,222,156,280,436
02351900,KAPLAN COLLEGE                          ,CA,95660-5512,Proprietary  ,75,247,322,328,845,1173
02351901,KAPLAN COLLEGE - BAKERSFIELD            ,CA,93304-0000,Proprietary  ,55,213,268,377,561,938
02358000,THOMAS AQUINAS COLLEGE                  ,CA,93060-9622,Private      ,37,9,46,368,30,398
02359300,SHASTA BIBLE COLLEGE                    ,CA,96002-0000,Private      ,10,13,23,33,51,84
02482700,WESTERN UNIVERSITY OF HEALTH S          ,CA,91766-1854,Private      ,15,654,669,139,5205,5344
02494800,LOLA BEAUTY COLLEGE                     ,CA,92641-0000,Proprietary  ,11,20,31,15,32,47
02497300,TRINITY COLLEGE                         ,CA,93277-8109,Proprietary  ,42,180,222,113,347,460
02500000,SAN JOAQUIN COLLEGE OF LAW              ,CA,93612-0000,Private      ,2,100,102,28,244,272
02518400,THE NATIONAL HISPANIC UNIVERSITY        ,CA,95127-0000,Proprietary  ,13,50,63,93,150,243
02519800,AVANCE BEAUTY COLLEGE                   ,CA,92154-0000,Proprietary  ,26,61,87,86,124,210
02520200,CALIFORNIA CAREER SCHOOLS               ,CA,92805-0000,Proprietary  ,6,37,43,43,122,165
02520300,INTERIOR DESIGNERS INSTITUTE            ,CA,92660-0000,Proprietary  ,7,26,33,32,58,90
02520400,ADRIAN'S BEAUTY COLLEGE OF TURLOCK      ,CA,95382-0000,Proprietary  ,9,28,37,50,68,118
02531801,PAUL MITCHELL THE SCHOOL-COSTA MESA     ,CA,92626-3804,Proprietary  ,57,75,132,137,144,281
02531804,PAUL MITCHELL THE SCHOOL - SAN DIEGO    ,CA,92101-0000,Proprietary  ,48,103,151,187,236,423
02537200,PALOMAR INSTITUTE OF COSMETOLOGY        ,CA,92069-0000,Proprietary  ,40,79,119,127,162,289
02539100,KAPLAN COLLEGE                          ,CA,91606-3231,Proprietary  ,111,328,439,228,607,835
02539102,KAPLAN COLLEGE -  RIVERSIDE             ,CA,92507-4223,Proprietary  ,72,188,260,283,487,770
02539500,IRVINE VALLEY COLLEGE                   ,CA,92620-0000,Public       ,861,1117,1978,5994,3711,9705
02542300,NATIONAL HOLISTIC INSTITUTE             ,CA,94608-0000,Proprietary  ,47,267,314,113,554,667
02543400,BROWNSON TECHNICAL SCHOOL               ,CA,92805-0000,Proprietary  ,10,53,63,23,82,105
02545900,HYPNOSIS MOTIVATION INSTITUTE           ,CA,91356-0000,Private      ,1,22,23,3,45,48
02546400,MTI BUSINESS COLLEGE INC                ,CA,95207-0000,Proprietary  ,6,63,69,38,135,173
02549000,KAPLAN COLLEGE                          ,CA,92083-7736,Proprietary  ,82,233,315,260,656,916
02549005,KAPLAN COLLEGE -  PALM SPRINGS          ,CA,92262-7011,Proprietary  ,46,104,150,259,352,611
02553500,ASSOCIATED TECHNICAL COLLEGE            ,CA,92101-0000,Proprietary  ,22,96,118,87,175,262
02553600,DIVERSIFIED LANGUAGE INSTITUTE          ,CA,90017-0000,Proprietary  ,20,237,257,35,314,349
02559300,UNITED EDUCATION INSTITUTE              ,CA,90020-0000,Proprietary  ,384,873,1257,660,1585,2245
02559400,INTERCOAST COLLEGES                     ,CA,92868-1656,Proprietary  ,87,589,676,147,927,1074
02570300,LOS ANGELES ORT TECHNICAL INSTITUTE     ,CA,90048-4904,Private      ,51,227,278,170,405,575
02577900,SANTA BARBARA BUSINESS COLLEGE          ,CA,93309-1664,Proprietary  ,77,242,319,326,582,908
02578000,SANTA BARBARA BUSINESS COLLEGE          ,CA,93454-6943,Proprietary  ,47,101,148,132,227,359
02591600,NORTH-WEST COLLEGE                      ,CA,91101-1744,Proprietary  ,28,84,112,96,194,290
02595600,ASIAN AMERICAN INTERNATIONAL BTY CG     ,CA,92683-4043,Proprietary  ,0,8,8,9,21,30
02596400,CRIMSON TECHNICAL COLLEGE - LOS ANGELES ,CA,90301-2904,Proprietary  ,47,104,151,144,318,462
02597300,SOUTH BAYLO UNIVERSITY                  ,CA,92801-1701,Private      ,0,68,68,7,157,164
02602300,CENTRAL COAST COLLEGE                   ,CA,93901-3301,Proprietary  ,38,90,128,165,226,391
02608900,PINNACLE COLLEGE                        ,CA,91803-8842,Proprietary  ,13,29,42,47,48,95
02608901,PINNACLE COLLEGE - SACRAMENTO           ,CA,95670-6386,Proprietary  ,13,24,37,47,78,125
02609000,EMPERORS COLG OF TRAD ORIENTAL MED      ,CA,90403-5609,Proprietary  ,2,48,50,4,110,114
03010611,VIRGINIA COLLEGE - GOLF ACADEMY OF AMERI,CA,92008-6512,Proprietary  ,13,50,63,22,78,100
03011300,"CALIF STATE UNIV, SAN MARCOS            ",CA,92096-0001,Public       ,939,1590,2529,17068,7754,24822
03019900,CAPSTONE COLLEGE                        ,CA,91402-0000,Proprietary  ,7,11,18,20,26,46
03025600,DELL'ARTE SCH OF PHYSICAL THEATRE       ,CA,95525-0816,Private      ,1,13,14,4,23,27
03027700,PACIFIC COLLEGE OF ORIENTAL MED         ,CA,92108-4408,Proprietary  ,10,158,168,46,406,452
03029600,POMONA ADULT SCHOOL                     ,CA,91766-0000,Public       ,24,84,108,70,157,227
03031409,INTERNATIONAL ACADEMY OF DESIGN AND TECH,CA,95834-9664,Proprietary  ,13,44,57,104,142,246
03035700,LAS POSITAS COLLEGE                     ,CA,94551-6750,Public       ,743,856,1599,2799,1966,4765
03039900,FREMONT COLLEGE                         ,CA,90703-5342,Proprietary  ,45,179,224,248,371,619
03043900,NEWSCHOOL OF ARCHITECTURE & DESIGN      ,CA,92101-6634,Proprietary  ,32,122,154,255,380,635
03054100,ROYALE COLLEGE OF BEAUTY                ,CA,92590-2525,Proprietary  ,21,43,64,59,75,134
03062300,WESTECH COLLEGE                         ,CA,91764-4988,Proprietary  ,63,196,259,139,317,456
03062400,MT DIABLO ADULT EDUC LOMA VISTA CTR     ,CA,94518-1122,Public       ,20,84,104,73,173,246
03062700,PLATT COLLEGE                           ,CA,90041-0000,Proprietary  ,101,172,273,400,601,1001
03062701,PLATT COLLEGE                           ,CA,91764-0000,Proprietary  ,62,154,216,283,444,727
03062702,PLATT COLLEGE - RIVERSIDE               ,CA,92507-0730,Proprietary  ,76,144,220,420,467,887
03063400,MODERN TECHNOLOGY SCHOOL                ,CA,92708-9821,Proprietary  ,7,42,49,30,114,144
03067400,BALDWIN PARK ADULT SCHOOL               ,CA,91706-4897,Public       ,40,66,106,104,160,264
03067500,INSTITUTE OF TECHNOLOGY                 ,CA,93612-3217,Proprietary  ,136,410,546,294,803,1097
03069500,SAGE COLLEGE                            ,CA,92557-6720,Proprietary  ,31,207,238,65,451,516
03072300,EVEREST COLLEGE                         ,CA,91761-3222,Proprietary  ,14,48,62,109,236,345
03072700,WESTWOOD COLLEGE - LOS ANGELES          ,CA,90010-1577,Proprietary  ,142,642,784,612,1692,2304
03078200,AMERICAN CLG TRADITIONAL CHINESE MD     ,CA,94107-2813,Private      ,3,33,36,8,96,104
03084700,VENTURA ADULT\CONTINUING EDUCATION      ,CA,93003-7313,Public       ,13,67,80,37,167,204
03094400,MARINELLO SCHOOL OF BEAUTY              ,CA,95841-2909,Proprietary  ,35,112,147,165,255,420
03094401,MARINELLO SCHOOL OF BEAUTY - CONCORD    ,CA,94520-2581,Proprietary  ,22,56,78,56,124,180
03094402,MARINELLO SCHOOL OF BEAUTY- STOCKTON    ,CA,95203-3149,Proprietary  ,26,74,100,97,157,254
03097700,CENTRAL CALIF SCH CONTINUING EDUC       ,CA,93401-6739,Proprietary  ,13,49,62,32,97,129
03098200,YO SAN UNIV TRADITIONAL CHINESE MED     ,CA,90066-1103,Private      ,0,31,31,4,80,84
03108100,SUMMIT COLLEGE                          ,CA,92324-3956,Proprietary  ,109,289,398,238,510,748
03109500,DONGGUK  UNIVERSITY LOS ANGELES         ,CA,90020-1765,Private      ,2,28,30,18,70,88
03113300,UEI COLLEGE                             ,CA,93727-0000,Proprietary  ,99,374,473,380,815,1195
03113600,SOUTHERN CALIFORNIA INST OF TECHNOL     ,CA,92805-3758,Proprietary  ,39,160,199,105,400,505
03116600,EAST SAN GABRIEL VLY REG OCCUP PROG     ,CA,91790-2105,Public       ,51,114,165,251,214,465
03125300,JOHN WESLEY INTER. BARBER & BTY CLG     ,CA,90813-4321,Proprietary  ,16,57,73,57,140,197
03125800,PREMIERE CAREER COLLEGE                 ,CA,91706-3746,Proprietary  ,29,95,124,50,152,202
03126800,PACIFICA GRADUATE INSTITUTE             ,CA,93013-0000,Proprietary  ,1,298,299,3,567,570
03128700,MT SIERRA COLLEGE                       ,CA,91016-3414,Proprietary  ,58,59,117,236,256,492
03131300,FIVE BRANCHES UNIVERSITY                ,CA,95062-4669,Proprietary  ,5,109,114,12,200,212
03144400,AMERICAN CLG OF HEALTH PROFESSIONS      ,CA,92505-3038,Proprietary  ,48,122,170,163,271,434
03150500,VIRGINIA SEWING MACHINES & SCH CTR      ,CA,90015-3535,Proprietary  ,3,14,17,7,27,34
03162300,FOUR-D SUCCESS ACADEMY                  ,CA,92324-4218,Proprietary  ,35,197,232,82,327,409
03163300,PACIFIC STATES UNIVERSITY               ,CA,90006-0000,Private      ,9,22,31,47,60,107
03195400,EVEREST COLLEGE                         ,CA,90501-2867,Proprietary  ,9,25,34,49,108,157
03210300,LE CORDON BLEU COLLEGE OF CULINARY ARTS ,CA,91101-5221,Proprietary  ,372,693,1065,1125,1431,2556
03225300,AMERICAN UNIVERSITY OF HEALTH SCIENCES  ,CA,90755-3612,Proprietary  ,25,105,130,78,325,403
03242300,CAREER NETWORK INSTITUTE                ,CA,92868-4710,Proprietary  ,39,240,279,81,401,482
03250300,COMMUNITY BASED EDUCATION AND DEVELOPMEN,CA,90010-2722,Private      ,40,102,142,103,249,352
03260300,CALIFORNIA STATE U-MONTEREY BAY         ,CA,93955-8001,Public       ,448,785,1233,14705,4104,18809
03266300,BETHESDA UNIVERSITY OF CALIFORNIA       ,CA,92801-4132,Private      ,33,22,55,143,112,255
03278300,CHARTER COLLEGE                         ,CA,91351-5432,Proprietary  ,90,253,343,140,375,515
03288300,ACAD CHINESE CULTURE & HEALTH SCIS      ,CA,94512-0000,Private      ,7,50,57,23,110,133
03299300,PACIFIC COLLEGE                         ,CA,92626-3160,Proprietary  ,30,171,201,81,313,394
03308300,BRISTOL UNIVERSITY                      ,CA,92806-6198,Proprietary  ,44,45,89,139,122,261
03327400,ACUPUNCTURE AND INTEGRATIVE MEDICINE COL,CA,94704-2724,Private      ,5,35,40,24,111,135
03332300,SOUTHERN CA BIBLE CLG & SEMINARY        ,CA,92019-1109,Private      ,2,44,46,8,145,153
03359300,ST. FRANCIS CAREER COLLEGE              ,CA,90262-2659,Proprietary  ,34,65,99,101,181,282
03367300,PROFESSIONAL GOLFERS CAREER COLLEGE     ,CA,92591-6013,Proprietary  ,18,24,42,54,53,107
03395300,INTERNATIONAL CAREER DEVELOPMENT        ,CA,90027-5794,Proprietary  ,225,2389,2614,384,4162,4546
03399300,NORTHWESTERN TECHNICAL COLLEGE          ,CA,95670-4443,Proprietary  ,2,5,7,10,10,20
03403300,EPIC BIBLE COLLEGE                      ,CA,95841-3546,Private      ,12,80,92,66,253,319
03413400,ENGLISH CENTER  (THE)                   ,CA,94607-3734,Private      ,2,52,54,7,94,101
03427500,UNIVERSITY OF ANTELOPE VALLEY           ,CA,93534-3324,Proprietary  ,121,282,403,461,650,1111
03440400,MARIAN HEALTH CAREERS CENTER            ,CA,90010-1728,Proprietary  ,17,51,68,38,86,124
03458300,MY LE'S BEAUTY COLLEGE                  ,CA,95824-0000,Proprietary  ,12,53,65,65,122,187
03467300,MARINELLO SCHOOL OF BEAUTY              ,CA,92545-3661,Proprietary  ,28,75,103,52,114,166
03467302,MARINELLO SCHOOL OF BEAUTY - MURRIETA   ,CA,92563-5039,Proprietary  ,30,51,81,82,102,184
03467303,MARINELLO SCHOOL OF BEAUTY - NAPA       ,CA,94559-1237,Proprietary  ,9,29,38,29,57,86
03467304,MARINELLO SCHOOL OF BEAUTY - CITY OF IND,CA,91748-1674,Proprietary  ,15,40,55,29,49,78
03467305,MARINELLO SCHOOL OF BEAUTY - BELL       ,CA,90201-1193,Proprietary  ,21,28,49,46,63,109
03467306,MARINELLO SCHOOL OF BEAUTY - PARAMOUNT  ,CA,90723-5256,Proprietary  ,32,58,90,75,111,186
03467307,MARINELLO SCHOOL OF BEAUTY - HUNTINGTON ,CA,92646-2552,Proprietary  ,9,43,52,50,88,138
03479300,PROFESSIONAL CAREER INSTITUTE           ,CA,90703-2522,Proprietary  ,11,34,45,44,66,110
03516300,KING'S UNIVERSITY (THE)                 ,CA,91405-2233,Private      ,49,157,206,119,308,427
03532400,ADVANCED TRAINING ASSOCIATES            ,CA,92020-1236,Proprietary  ,4,43,47,16,86,102
03542400,COPPER MOUNTAIN COLLEGE                 ,CA,92252-6102,Public       ,233,650,883,575,1316,1891
03577300,COBA ACADEMY                            ,CA,92866-1407,Proprietary  ,3,17,20,16,30,46
03590400,NTMA TRAINING CENTERS OF SOUTHERN C     ,CA,90650-0000,Private      ,41,135,176,70,220,290
03592400,IRELL & MANELLA GRADUATE SCHOOL OF BIOLO,CA,91010-0000,Private      ,0,0,0,4,6,10
03598300,AVALON BEAUTY COLLEGE                   ,CA,93103-3137,Proprietary  ,17,29,46,62,63,125
03614300,DAVID'S ACADEMY OF BEAUTY               ,CA,91780-1089,Proprietary  ,5,21,26,11,34,45
03639300,WEST COAST ULTRASOUND INSTITUTE         ,CA,90211-3312,Proprietary  ,142,554,696,299,974,1273
03646300,DESIGN'S SCHOOL OF COSMETOLOGY          ,CA,93446-9530,Proprietary  ,20,55,75,45,91,136
03681300,CALIFORNIA HEALING ARTS COLLEGE         ,CA,90025-0000,Proprietary  ,19,90,109,70,182,252
03695300,COMMUNITY ENHANCEMENT SERVICES          ,CA,91502-2750,Private      ,5,58,63,10,71,81
03695700,SANTIAGO CANYON COLLEGE                 ,CA,92869-4512,Public       ,698,758,1456,3885,2055,5940
03696300,UNIVERSITY OF THE WEST                  ,CA,91770-3709,Private      ,1,15,16,51,75,126
03698300,WEST COAST UNIVERSITY                   ,CA,91606-3206,Proprietary  ,412,1566,1978,1544,4805,6349
03736300,ADVANCE BEAUTY COLLEGE                  ,CA,92843-4752,Proprietary  ,15,144,159,35,219,254
03736301,ADVANCE BEAUTY COLLEGE - LAGUNA HILLS   ,CA,92653-1980,Proprietary  ,3,9,12,22,33,55
03740400,ATI COLLEGE                             ,CA,90650-0000,Proprietary  ,14,50,64,34,97,131
03752400,SCHOOL OF URBAN MISSIONS                ,CA,94603-0000,Private      ,82,139,221,129,219,348
03759300,COMPUTER TUTOR BUSINESS & TECH INST     ,CA,95356-0000,Proprietary  ,7,40,47,47,129,176
03786300,ADVANCED COLLEGE                        ,CA,90280-5255,Proprietary  ,11,34,45,43,83,126
03797400,CAREER CARE INSTITUTE                   ,CA,93534-4766,Proprietary  ,102,292,394,172,473,645
03797401,CAREER CARE INSTITUTE - VENTURA         ,CA,93001-0000,Proprietary  ,9,46,55,50,121,171
03797402,CAREER CARE INSTITUTE - MORENO VALLEY   ,CA,92553-7519,Proprietary  ,5,23,28,46,69,115
03814400,SOKA UNIVERSITY OF AMERICA              ,CA,92656-8081,Private      ,13,8,21,516,62,578
03853300,KECK GRADUATE INSTITUTE OF APPLIED LIFE ,CA,91711-4817,Private      ,0,109,109,18,328,346
03868300,WORLD MISSION UNIVERSITY                ,CA,90020-1789,Private      ,3,55,58,10,74,84
03868400,LOS ANGELES MUSIC ACADEMY               ,CA,91105-2540,Proprietary  ,35,48,83,162,130,292
03871300,FOLSOM LAKE COLLEGE                     ,CA,95630-6798,Public       ,697,1262,1959,3387,3247,6634
03874300,CAMBRIDGE JUNIOR COLLEGE                ,CA,95993-0000,Proprietary  ,32,82,114,154,296,450
03874400,COMMMUNITY CHRISTIAN COLLEGE            ,CA,92373-4465,Private      ,15,18,33,84,55,139
03889300,STANBRIDGE COLLEGE                      ,CA,92612-0000,Proprietary  ,98,363,461,352,1234,1586
03910400,NATIONAL POLYTECHNIC COLLEGE            ,CA,90040-3066,Proprietary  ,24,38,62,44,73,117
03933300,MUELLER COLLEGE OF HOLISTIC STUDIES     ,CA,92116-2630,Proprietary  ,5,54,59,21,142,163
03935300,CALIFORNIA NURSES EDUCATIONAL INSTITUTE ,CA,92234-7248,Proprietary  ,24,108,132,69,196,265
03962300,AMERICAN INSTITUTE OF MASSAGE THERAPY   ,CA,92705-5463,Proprietary  ,4,37,41,28,82,110
03964400,INTERNATIONAL SCHOOL OF BEAUTY          ,CA,92260-2740,Proprietary  ,16,67,83,74,137,211
03969600,UEI COLLEGE                             ,CA,90703-2637,Proprietary  ,121,381,502,311,719,1030
03971300,AMERICAN CAREER COLLEGE                 ,CA,91764-4906,Proprietary  ,189,386,575,591,1146,1737
03973300,EX'PRESSION COLLEGE FOR DIGTAL ARTS     ,CA,94608-1021,Proprietary  ,76,88,164,364,268,632
03974500,CALIFORNIA CAREER COLLEGE               ,CA,91303-2006,Proprietary  ,8,31,39,27,84,111
03980300,CALIFORNIA STATE UNIVERSITY CHANNEL ISLA,CA,93012-8599,Public       ,366,511,877,10324,3805,14129
03995300,UNIVERSITY OF EAST-WEST MEDICINE        ,CA,94085-3922,Proprietary  ,0,18,18,9,43,52
03999300,BEAUMONT ADULT SCHOOL                   ,CA,92223-1927,Public       ,9,50,59,20,81,101
04001300,PALACE BEAUTY COLLEGE                   ,CA,90006-4233,Proprietary  ,11,45,56,52,96,148
04003300,BLAKE AUSTIN COLLEGE                    ,CA,95687-3100,Proprietary  ,73,192,265,142,353,495
04004300,THUY PRINCESS BEAUTY COLLEGE            ,CA,91766-0000,Proprietary  ,4,15,19,9,18,27
04005300,UNITED STATES UNIVERSITY                ,CA,91911-1683,Proprietary  ,7,88,95,41,219,260
04014400,PALLADIUM TECHNICAL ACADEMY             ,CA,91731-2429,Proprietary  ,1,9,10,6,21,27
04037300,LOS ANGELES FILM SCHOOL (THE)           ,CA,90028-7300,Proprietary  ,426,753,1179,1379,1786,3165
04056300,CAREER COLLEGE OF CALIFORNIA            ,CA,92705-5805,Proprietary  ,14,48,62,60,129,189
04057300,ASHER COLLEGE                           ,CA,95825-4025,Proprietary  ,21,239,260,117,439,556
04076400,GNOMON SCHOOL OF VISUAL EFFECTS         ,CA,90038-2616,Proprietary  ,28,87,115,123,176,299
04088300,WESTMED COLLEGE                         ,CA,95128-2541,Private      ,20,63,83,109,198,307
04088301,WESTMED COLLEGE - MERCED                ,CA,95340-9165,Private      ,19,70,89,96,206,302
04088302,WESTMED COLLEGE - FRESNO                ,CA,93720-1551,Private      ,12,36,48,34,70,104
04088303,WESTMED COLLEGE - CHULA VISTA           ,CA,91910-5200,Private      ,5,14,19,11,26,37
04092300,COASTLINE BEAUTY COLLEGE                ,CA,92708-3847,Proprietary  ,13,36,49,48,81,129
04092400,MAKE-UP DESIGNORY                       ,CA,91502-1322,Proprietary  ,51,79,130,163,172,335
04100400,TAFT UNIVERSITY SYSTEM (THE)            ,CA,92704-6954,Proprietary  ,0,121,121,6,285,291
04111300,WEST HILLS COLLEGE LEMOORE              ,CA,93245-9248,Public       ,375,997,1372,2137,2266,4403
04114500,VALLEY COLLEGE OF MEDICAL CAREERS       ,CA,91304-2354,Proprietary  ,14,40,54,35,73,108
04115300,COACHELLA VALLEY BEAUTY COLLEGE         ,CA,92253-2051,Proprietary  ,32,48,80,65,87,152
04115600,MAYFIELD COLLEGE                        ,CA,92234-7014,Proprietary  ,53,179,232,89,247,336
04118800,NEW YORK FILM ACADEMY                   ,CA,91608-1002,Proprietary  ,203,281,484,655,677,1332
04119200,CAREER COLLEGE CONSULTANTS              ,CA,90041-2088,Proprietary  ,10,35,45,24,46,70
04119800,GDS INSTITUTE                           ,CA,90280-2072,Proprietary  ,6,7,13,10,14,24
04126400,CHAMPION INSTITUTE OF COSMETOLOGY       ,CA,92264-7458,Proprietary  ,2,20,22,23,38,61
04126500,COAST CAREER INSTITUTE                  ,CA,90015-3040,Proprietary  ,34,115,149,41,145,186
04127100,"UNIVERSITY OF CALIFORNIA, MERCED        ",CA,95343-5001,Public       ,230,143,373,16915,1918,18833
04127900,TRIDENT UNIVERSITY INTERNATIONAL        ,CA,90630-5023,Proprietary  ,38,1651,1689,66,2750,2816
04129700,INTERNATIONAL POLYTECHNIC INSTITUTE     ,CA,92231-1737,Private      ,4,8,12,16,22,38
04129803,MEDIATECH INSTITUTE - OCEANSIDE         ,CA,92054-5116,Proprietary  ,9,41,50,39,93,132
04132400,ACADEMY OF ESTHETICS AND COSMETOLOGY    ,CA,91342-3373,Proprietary  ,8,20,28,32,44,76
04132700,INFOTECH CAREER COLLEGE                 ,CA,90706-5579,Proprietary  ,14,24,38,30,59,89
04133100,CALIFORNIA UNIVERSITY OF MANAGEMENT AND ,CA,92801-1702,Private      ,5,19,24,17,55,72
04134500,CAREER COLLEGE OF SAN DIEGO             ,CA,92102-3348,Proprietary  ,37,120,157,149,283,432
04134700,INTERNATL PROFESSIONAL SCHL OF BODYWORK ,CA,92123-1520,Proprietary  ,7,38,45,20,101,121
04137200,BORNER'S BARBER COLLEGE                 ,CA,90047-3856,Proprietary  ,12,68,80,57,146,203
04138700,PAUL MITCHELL THE SCHOOL - PASADENA     ,CA,91801-3903,Proprietary  ,33,64,97,95,110,205
04140500,HORIZON UNIVERSITY                      ,CA,92111-2622,Private      ,8,23,31,25,69,94
04141300,SAN FRANCISCO INSTITUTE OF ESTHETICS    ,CA,94103-4083,Proprietary  ,31,62,93,73,124,197
04141400,LAURUS COLLEGE                          ,CA,93401-5405,Proprietary  ,50,341,391,102,646,748
04141700,HEALING HANDS SCHOOL OF HOLISTIC HEALTH ,CA,92025-1722,Proprietary  ,14,54,68,32,132,164
04142500,TOURO COLLEGE LOS ANGELES               ,CA,90046-4506,Private      ,25,173,198,98,385,483
04142600,TOURO UNIVERSITY                        ,CA,94592-1118,Private      ,11,1148,1159,50,2536,2586
04143800,WOODLAND COMMUNITY COLLEGE              ,CA,95776-5156,Public       ,288,476,764,1298,1344,2642
04144200,CAREER DEVELOPMENT INSTITUTE            ,CA,90035-4364,Proprietary  ,23,58,81,38,110,148
04145000,SAN DIEGO CULINARY INSTITUTE            ,CA,91941-6435,Proprietary  ,48,121,169,244,306,550
04145600,INTERNATIONAL COLLEGE OF COSMETOLOGY    ,CA,94601-3525,Proprietary  ,8,34,42,38,87,125
04146000,NATIONAL CAREER COLLEGE                 ,CA,91605-1400,Proprietary  ,17,103,120,37,148,185
04148200,BEYOND 21ST CENTURY BEAUTY ACADEMY      ,CA,90670-6316,Proprietary  ,10,10,20,25,25,50
04148900,N CALIF INSTITUTE OF COSMETOLOGY        ,CA,94577-2820,Proprietary  ,7,16,23,12,28,40
04149700,HOMESTEAD SCHOOLS                       ,CA,90505-5945,Private      ,17,71,88,29,110,139
04150000,CENTRAL NURSING COLLEGE                 ,CA,90010-2444,Proprietary  ,0,0,0,9,5,14
04150100,GOLDEN STATE COLLEGE OF COURT REPORTING ,CA,94568-2948,Proprietary  ,1,17,18,11,30,41
04150300,RWM FIBER OPTICS                        ,CA,90746-1051,Proprietary  ,7,46,53,12,52,64
04150500,"PREFERRED COLLEGE OF NURSING, LOS ANGELE",CA,90010-2202,Proprietary  ,15,54,69,59,137,196
04152800,CALIFORNIA ACADEMY (THE) - A PAUL MITCHE,CA,95825-2276,Proprietary  ,86,212,298,303,418,721
04153900,PROVIDENCE CHRISTIAN COLLEGE            ,CA,91104-2635,Private      ,42,14,56,185,34,219
04155500,"ACADEMY FOR JEWISH RELIGION, CALIFORNIA ",CA,90024-3234,Private      ,3,25,28,19,62,81
04156100,TONI & GUY HAIRDRESSING ACADEMY         ,CA,95356-9695,Proprietary  ,16,32,48,72,103,175
04157800,GRACE MISSION UNIVERSITY                ,CA,92833-3860,Private      ,1,9,10,5,27,32
04158200,PAUL MITCHELL THE SCHOOL SHERMAN OAKS   ,CA,91403-5882,Proprietary  ,25,58,83,87,123,210
04158700,HOLLYWOOD BEAUTY COLLEGE                ,CA,95210-3514,Proprietary  ,0,0,0,4,4,8
04158800,THEATRE OF ARTS                         ,CA,90028-6111,Proprietary  ,3,15,18,3,15,18
04158900,FLAIR BEAUTY COLLEGE                    ,CA,91351-3381,Proprietary  ,12,16,28,25,35,60
04159600,GALAXY MEDICAL COLLEGE                  ,CA,91606-1593,Proprietary  ,1,10,11,37,31,68
04159700,AMERICAN MEDICAL SCIENCES CENTER        ,CA,91204-5108,Proprietary  ,6,17,23,33,46,79
04160100,TRINITY SCHOOL OF HEALTH AND ALLIED SCIE,CA,90248-4334,Proprietary  ,6,50,56,7,59,66
04160400,ANGELES COLLEGE OF NURSING              ,CA,90010-2100,Proprietary  ,66,159,225,343,433,776
04161300,PREFERRED COLLEGE OF NURSING            ,CA,91401-1442,Proprietary  ,3,7,10,25,33,58
04161700,SHASTA SCHOOL OF COSMETOLOGY            ,CA,96003-0000,Proprietary  ,18,28,46,66,76,142
04161800,BRANDMAN UNIVERSITY                     ,CA,92618-3801,Private      ,88,2149,2237,343,5383,5726
04162800,S.I.C.E PAUL MITCHELL PARTNER SCHOOL    ,CA,95350-1440,Proprietary  ,44,101,145,144,195,339
04163400,COSMO BEAUTY ACADEMY                    ,CA,95605-1904,Proprietary  ,24,70,94,150,196,346
04164400,ANGELES INSTITUTE                       ,CA,90712-2903,Proprietary  ,31,92,123,55,133,188
04165900,PAUL MITCHELL THE SCHOOL FRESNO         ,CA,93710-7617,Proprietary  ,59,77,136,259,193,452
04167000,PAUL MITCHELL THE SCHOOL TEMECULA       ,CA,92591-4663,Proprietary  ,66,94,160,181,177,358
04169200,TRAMY BEAUTY SCHOOL                     ,CA,92115-6347,Proprietary  ,20,74,94,71,130,201
04169700,UNITEK COLLEGE                          ,CA,94538-3185,Proprietary  ,116,636,752,347,1525,1872
04169800,GURNICK ACADEMY OF MEDICAL ARTS         ,CA,94403-1849,Proprietary  ,58,417,475,236,1307,1543
04172000,SOUTHERN CALIFORNIA UNIVERSITY SOMA     ,CA,90017-2211,Proprietary  ,22,69,91,154,207,361
04173400,SANTA ANA BEAUTY ACADEMY                ,CA,92705-7820,Proprietary  ,3,10,13,31,31,62
04173500,MORENO VALLEY COLLEGE                   ,CA,92551-2204,Public       ,836,1566,2402,4405,4889,9294
04175200,PAUL MITCHELL THE SCHOOL EAST BAY       ,CA,94523-5515,Proprietary  ,61,67,128,162,146,308
04175400,ELITE COSMETOLOGY SCHOOL                ,CA,92284-2860,Proprietary  ,8,32,40,19,51,70
04176100,NORCO COLLEGE                           ,CA,92860-2600,Public       ,740,1121,1861,4504,3788,8292
04176300,BERGIN UNIVERSITY OF CANINE STUDIES     ,CA,95407-6834,Private      ,2,15,17,19,48,67
04177200,REAL BARBERS COLLEGE (THE)              ,CA,92805-2533,Proprietary  ,18,44,62,39,62,101
04178900,HANDS-ON MEDICAL MASSAGE SCHOOL         ,CA,92373-6271,Proprietary  ,5,15,20,10,34,44
04180000,CINTA AVEDA INSTITUTE                   ,CA,94108-3204,Proprietary  ,46,103,149,117,228,345
04181200,SOUTHERN CALIFORNIA HEALTH INSTITUTE    ,CA,91601-3100,Proprietary  ,22,85,107,58,156,214
04181600,INTEGRITY COLLEGE OF HEALTH             ,CA,91104-2300,Proprietary  ,5,47,52,19,70,89
04185200,SALINAS BEAUTY COLLEGE                  ,CA,93901-2405,Proprietary  ,8,15,23,29,41,70
04185500,ACADEMY OF COUTURE ART                  ,CA,90069-5701,Proprietary  ,16,41,57,86,119,205
04185600,MEDICAL ALLIED CAREER CENTER            ,CA,90670-4710,Proprietary  ,6,32,38,20,65,85
04185700,ACADEMY FOR SALON PROFESSIONALS (THE)   ,CA,95050-4057,Proprietary  ,9,33,42,44,68,112
04186900,"INTERNATIONAL COLLEGE OF BEAUTY, ARTS & ",CA,90039-1012,Proprietary  ,20,77,97,88,140,228
04189300,ALLIED AMERICAN UNIVERSITY              ,CA,92653-1337,Proprietary  ,28,950,978,61,1651,1712
04189700,CALIFORNIA MIRAMAR UNIVERSITY           ,CA,92126-7501,Proprietary  ,55,178,233,338,489,827
04189800,ACADEMY FOR SALON PROFESSIONALS         ,CA,91304-2305,Proprietary  ,13,23,36,37,75,112
04190800,SANTA ANA BEAUTY COLLEGE                ,CA,92706-2321,Proprietary  ,8,38,46,62,85,147
04190900,SUTTER BEAUTY COLLEGE                   ,CA,95991-3624,Proprietary  ,13,32,45,43,70,113
04191300,ANNENBERG SCHOOL OF NURSING             ,CA,91335-5426,Private      ,5,26,31,38,66,104
04192500,WESTCHESTER COLLEGE OF NURSING & ALLIED ,CA,90045-3647,Proprietary  ,7,25,32,24,52,76
04193500,LEMELANGE ACADEMY OF HAIR               ,CA,94558-2935,Proprietary  ,4,8,12,16,24,40
04193700,JOHN PAUL THE GREAT CATHOLIC UNIVERSITY ,CA,92131-1652,Private      ,76,63,139,260,117,377
04194300,COLTON-REDLANDS-YUCAIPA REGIONAL OCCUPAT,CA,92374-2896,Public       ,14,30,44,68,100,168
04194600,BRAND COLLEGE                           ,CA,91203-3646,Proprietary  ,0,14,14,6,43,49
04195200,DIAMOND BEAUTY COLLEGE                  ,CA,91733-2180,Proprietary  ,0,11,11,8,19,27
04195400,NCP COLLEGE OF NURSING                  ,CA,94080-1005,Proprietary  ,25,81,106,82,183,265
04195401,NCP COLLEGE OF NURSING - HAYWARD CAMPUS ,CA,94541-7026,Proprietary  ,28,105,133,88,222,310
04205800,"SAE INSTITUTE OF TECHNOLOGY, LOS ANGELES",CA,90028-7219,Proprietary  ,44,72,116,149,176,325
04206800,ADVANCE BEAUTY TECHS ACADEMY            ,CA,92583-6572,Proprietary  ,12,23,35,40,46,86
04208100,UKIAH ADULT SCHOOL                      ,CA,95482-3865,Public       ,3,19,22,16,60,76
04208400,RIVERSIDE COUNTY OFFICE OF EDUCATION    ,CA,92503-3504,Public       ,36,95,131,239,283,522
04208900,ADVANCED CAREER INSTITUTE               ,CA,93291-9254,Proprietary  ,8,88,96,47,143,190
04209000,SAN FRANCISCO COLLEGE OF COSMETOLOGY    ,CA,94110-1217,Proprietary  ,10,32,42,82,71,153
04209800,HINTON BARBER COLLEGE                   ,CA,94590-4547,Proprietary  ,7,18,25,23,47,70
04210600,ADVANCED COMPUTING INSTITUTE            ,CA,90010-3911,Proprietary  ,17,68,85,114,140,254
04211900,XAVIER COLLEGE SCHOOL OF NURSING        ,CA,95202-1332,Proprietary  ,26,83,109,118,230,348
04212000,LAWRENCE & COMPANY COLLEGE OF COSMETOLOG,CA,93230-4102,Proprietary  ,27,38,65,63,67,130
04215100,CALIFORNIA CAREER INSTITUTE             ,CA,92840-2816,Proprietary  ,11,69,80,39,133,172
04215300,COSMO FACTORY COSMETOLOGY ACADEMY (THE) ,CA,95060-4401,Proprietary  ,3,9,12,27,30,57
04216300,UEI COLLEGE                             ,CA,95065-1520,Proprietary  ,0,3,3,32,31,63
04217100,RUDOLF STEINER COLLEGE                  ,CA,95628-6811,Private      ,0,44,44,0,61,61
04217400,HIGH TECH HIGH GRADUATE SCHOOL OF EDUCAT,CA,92106-6025,Private      ,2,21,23,19,61,80
04217500,W INSTITUTE OF COSMETOLOGY              ,CA,94521-5385,Proprietary  ,6,19,25,16,40,56
04221700,ZMS THE ACADEMY                         ,CA,90042-4231,Proprietary  ,5,5,10,7,9,16
04221800,TONI&GUY HAIRDRESSING ACADEMY           ,CA,95337-5703,Proprietary  ,14,32,46,36,52,88
04221900,COMPUTER TRAINING ACADEMY               ,CA,92507-2122,Proprietary  ,14,89,103,78,206,284
04222200,FAB SCHOOL (THE)                        ,CA,92507-3434,Proprietary  ,33,57,90,89,115,204
04223700,BAY AREA MEDICAL ACADEMY                ,CA,94102-2844,Proprietary  ,29,90,119,155,225,380
04226100,LAWRENCE AND COMPANY COLLEGE OF COSMETOL,CA,93662-3509,Proprietary  ,21,16,37,33,34,67
04228100,HIGH DESERT MEDICAL COLLEGE             ,CA,93534-1134,Proprietary  ,79,254,333,176,454,630
04228800,BAY AREA COLLEGE OF NURSING             ,CA,94303-4617,Proprietary  ,9,26,35,42,87,129
04234000,SAN FRANCISCO SCHOOL OF DIGITAL FILMMAKI,CA,94103-2835,Proprietary  ,12,26,38,72,95,167
04235500,PRESIDIO GRADUATE SCHOOL                ,CA,94129-1749,Private      ,1,42,43,3,98,101
04237100,SALON PROFESSIONAL ACADEMY (THE)        ,CA,95129-5101,Proprietary  ,18,52,70,66,108,174
04237600,CALIFORNIA JAZZ CONSERVATORY            ,CA,94704-1268,Private      ,1,11,12,1,11,12
04237800,CALIFORNIA BARBER AND BEAUTY COLLEGE    ,CA,92115-4730,Proprietary  ,23,77,100,108,184,292
04240200,AVIATION INSTITUTE OF MAINTENANCE       ,CA,94621-4527,Proprietary  ,10,87,97,41,161,202
04241700,SAINT JOSEPH'S SCHOOL OF NURSING        ,CA,93534-2304,Proprietary  ,14,64,78,41,100,141
04242500,ASSOCIATED BARBER COLLEGE OF SAN DIEGO  ,CA,92101-4210,Proprietary  ,8,34,42,8,34,42
04242600,ABCO TECHNOLOGY                         ,CA,90045-1551,Proprietary  ,9,19,28,9,19,28
04244000,CALIFORNIA INTERCONTINENTAL UNIVERSITY  ,CA,92614-5636,Proprietary  ,0,1,1,0,1,1
04245500,UNITED HEALTHCARE CAREERS COLLEGE       ,CA,90015-3811,Proprietary  ,4,19,23,4,19,23
00184600,BRIAR CLIFF UNIVERSITY                  ,IA,51104-2100,Private      ,175,231,406,959,531,1490
00184700,BUENA VISTA UNIVERSITY                  ,IA,50588-9987,Private      ,444,712,1156,1425,1263,2688
00184800,SOUTHEASTERN COMMUNITY COLLEGE          ,IA,52655-0000,Public       ,283,386,669,844,778,1622
00185000,CENTRAL COLLEGE                         ,IA,50219-1999,Private      ,374,32,406,1903,82,1985
00185200,CLARKE UNIVERSITY                       ,IA,52001-3198,Private      ,258,185,443,1075,378,1453
00185400,COE COLLEGE                             ,IA,52402-5092,Private      ,157,51,208,2515,203,2718
00185500,DES MOINES UNIV-OSTEOPATHIC MED CTR     ,IA,50312-0000,Private      ,8,754,762,29,1424,1453
00185600,CORNELL COLLEGE                         ,IA,52314-1098,Private      ,187,21,208,1729,98,1827
00185700,SOUTHWESTERN COMMUNITY COLLEGE          ,IA,50801-1098,Public       ,218,203,421,535,347,882
00185800,DIVINE WORD COLLEGE                     ,IA,52045-0380,Private      ,4,4,8,9,7,16
00185900,DORDT COLLEGE                           ,IA,51250-1697,Private      ,285,39,324,1356,80,1436
00186000,DRAKE UNIVERSITY                        ,IA,50311-4505,Private      ,426,521,947,4485,1491,5976
00186200,ELLSWORTH COMMUNITY COLLEGE             ,IA,50126-1199,Public       ,186,90,276,541,177,718
00186400,IOWA LAKES COMMUNITY COLLEGE            ,IA,51334-2234,Public       ,284,236,520,792,434,1226
00186500,IOWA CENTRAL COMMUNITY COLLEGE          ,IA,50501-0000,Public       ,706,814,1520,2083,1630,3713
00186600,GRACELAND UNIVERSITY                    ,IA,50140-1699,Private      ,433,455,888,1230,1048,2278
00186700,GRAND VIEW UNIVERSITY                   ,IA,50316-1599,Private      ,397,365,762,1868,943,2811
00186800,GRINNELL COLLEGE                        ,IA,50112-1690,Private      ,364,19,383,3055,77,3132
00186900,IOWA STATE UNIV SCIENCE & TECHNOLOG     ,IA,50011-2028,Public       ,1901,999,2900,28364,5027,33391
00187100,IOWA WESLEYAN COLLEGE                   ,IA,52641-1398,Private      ,132,73,205,1185,273,1458
00187300,LORAS COLLEGE                           ,IA,52004-0178,Private      ,417,55,472,1871,140,2011
00187400,LUTHER COLLEGE                          ,IA,52101-1045,Private      ,310,28,338,3085,109,3194
00187500,MARSHALLTOWN COMMUNITY COLLEGE          ,IA,50158-4760,Public       ,220,215,435,528,421,949
00187700,NORTH IOWA AREA COMMUNITY COLLEGE       ,IA,50401-7299,Public       ,324,249,573,1060,499,1559
00187900,MORNINGSIDE COLLEGE                     ,IA,51106-1751,Private      ,257,275,532,1949,549,2498
00188000,MOUNT MERCY UNIVERSITY                  ,IA,52402-4797,Private      ,356,438,794,1096,755,1851
00188300,NORTHWESTERN COLLEGE                    ,IA,51041-1996,Private      ,411,73,484,1251,143,1394
00188700,SIMPSON COLLEGE                         ,IA,50125-1297,Private      ,481,189,670,1942,353,2295
00188900,ST AMBROSE UNIVERSITY                   ,IA,52803-2898,Private      ,480,409,889,2712,999,3711
00189000,UNIVERSITY OF NORTHERN IOWA             ,IA,50614-0002,Public       ,2211,950,3161,8919,2079,10998
00189100,UNIVERSITY OF DUBUQUE                   ,IA,52001-5099,Private      ,474,276,750,1890,576,2466
00189200,UNIVERSITY OF IOWA                      ,IA,52242-1316,Public       ,2390,1818,4208,20857,7133,27990
00189300,UPPER IOWA UNIVERSITY                   ,IA,52142-9206,Private      ,404,1414,1818,1511,2895,4406
00189500,WALDORF COLLEGE                         ,IA,50436-1700,Proprietary  ,194,385,579,587,857,1444
00189600,WARTBURG COLLEGE                        ,IA,50677-2200,Private      ,341,33,374,1938,91,2029
00189700,WARTBURG THEOLOGICAL SEMINARY           ,IA,52004-5004,Private      ,1,37,38,4,66,70
00190000,WILLIAM PENN UNIVERSITY                 ,IA,52577-1799,Private      ,438,365,803,1092,641,1733
00396300,AIB COLLEGE OF BUSINESS                 ,IA,50321-1799,Private      ,69,118,187,352,323,675
00407500,ESTRN IOWA COMMUNITY COLLEGE DIST       ,IA,52801-1201,Public       ,62,171,233,195,343,538
00407501,CLINTON COMMUNITY COLLEGE               ,IA,52732-0000,Public       ,132,365,497,361,809,1170
00407502,MUSCATINE COMMUNITY COLLEGE             ,IA,52761-0000,Public       ,160,198,358,427,387,814
00407503,SCOTT COMMUNITY COLLEGE                 ,IA,52722-0000,Public       ,483,840,1323,1083,1557,2640
00407600,KIRKWOOD COMMUNITY COLLEGE              ,IA,52406-2068,Public       ,1774,1978,3752,4925,3680,8605
00423300,MERCY/ST. LUKE'S SCH RAD TECH           ,IA,52402-0000,Private      ,14,21,35,25,36,61
00458600,KAPLAN UNIVERSITY                       ,IA,52807-2095,Proprietary  ,1121,23314,24435,2077,43898,45975
00458604,KAPLAN UNIVERSITY - CEDAR RAPIDS        ,IA,52404-2998,Proprietary  ,73,688,761,124,1131,1255
00458605,KAPLAN UNIVERSITY - DES MOINES          ,IA,50323-5702,Proprietary  ,68,856,924,124,1406,1530
00458606,KAPLAN UNIVERSITY - MASON CITY          ,IA,50401-4665,Proprietary  ,18,319,337,39,549,588
00458607,KAPLAN UNIVERSITY - CEDAR FALLS         ,IA,50613-6309,Proprietary  ,43,499,542,84,867,951
00458700,NORTHEAST IOWA COMMUNITY COLLEGE        ,IA,52132-0400,Public       ,175,171,346,507,325,832
00458701,NORTHEAST IOWA COMMUNITY COLLEGE        ,IA,52068-0000,Public       ,296,370,666,693,678,1371
00459500,HAWKEYE COMMUNITY COLLEGE               ,IA,50701-0000,Public       ,816,771,1587,1944,1440,3384
00459800,IOWA WESTERN CMTY CLG-COUNCIL BLUFF     ,IA,51502-0000,Public       ,1027,1051,2078,2645,2091,4736
00460000,NORTHWEST IOWA COMMUNITY COLLEGE        ,IA,51201-1046,Public       ,183,159,342,457,279,736
00626700,IOWA METHODIST MEDICAL CENTER SCHOOLS   ,IA,50309-1499,Private      ,8,24,32,34,50,84
00627300,MERCY COLLEGE OF HEALTH SCIENCES        ,IA,50309-1239,Private      ,149,302,451,401,584,985
00712000,DES MOINES AREA CMTY COLLEGE            ,IA,50021-0000,Public       ,2132,2586,4718,5760,5284,11044
00712100,FAITH BAPTIST BIBLE CLG & THEOL SEM     ,IA,50021-0000,Private      ,99,23,122,254,39,293
00729100,ST LUKE'S COLLEGE                       ,IA,51104-0263,Private      ,32,65,97,110,156,266
00731600,WESTERN IOWA TECH COMMUNITY COLLEGE     ,IA,51106-0000,Public       ,629,938,1567,1414,1647,3061
00758800,CAPRI COLLEGE                           ,IA,52004-0873,Proprietary  ,53,42,95,99,103,202
00761100,EQ SCHOOL OF HAIR DESIGN                ,IA,51503-0813,Proprietary  ,12,27,39,15,44,59
00765600,AMERICAN COLLEGE OF HARISTYLING -CR     ,IA,52402-0000,Proprietary  ,0,0,0,4,12,16
00765800,AMER COLL OF HAIRSTYLING-DES MOINES     ,IA,50309-5446,Proprietary  ,2,19,21,9,35,44
00765900,LA JAMES COLLEGE OF HAIRSTYLING         ,IA,50401-3308,Proprietary  ,20,14,34,38,32,70
00771700,CAPRI COLLEGE                           ,IA,52807-2622,Proprietary  ,33,61,94,81,110,191
00794100,COLLEGE OF HAIR DESIGN                  ,IA,50703-1834,Proprietary  ,1,13,14,1,23,24
00826000,IOWA SCHOOL OF BEAUTY INC               ,IA,50322-0000,Proprietary  ,28,51,79,50,106,156
00840300,INDIAN HILLS COMMUNITY COLLEGE          ,IA,52501-1398,Public       ,486,666,1152,1353,1342,2695
00842400,LA JAMES INTERNATIONAL COLLEGE          ,IA,50501-5577,Proprietary  ,6,17,23,24,29,53
00959300,LA'JAMES COLLEGE OF HAIRSTYLING         ,IA,52240-0000,Proprietary  ,12,25,37,29,39,68
01111300,MAHARISHI UNIV OF MANAGEMENT            ,IA,52557-0001,Private      ,44,204,248,96,338,434
01206400,HAMILTON TECHNICAL COLLEGE              ,IA,52807-2653,Proprietary  ,43,72,115,78,127,205
01230000,PALMER COLLEGE OF CHIROPRACTIC          ,IA,52803-5287,Private      ,34,1127,1161,83,2031,2114
01300600,LA' JAMES INTERNATIONAL COLLEGE-CF      ,IA,50613-5242,Proprietary  ,8,15,23,15,21,36
02090300,CAPRI COLLEGE                           ,IA,52404-0000,Proprietary  ,33,75,108,78,140,218
02134500,LA JAMES INTERNATIONAL COLLEGE - DAV    ,IA,52806-3952,Proprietary  ,13,15,28,18,38,56
02160900,PCI ACADEMY                             ,IA,50010-6062,Proprietary  ,52,27,79,86,55,141
02262500,FAUST INSTITUTE OF COSMETOLOGY          ,IA,50588-0000,Proprietary  ,4,6,10,10,14,24
02274100,LA' JAMES INTERNATIONAL COLLEGE - DM    ,IA,50131-0000,Proprietary  ,16,44,60,29,73,102
02289000,AMERICAN HAIR ACADEMY                   ,IA,52627-4530,Proprietary  ,9,13,22,12,18,30
02306900,IOWA SCHOOL OF BEAUTY                   ,IA,52501-0000,Proprietary  ,17,14,31,26,27,53
02328900,EMMAUS BIBLE COLLEGE                    ,IA,52001-0000,Private      ,72,25,97,201,46,247
02330900,IOWA SCHOOL OF BEAUTY                   ,IA,50158-0000,Proprietary  ,4,22,26,9,29,38
02609200,VATTEROTT COLLEGE                       ,IA,50321-4704,Proprietary  ,33,164,197,52,296,348
03065302,PAUL MITCHELL THE SCHOOL DAVENPORT      ,IA,52806-4000,Proprietary  ,5,2,7,18,12,30
03069100,ALLEN COLLEGE                           ,IA,50703-1916,Private      ,66,204,270,336,471,807
03441300,IOWA SCHOOL OF BEAUTY                   ,IA,51106-5111,Proprietary  ,10,20,30,29,35,64
03607400,TOTAL LOOK SCHOOL OF COSMETOLOGY AND MAS,IA,52136-1053,Proprietary  ,2,7,9,2,7,9
03720300,CARLSON COLLEGE OF MASSAGE THERAPY      ,IA,52205-7519,Proprietary  ,2,10,12,6,21,27
04051313,ART INSTITUTE OF PHOENIX (THE) - BROWN M,IA,52722-3628,Proprietary  ,7,25,32,14,53,67
04177800,SALON PROFESSIONAL ACADEMY (THE)        ,IA,52240-6083,Proprietary  ,20,22,42,32,35,67
04203300,AVEDA INSTITUTE DES MOINES              ,IA,50266-8137,Proprietary  ,50,54,104,99,104,203
00259600,ATLANTIC COMMUNITY COLLEGE              ,NJ,08330-2699,Public       ,1516,1676,3192,2726,2899,5625
00259700,BLOOMFIELD COLLEGE                      ,NJ,07003-3425,Private      ,905,575,1480,2814,1163,3977
00259800,CALDWELL COLLEGE                        ,NJ,07006-6195,Private      ,554,382,936,2634,875,3509
00259900,CENTENARY COLLEGE                       ,NJ,07840-2184,Private      ,252,203,455,1554,694,2248
00260000,COLLEGE OF SAINT ELIZABETH              ,NJ,07960-6989,Private      ,224,271,495,633,490,1123
00260100,CUMBERLAND COUNTY COLLEGE               ,NJ,08362-9912,Public       ,1027,1255,2282,1661,2054,3715
00260300,DREW UNIVERSITY                         ,NJ,07940-4063,Private      ,288,195,483,2400,495,2895
00260700,FAIRLEIGH DICKINSON UNIV-TEANECK        ,NJ,07666-1996,Private      ,765,917,1682,4291,1955,6246
00260701,FAIRLEIGH DICKINSON UNIV-FLORHAM        ,NJ,07940-0000,Private      ,525,374,899,3986,864,4850
00260702,FAIRLEIGH DICKINSON UNIV-ED WMS CLG     ,NJ,07601-0000,Private      ,107,167,274,427,337,764
00260703,FAIRLEIGH DICKINSON UNIVERSITY          ,NJ,07940-0000,Private      ,233,212,445,1459,519,1978
00260800,GEORGIAN COURT UNIVERSITY               ,NJ,08701-2697,Private      ,500,403,903,1461,792,2253
00260900,ROWAN UNIVERSITY                        ,NJ,08028-1702,Public       ,4262,2148,6410,16419,4853,21272
00261000,FELICIAN COLLEGE                        ,NJ,07644-2198,Private      ,558,504,1062,1847,987,2834
00261300,NEW JERSEY CITY UNIVERSITY              ,NJ,07305-1597,Public       ,1838,2487,4325,4514,4383,8897
00261500,MIDDLESEX COUNTY COLLEGE                ,NJ,08818-3050,Public       ,2515,1846,4361,4968,3304,8272
00261600,MONMOUTH UNIVERSITY                     ,NJ,07764-1898,Private      ,1597,851,2448,8375,2026,10401
00261700,MONTCLAIR STATE UNIVERSITY              ,NJ,07043-9987,Public       ,4251,2565,6816,19517,6219,25736
00261900,NEW BRUNSWICK THEOLOGICAL SEMINARY      ,NJ,08901-0000,Private      ,16,69,85,51,125,176
00262100,NEW JERSEY INST OF TECHNOLOGY           ,NJ,07102-1982,Public       ,1665,1407,3072,7797,2943,10740
00262200,KEAN UNIVERSITY                         ,NJ,07083-7131,Public       ,3925,3738,7663,11985,7218,19203
00262400,OCEAN COUNTY COLLEGE                    ,NJ,08754-2001,Public       ,1902,1473,3375,3541,2610,6151
00262500,WILLIAM PATERSON UNIVERSITY             ,NJ,07470-2152,Public       ,3348,2219,5567,11951,4182,16133
00262600,PRINCETON THEOLOGICAL SEMINARY          ,NJ,08542-0000,Private      ,3,223,226,12,557,569
00262700,PRINCETON UNIVERSITY                    ,NJ,08544-0001,Private      ,1469,208,1677,16004,1239,17243
00262800,RIDER UNIVERSITY                        ,NJ,08648-3099,Private      ,898,447,1345,8224,1302,9526
00262900,"RUTGERS, THE STATE UNIVERSITY OF NJ     ",NJ,08901-1281,Public       ,7828,8471,16299,48175,23032,71207
00263200,SETON HALL UNIVERSITY                   ,NJ,07079-2697,Private      ,1073,942,2015,12251,2926,15177
00263201,SETON HALL UNIVERSITY - SCHOOL OF LAW   ,NJ,07079-5210,Private      ,52,367,419,278,1201,1479
00263800,SAINT PETER'S UNIVERSITY                ,NJ,07306-5997,Private      ,1092,712,1804,3874,1377,5251
00263900,STEVENS INSTITUTE OF TECHNOLOGY         ,NJ,07030-5370,Private      ,664,154,818,5620,431,6051
00264200,COLLEGE OF NEW JERSEY (THE)             ,NJ,08628-0718,Public       ,1470,438,1908,11548,1113,12661
00264300,UNION COUNTY COLLEGE                    ,NJ,07016-1598,Public       ,2045,3007,5052,3793,5129,8922
00473600,BERGEN COMMUNITY COLLEGE                ,NJ,07652-1595,Public       ,2874,1979,4853,6356,3785,10141
00474000,MERCER COUNTY COMMUNITY COLLEGE         ,NJ,08690-0000,Public       ,1475,1502,2977,2679,2486,5165
00539900,MONMOUTH COUNTY VOCATIONAL SCH DIST     ,NJ,07728-5033,Public       ,24,52,76,54,90,144
00545200,TETERBORO SCH OF AERONAUTICS            ,NJ,07608-1083,Proprietary  ,23,29,52,45,44,89
00546100,SALEM COMMUNITY COLLEGE                 ,NJ,08069-2799,Public       ,214,266,480,361,473,834
00641700,HOLY NAME MEDICAL CENTER SCHOOL OF NURSI,NJ,07666-4254,Private      ,36,132,168,63,205,268
00642000,MOUNTAINSIDE HOSP SCH NRSG              ,NJ,07042-4898,Proprietary  ,7,46,53,13,101,114
00642100,MUHLENBERG SNYDER SCHOOLS               ,NJ,07061-3399,Private      ,61,184,245,100,339,439
00642900,ST FRANCIS MEDICAL CTR SCH NURSING      ,NJ,08629-1986,Private      ,11,36,47,20,82,102
00642902,ST FRANCIS MED CTR RAD TECH             ,NJ,08629-0000,Private      ,7,10,17,11,23,34
00686500,CAMDEN COUNTY COLLEGE                   ,NJ,08012-3240,Public       ,2257,2709,4966,4251,4911,9162
00690100,GLOUCESTER COUNTY COLLEGE               ,NJ,08080-4249,Public       ,1393,1010,2403,2857,1905,4762
00710700,ESSEX COUNTY COLLEGE                    ,NJ,07102-1798,Public       ,1984,3042,5026,4032,5863,9895
00750200,BERKELEY COLLEGE                        ,NJ,07424-3367,Proprietary  ,1245,1885,3130,2351,2992,5343
00759300,PARISIAN BEAUTY ACADEMY                 ,NJ,07601-5509,Proprietary  ,79,106,185,108,152,260
00772900,COUNTY COLLEGE OF MORRIS                ,NJ,07869-0000,Public       ,1323,799,2122,2851,1437,4288
00773000,BURLINGTON COUNTY COLLEGE               ,NJ,08068-1599,Public       ,1636,1703,3339,3151,3240,6391
00773100,RARITAN VALLEY COMMUNITY COLLEGE        ,NJ,08876-1265,Public       ,992,800,1792,2037,1389,3426
00780401,STAR CAREER ACADEMY - STAR LAKEWOOD     ,NJ,08701-5900,Proprietary  ,36,114,150,61,184,245
00780402,STAR CAREER ACADEMY - STAR EGG HARBOR   ,NJ,08234-4863,Proprietary  ,21,91,112,37,141,178
00793808,LINCOLN TECHNICAL INSTITUTE - SOUTH PLAI,NJ,07080-2424,Proprietary  ,109,98,207,166,147,313
00793810,LINCOLN TECHNICAL INSTITUTE - MAHWAH    ,NJ,07430-2106,Proprietary  ,230,204,434,314,247,561
00793811,LINCOLN TECHNICAL INSTITUTE - UNION     ,NJ,07083-5032,Proprietary  ,391,402,793,521,507,1028
00794700,BETH MEDRASH GOVOHA OF AMERICA          ,NJ,08701-0000,Private      ,70,927,997,76,941,1017
00840400,BROOKDALE COMMUNITY COLLEGE             ,NJ,07738-1597,Public       ,1949,1424,3373,3908,2519,6427
00849400,HO HO KUS SCHL OF TRADE & TECH SCIENCES ,NJ,07513-1402,Proprietary  ,33,57,90,51,82,133
00860900,RABBINICAL COLLEGE OF AMERICA           ,NJ,07960-3600,Private      ,17,4,21,25,6,31
00907800,CAPRI INSTITUTE OF HAIR DESIGN          ,NJ,07011-2111,Proprietary  ,23,65,88,41,94,135
00934400,RAMAPO COLLEGE OF NEW JERSEY            ,NJ,07430-1680,Public       ,1356,508,1864,7498,1248,8746
00934500,RICHARD STOCKTON COLLEGE OF NJ          ,NJ,08205-9441,Public       ,2120,1078,3198,8884,2707,11591
00982804,EVEREST INSTITUTE - SOUTH PLAINFIELD    ,NJ,07080-1125,Proprietary  ,79,162,241,110,227,337
00999400,PASSAIC COUNTY COMMUNITY COLLEGE        ,NJ,07505-1179,Public       ,1494,1787,3281,2727,2916,5643
01062900,P B COSMETOLOGY EDUCATION CENTRE        ,NJ,08030-1750,Proprietary  ,45,70,115,71,94,165
01085100,ANTHEM INSTITUTE                        ,NJ,07054-3409,Proprietary  ,46,176,222,58,240,298
01085101,ANTHEM INSTITUTE                        ,NJ,07306-0000,Proprietary  ,11,30,41,21,60,81
01085102,ANTHEM INSTITUTE                        ,NJ,08902-0000,Proprietary  ,11,26,37,21,42,63
01090300,RIZZIERI INSTITUTE                      ,NJ,08043-4600,Proprietary  ,54,45,99,79,83,162
01152300,MORRIS COUNTY SCHOOL OF TECHNOLOGY      ,NJ,07834-0000,Public       ,16,32,48,38,52,90
01198900,TALMUDICAL ACADEMY                      ,NJ,07710-0000,Private      ,9,4,13,11,5,16
01209000,ROBERT FIANCE BEAUTY SCHOOLS            ,NJ,08861-4118,Proprietary  ,20,29,49,32,42,74
01246100,LINCOLN TECHNICAL INSTITUTE             ,NJ,08820-2896,Proprietary  ,89,241,330,161,367,528
01246102,LINCOLN TECHNICAL INSTITUTE             ,NJ,08057-3212,Proprietary  ,85,314,399,130,501,631
01246103,LINCOLN TECHNICAL INSTITUTE             ,NJ,07652-2106,Proprietary  ,158,278,436,275,429,704
01246200,HOHOKUS - HACKENSACK SCHOOL OF BUSINESS ,NJ,07601-7197,Proprietary  ,57,165,222,79,275,354
01295400,HUDSON COUNTY COMMUNITY COLLEGE         ,NJ,07306-4012,Public       ,2076,2419,4495,3721,3824,7545
02053700,EASTWICK COLLEGE                        ,NJ,07446-0000,Proprietary  ,138,442,580,221,733,954
02061800,ROMAN ACADEMY OF BEAUTY CULTURE         ,NJ,07506-0000,Proprietary  ,7,3,10,12,6,18
02092300,HOHOKUS SCHOOL - RETS/NUTLEY            ,NJ,07110-0000,Proprietary  ,81,162,243,104,230,334
02103700,CAPRI INSTITUTE OF HAIR DESIGN          ,NJ,07652-0000,Proprietary  ,14,26,40,30,36,66
02104000,HARRIS SCHOOL OF BUSINESS               ,NJ,08002-2983,Proprietary  ,101,416,517,127,559,686
02106601,AMERICAN INSTITUTE - CLIFTON            ,NJ,07011-2345,Proprietary  ,97,210,307,118,350,468
02106605,AMERICAN INSTITUTE - TOMS RIVER         ,NJ,08755-1524,Proprietary  ,44,142,186,58,200,258
02131100,DU CRET SCHOOL OF THE ARTS              ,NJ,07060-0000,Private      ,9,3,12,22,11,33
02131600,PENNCO TECH                             ,NJ,08012-0000,Proprietary  ,171,191,362,262,354,616
02132300,FORTIS INSTITUTE                        ,NJ,07470-7041,Proprietary  ,144,251,395,190,332,522
02146800,JOE KUBERT SCH OF CARTOON & GRAPHIC     ,NJ,07801-0000,Proprietary  ,36,27,63,66,57,123
02154000,DIVERS ACAD OF EASTERN SEABOARD         ,NJ,08081-1139,Proprietary  ,36,57,93,54,84,138
02183600,CAPRI INSTITUTE OF HAIR DESIGN          ,NJ,07033-0000,Proprietary  ,14,38,52,26,54,80
02192200,THOMAS EDISON STATE COLLEGE             ,NJ,08608-0000,Public       ,168,2581,2749,359,5049,5408
02219600,OMEGA INSTITUTE                         ,NJ,08109-0000,Proprietary  ,1,2,3,4,15,19
02223700,ROBERT FIANCE BEAUTY SCHOOLS            ,NJ,07093-4623,Proprietary  ,16,68,84,22,81,103
02223900,DRAKE COLLEGE OF BUSINESS               ,NJ,07201-0000,Proprietary  ,10,36,46,26,54,80
02223902,DRAKE COLLEGE OF BUSINESS - NEWARK CAMPU,NJ,07112-2760,Proprietary  ,15,65,80,52,128,180
02232500,UNION COUNTY VOCATIONAL TECH INST       ,NJ,07076-0000,Public       ,19,26,45,48,49,97
02234600,ATLANTIC BEAUTY & SPA ACADEMY           ,NJ,08234-2621,Proprietary  ,18,39,57,34,56,90
02246000,ROSS UNIVERSITY - MEDICAL SCHOOL        ,NJ,08837-0000,Proprietary  ,4,882,886,18,2170,2188
02248600,COOPER HEALTH SYS-CTR ALLIED HEALTH     ,NJ,08103-0000,Private      ,31,79,110,83,207,290
02265500,CAPRI INSTITUTE OF HAIR DESIGN          ,NJ,08724-0000,Proprietary  ,26,54,80,31,68,99
02277900,ROSS UNIV - SCH OF VETERINARY MED       ,NJ,08837-0000,Proprietary  ,3,272,275,13,1242,1255
02312000,BERGEN COUNTY TECHNICAL SCHOOLS         ,NJ,07601-6110,Public       ,29,54,83,64,91,155
02503900,WARREN COUNTY COMMUNITY COLLEGE         ,NJ,07882-0000,Public       ,265,221,486,450,383,833
02523700,OCEAN COUNTY VOCATIONAL-TECH SCHOOL     ,NJ,08753-0000,Public       ,102,166,268,172,288,460
02525900,ARTISTIC ACADEMY OF HAIR DESIGN         ,NJ,07950-1409,Proprietary  ,22,28,50,48,59,107
02528200,ROBERT FIANCE BEAUTY SCHOOLS            ,NJ,07060-4840,Proprietary  ,27,55,82,33,70,103
02558700,PRISM CAREER INSTITUTE                  ,NJ,08037-0000,Proprietary  ,65,389,454,95,533,628
02568800,SUSSEX COUNTY COMMUNITY COLLEGE         ,NJ,07860-1149,Public       ,566,334,900,1013,578,1591
02586900,HARRIS SCHOOL OF BUSINESS               ,NJ,08043-2604,Proprietary  ,39,184,223,46,228,274
02616402,SANFORD-BROWN INSTITUTE - ISELIN        ,NJ,08830-0000,Proprietary  ,27,107,134,49,187,236
03077500,RABBI JACOB JOSEPH SCHOOL               ,NJ,08817-4494,Private      ,11,3,14,15,3,18
03122600,EASTERN INTERNATIONAL COLLEGE           ,NJ,07306-3906,Proprietary  ,66,192,258,91,300,391
03187300,STENOTECH CAREER INSTITUTE              ,NJ,07004-0000,Proprietary  ,1,7,8,4,17,21
03197300,INSTITUTE FOR HEALTH EDUCATION(THE)     ,NJ,07306-2929,Proprietary  ,0,0,0,2,7,9
03324300,CENTRAL CAREER SCHOOL                   ,NJ,07080-2408,Proprietary  ,8,34,42,13,47,60
03380302,STAR CAREER ACADEMY - STAR NEWARK       ,NJ,07102-4510,Proprietary  ,46,199,245,85,336,421
03380303,STAR CAREER ACADEMY - STAR CLIFTON      ,NJ,07011-2248,Proprietary  ,28,76,104,36,108,144
03536300,INSTITUTE FOR THERAPEUTIC MASSAGE       ,NJ,07420-1452,Proprietary  ,10,35,45,12,60,72
03650600,PC AGE                                  ,NJ,07306-3936,Proprietary  ,17,96,113,25,163,188
03650603,PC AGE                                  ,NJ,08817-2842,Proprietary  ,8,20,28,16,31,47
03666300,PILLAR COLLEGE                          ,NJ,07102-5511,Private      ,49,344,393,69,499,568
03803300,HEALTHCARE TRAINING INSTITUTE           ,NJ,07083-3504,Proprietary  ,28,119,147,47,178,225
03811300,EASTERN SCHOOL OF ACUPUNCTURE AND TRADIT,NJ,07042-3562,Proprietary  ,1,16,17,3,32,35
04081300,BAIS MEDRASH TORAS CHESED               ,NJ,08701-0000,Private      ,9,8,17,13,8,21
04123400,YESHIVAS BE'ER YITZCHOK                 ,NJ,07208-2380,Private      ,5,18,23,7,27,34
04125000,GENTLE HEALING SCHOOL OF MASSAGE        ,NJ,08512-3600,Proprietary  ,2,10,12,2,19,21
04131100,YESHIVA TORAS CHAIM                     ,NJ,08701-2120,Private      ,70,1,71,71,1,72
04131200,TOTAL IMAGE BEAUTY ACADEMY              ,NJ,07307-2943,Proprietary  ,1,20,21,7,32,39
04134100,JERSEY COLLEGE                          ,NJ,07608-1104,Proprietary  ,75,959,1034,118,1556,1674
04136400,AMERICAN INSTITUTE OF MEDICAL SCIENCES &,NJ,07080-1183,Proprietary  ,31,120,151,56,192,248
04154500,STARTING POINTS FOR CHILDREN            ,NJ,07306-0001,Private      ,5,30,35,12,42,54
04154900,NATIONAL CAREER INSTITUTE               ,NJ,07018-2011,Proprietary  ,7,100,107,10,110,120
04154901,NATIONAL CAREER INSTITUTE - JERSEY CITY ,NJ,07306-4300,Proprietary  ,19,69,88,25,88,113
04173100,LAB PAUL MITCHELL PARTNER SCHOOL (THE)  ,NJ,08628-2500,Proprietary  ,16,34,50,25,43,68
04180300,MESIVTA KESER TORAH                     ,NJ,07719-2409,Private      ,0,1,1,1,1,2
04181400,BEST CARE TRAINING INSTITUTE            ,NJ,07018-1703,Proprietary  ,7,45,52,14,77,91
04184500,CHRISTINE VALMY INTERNATIONAL SCHOOL OF ,NJ,07058-9589,Proprietary  ,10,25,35,17,34,51
04188700,ASI CAREER INSTITUTE                    ,NJ,08012-1043,Proprietary  ,4,44,48,8,80,88
04192400,YESHIVA GEDOLAH ZICHRON LEYMA           ,NJ,07036-3905,Private      ,1,0,1,3,1,4
04207500,MEDICAL CAREER INSTITUTE                ,NJ,07712-7202,Proprietary  ,10,53,63,15,71,86
04215600,AMERICAN INSTITUTE OF PHARMACEUTICAL TEC,NJ,07601-9991,Proprietary  ,18,108,126,25,124,149
04216000,UNIVERSAL TRAINING INSTITUTE            ,NJ,08861-4106,Proprietary  ,7,37,44,13,60,73
04216100,YESHIVA YESODEI HATORAH                 ,NJ,08701-4946,Private      ,0,0,0,1,0,1
04216500,RIZZIERI INSTITUTE                      ,NJ,08043-1911,Proprietary  ,13,22,35,24,37,61
04218200,PAUL MITCHELL THE SCHOOL - JERSEY SHORE ,NJ,08723-3413,Proprietary  ,22,37,59,38,59,97
04218500,SALON PROFESSIONAL ACADEMY THE          ,NJ,07080-0000,Proprietary  ,22,50,72,33,74,107
00266500,VAUGHN COLLEGE OF AERONAUTICS AND TECHNO,NY,11369-9997,Private      ,380,323,703,964,596,1560
00266600,ADELPHI UNIVERSITY                      ,NY,11530-4299,Private      ,874,1155,2029,8422,3168,11590
00266700,DOWLING COLLEGE                         ,NY,11769-1999,Private      ,304,203,507,1474,555,2029
00266800,ALFRED UNIVERSITY                       ,NY,14802-1205,Private      ,384,156,540,3570,447,4017
00266900,BANK STREET COLLEGE OF EDUCATION        ,NY,10025-0000,Private      ,7,222,229,14,547,561
00267100,BARD COLLEGE                            ,NY,12504-5000,Private      ,271,107,378,3749,581,4330
00267400,NEW YORK THEOLOGICAL SEMINARY           ,NY,10115-0002,Private      ,4,79,83,5,159,164
00267700,BROOKLYN LAW SCHOOL                     ,NY,11201-0000,Private      ,17,674,691,48,2090,2138
00267800,BRYANT & STRATTON COLLEGE               ,NY,14203-1713,Proprietary  ,834,4411,5245,1515,9259,10774
00267803,BRYANT & STRATTON COLLEGE - GREECE      ,NY,14606-4227,Proprietary  ,78,314,392,188,783,971
00267805,BRYANT & STRATTON COLLEGE - SYRACUSE    ,NY,13203-2502,Proprietary  ,179,382,561,401,893,1294
00267807,BRYANT & STRATTON COLLEGE - ALBANY      ,NY,12205-5230,Proprietary  ,84,233,317,147,524,671
00268100,CANISIUS COLLEGE                        ,NY,14208-1098,Private      ,748,500,1248,4517,1257,5774
00268500,CAZENOVIA COLLEGE                       ,NY,13035-1085,Private      ,196,76,272,1968,213,2181
00268700,CUNY-BROOKLYN COLLEGE                   ,NY,11210-2814,Public       ,4339,4116,8455,18922,9218,28140
00268800,CITY COLLEGE-CUNY                       ,NY,10031-9198,Public       ,3786,3501,7287,19483,8437,27920
00268900,CUNY-HUNTER COLLEGE                     ,NY,10021-0000,Public       ,5321,4969,10290,25963,12011,37974
00269000,QUEENS COLLEGE-CUNY                     ,NY,11367-1597,Public       ,4139,3094,7233,17244,6707,23951
00269100,CUNY- BOROUGH OF MANHATTAN CMTY CLG     ,NY,10007-1047,Public       ,8791,6141,14932,23645,12395,36040
00269200,CUNY BRONX COMMUNITY COLLEGE            ,NY,10453-3102,Public       ,3496,3831,7327,9256,7473,16729
00269300,CUNY-JOHN JAY CLG CRIMINAL JUSTICE      ,NY,10019-1093,Public       ,4097,2777,6874,15582,6518,22100
00269400,KINGSBOROUGH COMMUNITY COLLEGE          ,NY,11235-2398,Public       ,3675,2400,6075,10698,5235,15933
00269600,NY CITY COLLEGE OF TECHNOLOGY-CUNY      ,NY,11201-2983,Public       ,4507,3024,7531,17037,7118,24155
00269700,QUEENSBOROUGH COMMUNITY COLLEGE         ,NY,11364-1497,Public       ,5371,2639,8010,12914,5000,17914
00269800,CUNY THE COLLEGE OF STATEN ISLAND       ,NY,10314-6600,Public       ,3397,1604,5001,12152,3473,15625
00269900,CLARKSON UNIVERSITY                     ,NY,13699-5615,Private      ,943,167,1110,6305,466,6771
00270000,COLGATE ROCHESTER CROZER DIVINITY S     ,NY,14620-0000,Private      ,2,40,42,7,59,66
00270100,COLGATE UNIVERSITY                      ,NY,13346-1386,Private      ,275,23,298,4166,105,4271
00270300,COLLEGE OF MOUNT SAINT VINCENT          ,NY,10471-1093,Private      ,499,157,656,2517,365,2882
00270400,COLLEGE OF NEW ROCHELLE                 ,NY,10805-2339,Private      ,284,1840,2124,956,2738,3694
00270500,COLLEGE OF SAINT ROSE                   ,NY,12203-1490,Private      ,806,520,1326,4586,1183,5769
00270700,COLUMBIA UNIVERSITY                     ,NY,10027-0000,Private      ,1959,4109,6068,23660,18136,41796
00270800,BARNARD COLLEGE-COLUMBIA UNIV           ,NY,10027-6598,Private      ,537,106,643,4823,344,5167
00270900,CONCORDIA COLLEGE                       ,NY,10708-1998,Private      ,223,270,493,830,521,1351
00271000,COOPER UNION                            ,NY,10003-7120,Private      ,175,71,246,1843,199,2042
00271100,CORNELL UNIVERSITY                      ,NY,14853-2801,Private      ,3258,1039,4297,28310,5108,33418
00271101,WEILL CORNELL MEDICAL COLLEGE AND GRADUA,NY,10021-0000,Private      ,7,205,212,36,636,672
00271200,D'YOUVILLE COLLEGE                      ,NY,14201-1084,Private      ,374,657,1031,1766,1684,3450
00271300,DOMINICAN COLLEGE                       ,NY,10962-1299,Private      ,531,347,878,1675,664,2339
00271800,ELMIRA COLLEGE                          ,NY,14901-2099,Private      ,366,101,467,2059,229,2288
00272200,FORDHAM UNIVERSITY                      ,NY,10458-5157,Private      ,2508,2145,4653,26468,6673,33141
00272600,GENERAL THEOLOGICAL SEMINARY            ,NY,10011-0000,Private      ,0,23,23,2,46,48
00272800,HAMILTON COLLEGE                        ,NY,13323-1218,Private      ,436,15,451,3036,82,3118
00272900,HARTWICK COLLEGE                        ,NY,13820-4020,Private      ,502,46,548,2463,133,2596
00273100,HOBART & WILLIAM SMITH COLLEGES         ,NY,14456-3397,Private      ,539,25,564,2998,95,3093
00273200,HOFSTRA UNIVERSITY                      ,NY,11549-1010,Private      ,1530,1478,3008,16815,4229,21044
00273400,HOUGHTON COLLEGE                        ,NY,14744-0128,Private      ,289,45,334,1232,109,1341
00273500,HILBERT COLLEGE                         ,NY,14075-1597,Private      ,216,82,298,873,216,1089
00273700,IONA COLLEGE                            ,NY,10801-1890,Private      ,1284,369,1653,8022,998,9020
00273900,ITHACA COLLEGE                          ,NY,14850-7130,Private      ,754,171,925,13677,987,14664
00274000,JEWISH THEOLOGICAL SEMINARY OF AMER     ,NY,10027-4649,Private      ,3,20,23,122,122,244
00274200,THE JUILLIARD SCHOOL                    ,NY,10023-6588,Private      ,200,142,342,1411,744,2155
00274400,KEUKA COLLEGE                           ,NY,14478-0000,Private      ,358,400,758,1909,914,2823
00274800,LEMOYNE COLLEGE                         ,NY,13214-1399,Private      ,732,340,1072,5108,775,5883
00274900,NEW YORK COLLEGE OF PODIATRIC MED       ,NY,10035-1940,Private      ,12,141,153,33,409,442
00275100,LONG ISLAND UNIVERSITY                  ,NY,11548-1326,Private      ,2135,3502,5637,11511,7533,19044
00275800,MANHATTAN COLLEGE                       ,NY,10471-4098,Private      ,1021,234,1255,6819,627,7446
00275900,MANHATTAN SCHOOL OF MUSIC               ,NY,10027-4689,Private      ,87,103,190,629,577,1206
00276000,MANHATTANVILLE COLLEGE                  ,NY,10577-2132,Private      ,450,282,732,3033,602,3635
00276300,MARIA COLLEGE                           ,NY,12208-1798,Private      ,102,290,392,258,512,770
00276500,MARIST COLLEGE                          ,NY,12601-1387,Private      ,902,359,1261,8260,858,9118
00276900,MARYMOUNT MANHATTAN COLLEGE             ,NY,10021-4597,Private      ,530,94,624,3946,284,4230
00277200,MERCY COLLEGE                           ,NY,10522-1189,Private      ,1073,2072,3145,4931,4556,9487
00277500,MOLLOY COLLEGE                          ,NY,11570-1100,Private      ,1003,784,1787,4071,1732,5803
00277700,MEDAILLE COLLEGE                        ,NY,14214-2695,Private      ,363,442,805,1329,1038,2367
00277800,MOUNT SAINT MARY COLLEGE                ,NY,12550-3494,Private      ,578,366,944,3501,830,4331
00277900,NAZARETH COLLEGE OF ROCHESTER           ,NY,14618-3790,Private      ,626,557,1183,3589,1200,4789
00278200,NEW YORK INSTITUTE OF TECHNOLOGY        ,NY,11568-8000,Private      ,1097,765,1862,5815,1747,7562
00278202,NY INSTITUTE OF TECHNOLOGY-OSTEOPATHIC M,NY,11568-0000,Private      ,7,630,637,52,1132,1184
00278300,NEW YORK LAW SCHOOL                     ,NY,10013-0000,Private      ,20,583,603,54,1766,1820
00278400,NEW YORK MEDICAL COLLEGE                ,NY,10595-0000,Private      ,4,758,762,20,1601,1621
00278500,NEW YORK UNIVERSITY                     ,NY,10012-1091,Private      ,4722,5801,10523,44966,22375,67341
00278800,NIAGARA UNIVERSITY                      ,NY,14109-2010,Private      ,878,355,1233,3734,742,4476
00279000,NYACK COLLEGE                           ,NY,10960-3698,Private      ,286,567,853,1000,1037,2037
00279100,PACE UNIVERSITY - NEW YORK              ,NY,10038-1598,Private      ,1203,1038,2241,12654,3039,15693
00279101,PACE UNIVERSITY-PLEASANTVILLE           ,NY,10570-0000,Private      ,456,332,788,3732,904,4636
00279102,PACE UNIVERSITY - WHITE PLAINS          ,NY,10603-0000,Private      ,63,428,491,538,1179,1717
00279500,PAUL SMITHS CLG OF ARTS & SCIENCES      ,NY,12970-0000,Private      ,265,71,336,1148,145,1293
00279800,PRATT INSTITUTE                         ,NY,11205-3899,Private      ,632,474,1106,4770,1680,6450
00280300,RENSSELAER POLYTECHNIC INSTITUTE        ,NY,12180-3590,Private      ,1052,157,1209,12113,620,12733
00280500,ROBERTS WESLEYAN COLLEGE                ,NY,14624-1997,Private      ,272,402,674,1411,858,2269
00280600,ROCHESTER INSTITUTE OF TECHNOLOGY       ,NY,14623-5608,Private      ,2495,765,3260,16524,1997,18521
00280700,ROCKEFELLER UNIVERSITY                  ,NY,10021-0000,Private      ,3,10,13,19,32,51
00280800,DAEMEN COLLEGE                          ,NY,14226-3592,Private      ,475,458,933,2620,884,3504
00281000,THE SAGE COLLEGES                       ,NY,12180-4199,Private      ,392,521,913,2176,1573,3749
00281200,TROCAIRE COLLEGE                        ,NY,14220-2094,Private      ,260,534,794,675,1092,1767
00281300,SARAH LAWRENCE COLLEGE                  ,NY,10708-5999,Private      ,206,117,323,2154,571,2725
00281400,SKIDMORE COLLEGE                        ,NY,12866-1632,Private      ,539,41,580,4637,129,4766
00281500,ST BERNARDS SCH THEOLOGY & MINISTRY     ,NY,14618-3822,Private      ,0,10,10,1,26,27
00281600,SIENA COLLEGE                           ,NY,12211-1462,Private      ,804,76,880,5778,255,6033
00281700,ST BONAVENTURE UNIVERSITY               ,NY,14778-2284,Private      ,314,128,442,2638,307,2945
00282000,ST FRANCIS COLLEGE                      ,NY,11201-4398,Private      ,649,240,889,2608,544,3152
00282100,ST JOHN FISHER COLLEGE                  ,NY,14618-3597,Private      ,714,605,1319,4588,1333,5921
00282200,CHRIST THE KING SEMINARY                ,NY,14052-0607,Private      ,0,1,1,0,2,2
00282300,ST JOHN'S UNIVERSITY                    ,NY,11439-1343,Private      ,3275,1835,5110,21993,5114,27107
00282500,ST JOSEPH'S COLLEGE                     ,NY,11205-3688,Private      ,268,286,554,1365,525,1890
00282501,ST JOSEPH'S COLLEGE-SUFFOLK CAMPUS      ,NY,11772-0000,Private      ,747,617,1364,2361,1121,3482
00282900,ST LAWRENCE UNIVERSITY                  ,NY,13617-1455,Private      ,453,43,496,3032,128,3160
00283200,ST THOMAS AQUINAS COLLEGE               ,NY,10976-1050,Private      ,352,59,411,1562,151,1713
00283300,ST VLADIMIR ORTHODOX THEOL SEM          ,NY,10707-0000,Private      ,0,12,12,0,39,39
00283400,EXCELSIOR COLLEGE                       ,NY,12203-5159,Private      ,288,4171,4459,475,8313,8788
00283500,SUNY AT ALBANY                          ,NY,12222-0001,Public       ,3480,1457,4937,20570,3747,24317
00283600,BINGHAMTON UNIVERSITY (SUNY)            ,NY,13902-6000,Public       ,2661,825,3486,25498,2420,27918
00283700,SUNY AT BUFFALO                         ,NY,14260-0001,Public       ,3311,2247,5558,23921,7973,31894
00283800,SUNY AT STONY BROOK                     ,NY,11794-0701,Public       ,3536,2667,6203,27128,6548,33676
00283900,SUNY-DOWNSTATE MEDICAL CENTER           ,NY,11203-2098,Public       ,61,806,867,172,1997,2169
00284000,SUNY UPSTATE MEDICAL UNIVERSITY         ,NY,13210-2375,Public       ,50,408,458,231,1323,1554
00284100,SUNY BROCKPORT - FIN AID OFF            ,NY,14420-2914,Public       ,1735,928,2663,9188,2169,11357
00284200,BUFFALO STATE COLLEGE - SUNY            ,NY,14222-1095,Public       ,2692,1287,3979,13233,3240,16473
00284300,SUNY COLLEGE-CORTLAND                   ,NY,13045-0900,Public       ,1777,401,2178,10848,1075,11923
00284400,SUNY AT FREDONIA                        ,NY,14063-1145,Public       ,1016,230,1246,6559,745,7304
00284500,SUNY GENESEO                            ,NY,14454-1401,Public       ,825,149,974,8666,492,9158
00284600,SUNY COLLEGE-NEW PALTZ                  ,NY,12561-2499,Public       ,1620,631,2251,12470,1739,14209
00284700,SUNY COLLEGE-ONEONTA                    ,NY,13820-4015,Public       ,1478,211,1689,10571,680,11251
00284800,SUNY OSWEGO                             ,NY,13126-3599,Public       ,1792,553,2345,10702,1427,12129
00284900,SUNY COLLEGE AT PLATTSBURGH             ,NY,12901-2681,Public       ,1215,418,1633,7421,1038,8459
00285000,SUNY COLLEGE-POTSDAM                    ,NY,13676-2294,Public       ,904,270,1174,5298,711,6009
00285100,SUNY COLLEGE OF ENVIRONMENT SCIENCE AND ,NY,13210-2778,Public       ,366,161,527,2305,441,2746
00285300,SUNY MARITIME COLLEGE                   ,NY,10465-4198,Public       ,360,112,472,1913,313,2226
00285400,SUNY COLLEGE OF TECHNOLOGY-ALFRED       ,NY,14802-9951,Public       ,1128,316,1444,4448,733,5181
00285500,SUNY CANTON COLG OF TECHNOLOGY          ,NY,13617-1098,Public       ,653,413,1066,3373,1065,4438
00285600,SUNY AG & TECH COLLEGE-COBLESKILL       ,NY,12043-9986,Public       ,752,212,964,3121,466,3587
00285700,SUNY DELHI                              ,NY,13753-1190,Public       ,969,402,1371,3808,916,4724
00285800,SUNY FARMINGDALE                        ,NY,11735-1021,Public       ,1804,1026,2830,6351,2040,8391
00285900,SUNY COLLEGE OF AG & TECH AT MORRISVILLE,NY,13408-0901,Public       ,941,277,1218,3597,626,4223
00286000,ADIRONDACK COMMUNITY COLLEGE            ,NY,12804-1445,Public       ,675,486,1161,1627,952,2579
00286100,CAYUGA COMMUNITY COLLEGE                ,NY,13021-3099,Public       ,457,590,1047,1120,1118,2238
00286200,BROOME COMMUNITY COLLEGE                ,NY,13902-0000,Public       ,1297,894,2191,3508,1752,5260
00286300,CORNING COMMUNITY COLLEGE               ,NY,14830-3297,Public       ,545,482,1027,1301,986,2287
00286400,DUTCHESS COMMUNITY COLLEGE              ,NY,12601-1595,Public       ,1433,743,2176,3454,1392,4846
00286600,FASHION INSTITUTE OF TECHNOLOGY         ,NY,10001-5992,Public       ,1148,778,1926,8824,2553,11377
00286700,SUNY FULTON MONTGOMERY COMM CLG         ,NY,12095-3790,Public       ,430,278,708,1081,608,1689
00286800,HUDSON VALLEY COMMUNITY COLLEGE         ,NY,12180-6096,Public       ,2144,1501,3645,4585,2688,7273
00286900,JAMESTOWN COMMUNITY COLLEGE             ,NY,14702-0020,Public       ,658,529,1187,1727,991,2718
00287000,JEFFERSON COMMUNITY COLLEGE             ,NY,13601-1897,Public       ,495,720,1215,1225,1420,2645
00287100,"SUNY, MOHAWK VALLEY COMMUNITY CLG       ",NY,13501-5394,Public       ,1227,965,2192,2652,1728,4380
00287200,MONROE COMMUNITY COLLEGE                ,NY,14623-5780,Public       ,2904,2820,5724,6805,5568,12373
00287300,NASSAU COMMUNITY COLLEGE                ,NY,11530-6793,Public       ,3384,2453,5837,7706,4390,12096
00287400,NIAGARA COUNTY COMMUNITY COLLEGE        ,NY,14132-9460,Public       ,1097,755,1852,2706,1643,4349
00287500,ONONDAGA COMMUNITY COLLEGE              ,NY,13215-4585,Public       ,2174,1391,3565,5698,2705,8403
00287600,ORANGE COUNTY COMMUNITY COLLEGE         ,NY,10940-6441,Public       ,983,817,1800,2005,1434,3439
00287700,ROCKLAND COMMUNITY COLLEGE              ,NY,10901-3611,Public       ,841,738,1579,1595,1168,2763
00287800,SUFFOLK COMMUNITY COLLEGE               ,NY,11784-2899,Public       ,2449,1219,3668,5307,2241,7548
00287801,SUFFOLK COMMUNITY CLG-W. CAMPUS         ,NY,11717-0000,Public       ,1794,1294,3088,3645,2225,5870
00287803,SUFFOLK COMMUNITY CLG-EASTRN CAMPUS     ,NY,11901-0000,Public       ,610,390,1000,1329,686,2015
00287900,SULLIVAN COUNTY COMMUNITY COLLEGE       ,NY,12759-5151,Public       ,317,210,527,765,411,1176
00288000,ULSTER COUNTY COMMUNITY COLLEGE         ,NY,12484-0557,Public       ,370,327,697,813,584,1397
00288100,SUNY WESTCHESTER COMMUNITY COLLEGE      ,NY,10595-1698,Public       ,2120,1730,3850,4376,3116,7492
00288200,SYRACUSE UNIVERSITY                     ,NY,13244-2130,Private      ,3017,1537,4554,26939,5646,32585
00288300,UTICA COLLEGE- UTICA                    ,NY,13502-4892,Private      ,723,863,1586,4456,2019,6475
00288500,ALBANY COLLEGE OF PHARMACY AND HEALTH SC,NY,12208-3492,Private      ,118,105,223,1679,747,2426
00288600,ALBANY LAW SCHOOL                       ,NY,12208-0000,Private      ,15,223,238,44,737,781
00288700,ALBANY MEDICAL COLLEGE                  ,NY,12208-0000,Private      ,19,178,197,66,989,1055
00288900,UNION COLLEGE                           ,NY,12308-2311,Private      ,407,25,432,3850,120,3970
00289000,UNION THEOLOGICAL SEMINARY              ,NY,10027-0000,Private      ,0,46,46,4,224,228
00289200,UNITED STATES MERCHANT MARINE ACADEMY   ,NY,11024-1634,Public       ,100,7,107,356,16,372
00289400,UNIVERSITY OF ROCHESTER                 ,NY,14627-9000,Private      ,1163,622,1785,8883,1598,10481
00289401,EASTMAN SCH OF MUSIC/UNIV ROCHESTER     ,NY,14604-0000,Private      ,117,97,214,778,354,1132
00289402,UNIV OF ROCHESTER SCHL OF MEDICINE      ,NY,14642-0000,Private      ,6,240,246,53,670,723
00289500,VASSAR COLLEGE                          ,NY,12604-0008,Private      ,653,48,701,4688,164,4852
00289600,VILLA MARIA COLLEGE-BUFFALO             ,NY,14225-3999,Private      ,130,79,209,404,200,604
00289900,WAGNER COLLEGE                          ,NY,10301-4495,Private      ,332,189,521,2501,441,2942
00290000,WEBB INSTITUTE                          ,NY,11542-1398,Private      ,9,1,10,94,4,98
00290100,WELLS COLLEGE                           ,NY,13026-0500,Private      ,241,21,262,1356,68,1424
00290300,YESHIVA UNIVERSITY                      ,NY,10033-3201,Private      ,459,529,988,2062,1928,3990
00290302,YESHIVA UNIVERSITY - BRONX CAMPUS       ,NY,10461-1975,Private      ,22,453,475,88,1094,1182
00397400,MESIVTHA TIFERETH JERUSALEM OF AMER     ,NY,10002-6382,Private      ,4,1,5,6,3,9
00397600,RABBINICAL ACAD MESIVTA RABBI CHAIM     ,NY,11230-4715,Private      ,1,0,1,1,1,2
00397700,RABBINICAL COLLEGE CH'SAN SOFER         ,NY,11204-1252,Private      ,0,1,1,0,1,1
00397800,RABBINICAL SEMINARY OF AMERICA          ,NY,11375-0000,Private      ,25,5,30,36,14,50
00397900,COLUMBIA UNIV TEACHERS COLLEGE          ,NY,10027-0000,Private      ,10,1207,1217,81,3792,3873
00405400,HEBREW UNION COL-JEWISH INST OF REL     ,NY,10012-0000,Private      ,0,122,122,0,207,207
00475900,"CUNY, YORK COLLEGE                      ",NY,11451-0001,Public       ,2820,2196,5016,11503,4400,15903
00476500,CUNY GRADUATE SCH & UNIV CTR            ,NY,10016-4309,Public       ,53,1117,1170,98,2328,2426
00477600,CENTRAL YESHIVA TOMCHEI TMIMIM LUBA     ,NY,11230-2798,Private      ,5,0,5,10,2,12
00478800,HERKIMER COUNTY COMMUNITY COLLEGE       ,NY,13350-1598,Public       ,558,344,902,1622,724,2346
00479800,MIRRER YESHIVA CENTRAL INST             ,NY,11223-2010,Private      ,7,0,7,9,2,11
00479900,MONROE COLLEGE                          ,NY,10468-4305,Proprietary  ,1653,2102,3755,3676,3998,7674
00481100,EVEREST INSTITUTE                       ,NY,14621-3007,Proprietary  ,17,92,109,38,271,309
00506400,SAINT JAMES MERCY HOSPITAL SCHOOL OF RAD,NY,14843-2197,Private      ,0,1,1,1,3,4
00520800,THE COLLEGE OF WESTCHESTER              ,NY,10602-0000,Proprietary  ,323,365,688,689,562,1251
00587700,ROBERT J HOCHSTIM SCHOOL OF RADIOG      ,NY,11572-1151,Private      ,1,3,4,1,6,7
00643501,ARNOT OGDEN MEDICAL CENTER              ,NY,14905-1676,Private      ,14,15,29,32,33,65
00643800,PHILLIPS BETH ISRAEL SCH OF NURSING     ,NY,10001-6354,Private      ,33,162,195,68,260,328
00644300,COCHRAN SCH NSG-ST JOHN RVSDE HOSP      ,NY,10701-1399,Private      ,7,88,95,20,130,150
00644500,CROUSE HOSP SCH OF NURSING              ,NY,13210-1690,Private      ,66,132,198,180,232,412
00644800,BELANGER SCHOOL OF NURSING              ,NY,12304-1009,Private      ,18,70,88,43,138,181
00646100,SAINT ELIZABETH MEDICAL CENTER          ,NY,13501-2998,Private      ,56,78,134,121,131,252
00646700,SAINT JOSEPH'S COLLEGE OF NURSING       ,NY,13203-1806,Private      ,80,91,171,215,216,431
00678200,GENESEE COMMUNITY COLLEGE               ,NY,14020-9704,Public       ,806,723,1529,2068,1449,3517
00678500,SCHENECTADY COUNTY COMMUNITY CLG        ,NY,12305-2294,Public       ,667,660,1327,1480,1254,2734
00678700,CLINTON COMMUNITY COLLEGE               ,NY,12901-5690,Public       ,308,223,531,752,420,1172
00678800,TOMPKINS CORTLAND COMMUNITY COLLEGE     ,NY,13053-0139,Public       ,717,463,1180,2000,959,2959
00678900,COLUMBIA-GREENE COMMUNITY COLLEGE       ,NY,12534-9543,Public       ,200,251,451,462,475,937
00679100,SUNY AT PURCHASE                        ,NY,10577-1400,Public       ,1044,313,1357,7000,867,7867
00702200,CUNY-LEHMAN COLLEGE                     ,NY,10468-1589,Public       ,2823,4875,7698,12474,9462,21936
00702600,MOUNT SINAI SCHOOL OF MEDICINE          ,NY,10029-0000,Private      ,13,334,347,34,942,976
00710900,SUNY COLLEGE-OLD WESTBURY               ,NY,11568-0210,Public       ,1288,843,2131,5207,1724,6931
00711100,NORTH COUNTRY COMMUNITY COLLEGE         ,NY,12983-2046,Public       ,200,187,387,510,359,869
00726400,MESIFTA TORAH VODAATH RABBINCAL SEM     ,NY,11218-5209,Private      ,2,1,3,2,1,3
00727300,CUNY-BERNARD BARUCH COLLEGE             ,NY,10010-5518,Public       ,3792,3506,7298,18036,7527,25563
00730400,CULINARY INSTITUTE OF AMERICA           ,NY,12538-1499,Private      ,808,375,1183,3143,967,4110
00732916,ITT TECHNICAL INSTITUTE                 ,NY,12205-1003,Proprietary  ,36,124,160,86,272,358
00737200,AUSTIN'S SCHOOL OF SPA TECHNOLOGY       ,NY,12206-1513,Proprietary  ,59,149,208,78,181,259
00737500,ISLAND DRAFTING & TECHNICAL INST        ,NY,11701-2704,Proprietary  ,38,24,62,51,35,86
00738700,LONG ISLAND BEAUTY SCHOOL               ,NY,11788-4346,Proprietary  ,35,57,92,59,96,155
00738800,LONG ISLAND BEAUTY SCHOOL               ,NY,11550-3704,Proprietary  ,9,40,49,17,65,82
00739100,BEAUTY SCHOOL OF MIDDLETOWN             ,NY,10940-6574,Proprietary  ,7,17,24,21,33,54
00739400,BERKELEY COLLEGE                        ,NY,10017-0000,Proprietary  ,1218,2054,3272,2343,3132,5475
00740100,MANDL SCHOOL                            ,NY,10019-5516,Proprietary  ,89,407,496,133,665,798
00740500,WOOD TOBE-COBURN SCHOOL                 ,NY,10016-0102,Proprietary  ,141,46,187,340,91,431
00746500,AMERICAN ACADEMY OF DRAMATIC ARTS       ,NY,10016-7089,Private      ,227,105,332,1022,283,1305
00746600,LIM COLLEGE                             ,NY,10022-5268,Proprietary  ,303,124,427,1860,406,2266
00746800,SCHOOL OF VISUAL ARTS                   ,NY,10010-3994,Proprietary  ,551,318,869,3416,1237,4653
00751800,APEX TECHNICAL SCHOOL                   ,NY,10011-0000,Proprietary  ,132,372,504,224,625,849
00752200,CONTINENTAL SCH OF BEAUTY CULTURE       ,NY,14623-3231,Proprietary  ,41,133,174,69,165,234
00752205,CONTINENTAL SCHOOL OF BEAUTY CULTURE - M,NY,13211-1003,Proprietary  ,4,8,12,11,16,27
00753200,FINGER LAKES COMMUNITY COLLEGE          ,NY,14424-8395,Public       ,963,766,1729,2641,1639,4280
00757200,AMERICAN MUSICAL AND DRAMATIC ACAD      ,NY,10023-2106,Private      ,545,125,670,2816,439,3255
00757300,EMPIRE BEAUTY SCHOOL                    ,NY,11103-4028,Proprietary  ,244,510,754,411,1026,1437
00780400,STAR CAREER ACADEMY                     ,NY,10011-7307,Proprietary  ,38,149,187,72,272,344
00793809,LINCOLN TECHNICAL INSTITUTE - WHITESTONE,NY,11357-6092,Proprietary  ,222,124,346,348,205,553
00818900,CONTINENTAL SCHOOL OF BEAUTY CULTURE - B,NY,14224-3402,Proprietary  ,21,22,43,26,30,56
00818903,CONTINENTAL SCHOOL OF BEAUTY CULTURE - B,NY,14223-2911,Proprietary  ,20,43,63,52,76,128
00843700,CHAMPLAIN VALLEY - TEC/PRN              ,NY,12901-0000,Public       ,12,32,44,29,56,85
00849500,JAMESTOWN BUSINESS COLLEGE              ,NY,14702-0429,Proprietary  ,77,105,182,151,151,302
00861100,"CUNY, HOSTOS CMTY COLLEGE               ",NY,10451-1499,Public       ,2581,2911,5492,7201,5563,12764
00861400,RABBINICAL CLG BOBOVER YESHIVA BNEI     ,NY,11219-3293,Private      ,1,0,1,2,2,4
00878800,STATE UNIVERSITY OF NEW YORK STUDENT LOA,NY,12246-0000,Public       ,78,79,157,336,220,556
00902900,NEIGHBORHOOD PLAYHOUSE                  ,NY,10022-5017,Private      ,5,20,25,25,32,57
00904300,ELMIRA BUSINESS INSTITUTE               ,NY,14901-2731,Proprietary  ,33,386,419,46,418,464
00907700,UTICA SCHOOL OF COMMERCE                ,NY,13501-2280,Proprietary  ,30,85,115,49,141,190
00924800,SAMARITAN HOSPITAL SCH NURSING          ,NY,12180-2475,Private      ,24,91,115,52,175,227
00928300,MIDWAY-PARIS BEAUTY SCHOOL              ,NY,11385-3453,Proprietary  ,4,20,24,7,28,35
00928400,BRITTANY BEAUTY SCHOOL                  ,NY,11756-1345,Proprietary  ,24,66,90,35,87,122
00933500,MESIVTA EASTERN PKWY RABBINICAL CLG     ,NY,11218-5559,Private      ,2,1,3,4,1,5
00947900,SAINT VINCENTS CMC SI NURSING SCHOOL    ,NY,10304-3850,Proprietary  ,73,239,312,134,396,530
00976900,METROPOLITAN COLLEGE OF NEW YORK        ,NY,10013-1919,Private      ,57,636,693,143,1424,1567
00992900,SUNY COLLEGE OF OPTOMETRY               ,NY,10036-8003,Public       ,6,173,179,13,348,361
01005100,LA GUARDIA CMTY COLLEGE - CUNY          ,NY,11101-3083,Public       ,4748,3706,8454,13815,7884,21699
01005200,JEFFERSON-LEWIS BOCES PRAC NRSGPRG      ,NY,13601-9509,Public       ,8,74,82,16,113,129
01009700,CUNY-MEDGAR W EVERS COLLEGE             ,NY,11225-2010,Public       ,2077,2311,4388,6719,4438,11157
01014200,TOURO COLLEGE                           ,NY,10010-4202,Private      ,1145,3956,5101,2011,6557,8568
01014700,WESTERN SUFFOLK BOCES                   ,NY,11768-3499,Public       ,57,101,158,105,193,298
01015300,HELENE FULD COL OF NRSNG/N GEN HOSP     ,NY,10035-0000,Private      ,8,219,227,17,404,421
01028600,EMPIRE STATE COLLEGE                    ,NY,12866-4391,Public       ,317,3713,4030,709,8485,9194
01037800,RABBINICAL COLLEGE OF LONG ISLAND       ,NY,11561-3244,Private      ,6,0,6,9,1,10
01054900,KEHILATH YAKOV RABBINICAL SEMINARY      ,NY,10562-1001,Private      ,1,1,2,2,2,4
01055100,NEW YORK SCH MED & DENTAL ASSISTANT     ,NY,11101-2327,Proprietary  ,28,67,95,58,122,180
01064100,SOUTHERN WESTCHESTER BOCES              ,NY,10543-0000,Public       ,9,44,53,20,68,88
01068400,ERIE COMMUNITY COLLEGE-ALL CAMPUSES     ,NY,14203-2698,Public       ,2148,2314,4462,4821,4238,9059
01081300,AMERICAN ACAD MCALLISTER INST           ,NY,10019-3604,Private      ,20,120,140,88,485,573
01094300,RABBINICAL COLLEGE BETH SHRAGA          ,NY,10952-3033,Private      ,0,1,1,0,1,1
01095200,PNW BOCES LPN PROGRAM                   ,NY,10598-0000,Public       ,4,13,17,8,21,29
01103100,TECHNICAL CAREER INSTITUTE              ,NY,10001-2789,Proprietary  ,347,1102,1449,447,1543,1990
01118900,UNITED TALMUDICAL SEMINARY              ,NY,11211-7984,Private      ,0,0,0,1,1,2
01119200,BETH HAMEDRASH SHAAREI YOSHER INST      ,NY,11204-1052,Private      ,0,1,1,0,1,1
01161400,CHAMPLAIN VALLEY HOSP SCH RAD TECH      ,NY,12901-1490,Private      ,8,8,16,21,17,38
01161700,NEW YORK METHODIST HOSPITAL             ,NY,11229-9023,Private      ,31,165,196,71,289,360
01164700,SBI CAMPUS - AN AFFILIATE OF SANFORD-BRO,NY,11747-3785,Proprietary  ,52,81,133,63,125,188
01167700,MEMORIAL SLOAN KETTERING CANCER CTR     ,NY,10021-6094,Private      ,0,11,11,2,19,21
01167800,SUNY INST OF TECHNOLOGY UTICA ROME      ,NY,13504-3050,Public       ,540,402,942,2276,791,3067
01182100,YESHIVATH ZICHRON MOSHE                 ,NY,12779-0580,Private      ,0,1,1,0,1,1
01183000,BERK TRADE AND BUSINESS SCHOOL          ,NY,11101-0000,Proprietary  ,27,76,103,46,112,158
01185900,WORD OF LIFE BIBLE INSTITUTE            ,NY,12860-0129,Private      ,203,35,238,514,66,580
01186000,MERCY MED CNTR SCHL OF RADIOGRAPHY      ,NY,11570-1098,Private      ,8,12,20,19,26,45
01192100,WESTCHESTER SCH OF BEAUTY CULTURE       ,NY,10550-2295,Proprietary  ,3,28,31,10,42,52
01192200,BETH HATALMUD RABBINICAL CLG            ,NY,11214-2594,Private      ,1,3,4,4,4,8
01198400,OHR HAMEIR THEOLOGICAL SEMINARY         ,NY,10566-0990,Private      ,2,0,2,3,0,3
01201100,TALMUDICAL SEM OHOLEI TORAH             ,NY,11213-3310,Private      ,2,0,2,3,0,3
01210700,INSTITUTE OF DESIGN & CONSTRUCTION      ,NY,11201-5380,Private      ,10,18,28,32,54,86
01220300,MEMORIAL HOSPITAL SCH OF NURSING        ,NY,12204-1083,Private      ,20,70,90,43,112,155
01227700,NEW YORK CHIROPRACTIC COLLEGE           ,NY,13148-0800,Private      ,3,323,326,12,640,652
01229300,VEEB NASSAU CNTY SCHL OF PRACT NURS     ,NY,11553-3040,Public       ,28,149,177,40,218,258
01235800,PLAZA COLLEGE                           ,NY,11372-6300,Proprietary  ,90,326,416,124,449,573
01236400,SAINT VINCENTS CATHOLIC MEDICAL CENTERS ,NY,11354-0000,Proprietary  ,40,219,259,72,384,456
01240700,SCHUYLER-CHEMUNG-TIOGA BOCES            ,NY,14903-1089,Public       ,15,58,73,22,110,132
01240701,STEUBEN SCHUYLER CHEMUNG TIOGA ALLEGANY ,NY,14870-9518,Public       ,0,2,2,0,3,3
01256100,FIVE TOWNS COLLEGE                      ,NY,11746-5871,Proprietary  ,270,85,355,634,145,779
01258900,ERIE 1 BOCES                            ,NY,14224-0000,Public       ,18,73,91,58,235,293
01265200,ONONDAGA CORTLAND MADISON BOCES         ,NY,13090-4500,Public       ,75,151,226,124,276,400
01278300,OSWEGO COUNTY BOCES ADULT CAREERS       ,NY,13114-4498,Public       ,14,33,47,24,53,77
01292700,SYRACUSE CITY SCHOOL DISTRICT           ,NY,13202-3092,Public       ,9,33,42,29,44,73
01302600,MACHZIKEI HADATH RABBINICAL COLLEGE     ,NY,11204-1805,Private      ,1,1,2,2,1,3
01302700,YESHIVATH VIZNITZ                       ,NY,10952-3021,Private      ,1,0,1,1,0,1
01302900,BORICUA COLLEGE                         ,NY,10032-1599,Private      ,131,361,492,209,603,812
02056400,CAPRI COSMETOLOGY LEARNING CENTER       ,NY,10954-0000,Proprietary  ,55,62,117,73,99,172
02066200,THE NEW SCHOOL                          ,NY,10011-0000,Private      ,1060,1348,2408,6140,3926,10066
02069000,NEW YORK SCHOOL OF INTERIOR DESIGN      ,NY,10021-0000,Private      ,60,153,213,159,290,449
02075700,BRIARCLIFFE COLLEGE                     ,NY,11714-0000,Proprietary  ,105,264,369,323,836,1159
02075702,BRIARCLIFFE COLLEGE - PATCHOGUE         ,NY,11772-3019,Proprietary  ,111,165,276,378,530,908
02092400,RIDLEY-LOWELL SCHOOL OF BUSINESS        ,NY,13905-0000,Proprietary  ,8,53,61,27,89,116
02093700,LONG ISLAND BUSINESS INSTITUTE          ,NY,11725-0000,Proprietary  ,155,638,793,187,747,934
02093701,LONG ISLAND BUSINESS INSTITUTE - FLUSHIN,NY,11354-4429,Proprietary  ,2,12,14,10,23,33
02098400,HERKIMER COUNTY BOCES                   ,NY,13350-0000,Public       ,11,48,59,22,65,87
02104300,OTSEGO AREA SCHOOL OF PRAC NURSING      ,NY,12167-0000,Public       ,0,2,2,2,4,6
02105900,HAIR DESIGN INSTITUTE AT FIFTH AVE      ,NY,11220-0000,Proprietary  ,9,51,60,28,78,106
02106800,BRAMSON ORT COLLEGE                     ,NY,11375-0000,Private      ,93,269,362,116,293,409
02110900,CATTARAUGUS/ALLEGANY BOCES              ,NY,14760-0000,Public       ,12,40,52,30,66,96
02112301,RIDLEY - LOWELL BUSINESS & TECHNICAL INS,NY,12601-3328,Proprietary  ,42,166,208,56,225,281
02116011,SANFORD-BROWN INSTITUTE - NEW YORK      ,NY,10003-2103,Proprietary  ,75,269,344,152,528,680
02124000,ORANGE ULSTER BOCES SCH OF PRAC NRS     ,NY,10924-9401,Public       ,18,55,73,33,99,132
02125500,CIRCLE IN THE SQUARE THEATRE SCHOOL     ,NY,10019-0000,Private      ,16,18,34,47,44,91
02126300,MADISON-ONEIDA BOCES PRAC NRS           ,NY,13478-0000,Public       ,6,17,23,11,28,39
02138500,BOCES RENSSELAER SCHOOL OF PN           ,NY,12033-3221,Public       ,4,11,15,5,14,19
02145800,CAYUGA ONONDAGA BOCES                   ,NY,13021-9430,Public       ,11,25,36,26,48,74
02146000,WAYNE-FINGER LAKES BOCES                ,NY,14513-0000,Public       ,22,123,145,38,192,230
02152000,YESHIVA SHAAR HATORAH ITRI TORAH        ,NY,11418-0000,Private      ,1,0,1,2,0,2
02153600,BROOME-TIOGA BOCES PN PROG              ,NY,13905-0000,Public       ,10,56,66,25,96,121
02157900,ROCHESTER GENERAL HOSPITAL              ,NY,14621-3001,Private      ,19,43,62,30,60,90
02158200,WSHNGTN-SARTGA-WARN-HMLTN-ESX BOCES     ,NY,12839-1051,Public       ,6,26,32,10,44,54
02160100,GENEVA GENERAL HOSPITAL                 ,NY,14456-0000,Private      ,18,85,103,37,127,164
02163400,NEW YORK CAREER INSTITUTE               ,NY,10007-2801,Proprietary  ,52,153,205,92,341,433
02169100,DAVIS COLLEGE                           ,NY,13790-0000,Private      ,66,35,101,126,63,189
02170000,SWEDISH INSTITUTE                       ,NY,10001-0000,Proprietary  ,70,324,394,124,685,809
02170200,ALBANY SCHOHARIE SCHENECTADY            ,NY,12205-0000,Public       ,4,31,35,16,53,69
02171900,AILEY SCHOOL (THE)                      ,NY,10019-4402,Private      ,39,22,61,135,54,189
02172100,HAMILTON-FULTON-MONTGOMERY BOCES        ,NY,12095-0665,Public       ,11,25,36,29,44,73
02172800,DUTCHESS COUNTY BOCES SCH PRAC NURS     ,NY,12601-0000,Public       ,20,54,74,46,100,146
02173200,EMPIRE BEAUTY SCHOOL                    ,NY,10001-0000,Proprietary  ,296,656,952,467,1118,1585
02173900,ULSTER COUNTY BOCES PRACTICAL NRSG      ,NY,12466-0000,Public       ,14,54,68,20,100,120
02176000,CHERYL FELL'S SCHOOL OF BUSINESS        ,NY,14304-0000,Proprietary  ,3,46,49,7,52,59
02179400,EASTERN SUFFOLK BOCES                   ,NY,11713-0000,Public       ,70,133,203,109,209,318
02182200,NEW SCHOOL OF RADIO & TELEVISION        ,NY,12206-1106,Proprietary  ,15,27,42,40,53,93
02191600,TORAH TEMIMAH TALMUDICAL SEMINARY       ,NY,11218-0000,Private      ,2,0,2,3,0,3
02192500,BELLEVUE HOSP CTR SCH RAD TECH          ,NY,10016-0000,Public       ,5,21,26,13,62,75
02199300,ORLEANS-NIAGARA BOCES                   ,NY,14132-0000,Public       ,8,31,39,16,63,79
02206000,HUNTER BUSINESS SCHOOL                  ,NY,11756-0000,Proprietary  ,96,299,395,143,415,558
02219500,MILDRED ELLEY                           ,NY,12206-1513,Proprietary  ,168,1295,1463,200,1586,1786
02235600,ERIE 2-CHAUTAUQUA-CATTARAUGUS BOCES     ,NY,14006-0000,Public       ,11,70,81,17,84,101
02265100,YESHIVA DERECH CHAIM                    ,NY,11218-0000,Private      ,1,0,1,6,1,7
02272900,ROCKLAND COUNTY BOCES PRAC NRSG SCH     ,NY,10994-0000,Public       ,6,23,29,12,36,48
02275900,"MODERN WELDING SCHOOL, INC.             ",NY,12304-0000,Proprietary  ,15,25,40,40,57,97
02287800,NATIONAL TRACTOR TRAILER SCHOOL         ,NY,13088-2505,Proprietary  ,10,94,104,13,128,141
02294900,INSTITUTE OF AUDIO RESEARCH             ,NY,10003-0000,Proprietary  ,40,105,145,83,190,273
02306500,PROFESSIONAL BUSINESS COLLEGE           ,NY,10013-5049,Private      ,4,9,13,16,37,53
02314200,EMPIRE BEAUTY SCHOOL                    ,NY,10566-3805,Proprietary  ,16,16,32,20,20,40
02350600,YESHIVA AND KOLLEL HARBOTZAS TORAH      ,NY,11230-0000,Private      ,0,0,0,1,1,2
02491400,SPANISH AMERICAN INSTITUTE              ,NY,10036-0000,Private      ,1,8,9,3,15,18
02505800,YESHIVA KARLIN STOLIN RAB INSTITUTE     ,NY,11204-0000,Private      ,0,0,0,2,3,5
02505900,SH-OR YOSHUV RABBINICAL COLLEGE         ,NY,11691-0000,Private      ,2,2,4,5,2,7
02506000,ASSOCIATED BETH RIVKAH SCHOOLS          ,NY,11225-0000,Private      ,25,1,26,32,2,34
02506100,CITY UNIV OF NEW YORK-CENTRAL           ,NY,10021-0000,Public       ,300,363,663,1605,1002,2607
02506800,YESHIVAT MIKDASH MELECH                 ,NY,11230-0000,Private      ,3,1,4,11,2,13
02511500,JOFFREY BALLET SCHOOL                   ,NY,10011-0000,Proprietary  ,41,5,46,120,12,132
02513500,MAR JON SCHOOL OF BEAUTY CULTURE        ,NY,14150-0000,Proprietary  ,6,14,20,10,24,34
02525600,ART INSTITUTE OF NEW YORK CITY (THE)    ,NY,10013-2429,Proprietary  ,281,271,552,906,661,1567
02540800,"GLOBE INSTITUTE OF TECHNOLOGY, INC.     ",NY,10007-0000,Proprietary  ,135,128,263,219,181,400
02546000,TRI-STATE COLLEGE OF ACUPUNCTURE        ,NY,10011-0000,Proprietary  ,1,50,51,2,72,74
02546300,YESHIVA OF THE TELSHE ALUMNI            ,NY,10471-0000,Private      ,1,0,1,1,0,1
02550600,TALMUDICAL INST OF UPSTATE NY           ,NY,14607-0000,Private      ,0,1,1,1,2,3
02556700,SEMINAR L'MOROS BAIS YAAKOV             ,NY,11219-0000,Private      ,135,0,135,137,0,137
02572900,BUSINESS INFORMATICS CENTER             ,NY,11580-0000,Proprietary  ,2,5,7,4,11,15
02575400,FRENCH CULINARY INSTITUTE               ,NY,10013-2618,Proprietary  ,85,195,280,173,390,563
02587600,ORLO SCH HAIR DESIGN & COSMETOLOGY      ,NY,12206-1723,Proprietary  ,5,16,21,9,28,37
02599400,NEW YORK COLLEGE OF HEALTH PROFESSIONS  ,NY,11791-4413,Private      ,33,199,232,81,475,556
02600100,NEW YORK ACADEMY OF ART (THE)           ,NY,10013-2911,Private      ,37,66,103,130,211,341
02614900,SANFORD-BROWN INSTITUTE                 ,NY,10604-2910,Proprietary  ,1,3,4,7,20,27
02615001,SANFORD-BROWN COLLEGE - SANFORD-BROWN IN,NY,11530-4734,Proprietary  ,64,115,179,110,225,335
02616600,SHEAR EGO INTERNATIONAL SCHOOL OF HAIR D,NY,14617-3501,Proprietary  ,37,39,76,51,72,123
02617000,CONTINENTAL SCH OF BEAUTY CULTURE       ,NY,14020-0000,Proprietary  ,4,16,20,6,17,23
02617002,CONTINENTAL SCHOOL OF BEAUTY CULTURE  - ,NY,14020-1908,Proprietary  ,8,9,17,9,14,23
02622900,BAIS MEDRASH ELYON                      ,NY,10952-3013,Private      ,0,1,1,0,1,1
03000100,YESHIVA GEDOLAH IMREI YOSEF DSPINKA     ,NY,11219-4696,Private      ,0,0,0,1,0,1
03007200,DANCE THEATRE OF HARLEM                 ,NY,10031-0000,Private      ,8,10,18,30,29,59
03027701,PACIFIC COLLEGE OF ORIENTAL MEDICINE - N,NY,10010-7108,Proprietary  ,3,133,136,8,315,323
03081600,DELAWARE CHENANGO MADISON OT. BOCES     ,NY,13815-9554,Public       ,5,12,17,8,21,29
03095500,ASA INST BUSINESS & COMPUTER TECH       ,NY,11201-5208,Proprietary  ,854,1773,2627,1065,2056,3121
03096200,CHARLES STUART SCHOOL                   ,NY,11229-2004,Proprietary  ,2,10,12,5,12,17
03103700,ADIRONDACK BEAUTY SCHOOL                ,NY,12801-3158,Proprietary  ,5,12,17,16,27,43
03104900,SULLIVAN COUNTY BOCES                   ,NY,12754-2116,Public       ,2,3,5,6,10,16
03115300,GENESEE VALLEY BOCES                    ,NY,14020-1099,Public       ,3,34,37,8,69,77
03120700,NEW YORK CONSERVATORY FOR DRAMATIC ARTS ,NY,10011-4225,Proprietary  ,142,64,206,379,128,507
03127100,YESHIVAS NOVOMINSK                      ,NY,11219-0000,Private      ,3,0,3,3,0,3
03129200,RABBINICAL CLG OHR SHIMAR YISROEL       ,NY,11211-8102,Private      ,1,0,1,1,1,2
03169300,STUDIO JEWELERS                         ,NY,10016-4112,Proprietary  ,1,9,10,2,17,19
03181400,MERKAZ BNOS                             ,NY,11214-4911,Private      ,3,96,99,3,96,99
03191300,CUNY SCHOOL OF LAW @ QUEENS COLLEGE     ,NY,11367-0000,Public       ,138,415,553,544,1093,1637
03193300,MANHATTAN SCHOOL OF COMPUTER TECH       ,NY,11230-1617,Private      ,53,205,258,124,352,476
03203300,NEW YORK INSTITUTE OF MASSAGE           ,NY,14221-6021,Proprietary  ,7,35,42,13,60,73
03216300,UNIFICATION THEOLOGICAL SEMINARY        ,NY,12507-5021,Private      ,1,2,3,5,14,19
03328300,FRANKLIN CAREER INSTITUTE               ,NY,11550-3003,Private      ,11,26,37,17,38,55
03328301,FRANKLIN CAREER INSTITUTE - BROOKLYN    ,NY,11220-3110,Private      ,35,128,163,63,235,298
03358300,ALLEN SCHOOL                            ,NY,11432-4901,Proprietary  ,75,463,538,101,672,773
03358301,ALLEN SCHOOL - BROOKLYN                 ,NY,11201-0000,Proprietary  ,47,166,213,86,320,406
03380300,STAR CAREER ACADEMY                     ,NY,11791-5311,Proprietary  ,17,57,74,33,102,135
03419400,NORTHEASTERN SEMINARY                   ,NY,14624-1997,Private      ,1,40,41,19,63,82
03433500,LIA SCHORR INSTITUTE OF COSMETIC SK     ,NY,10022-2614,Proprietary  ,3,9,12,6,12,18
03443300,NEW YORK COLLEGE OF TRADITIONAL CHINESE ,NY,11501-0000,Private      ,1,20,21,2,40,42
03496300,YESHIVA SHAAREI TORAH OF ROCKLAND       ,NY,10901-4003,Private      ,0,1,1,0,1,1
03537300,NEW YORK AUTOMOTIVE & DIESEL INSTIT     ,NY,11101-0000,Proprietary  ,40,120,160,53,148,201
03651300,SAINT JOSEPH'S MEDICAL CENTER SCHOO     ,NY,10701-4080,Private      ,0,0,0,1,7,8
03652300,METROPOLITAN LEARNING INSTITUTE         ,NY,11374-2101,Private      ,36,495,531,36,528,564
03665400,CHRISTIE'S EDUCATION                    ,NY,10036-8002,Proprietary  ,0,11,11,0,31,31
03713300,BEIS MEDRASH HEICHAL DOVID              ,NY,11691-4433,Private      ,2,1,3,3,1,4
03773300,CENTER FOR NATURAL WELLNESS SCHOOL OF MA,NY,12205-1601,Proprietary  ,11,49,60,25,89,114
03802300,UTA MESIVTA OF KIRYAS JOEL              ,NY,10950-2169,Private      ,0,1,1,1,1,2
03839300,AVEDA INSTITUTE NEW YORK                ,NY,10013-1522,Proprietary  ,33,95,128,70,182,252
03881300,UNION GRADUATE COLLEGE                  ,NY,12308-3131,Private      ,0,65,65,11,130,141
03903400,AMERICAN BEAUTY SCHOOL                  ,NY,10462-8003,Proprietary  ,30,125,155,65,194,259
03941400,ELITE ACADEMY OF BEAUTY ARTS            ,NY,11223-1630,Proprietary  ,0,0,0,1,2,3
03983300,"SCHOOL OF PROFESSIONAL HORTICULTURE, AT ",NY,10458-5126,Private      ,3,8,11,7,20,27
03988300,"SAE INSTITUTE OF TECHNOLOGY, NEW YORK   ",NY,10001-2915,Proprietary  ,95,111,206,221,236,457
04043300,ACE COMPUTER TRAINING CENTER            ,NY,11375-5337,Proprietary  ,12,44,56,21,65,86
04092401,MAKE-UP DESIGNORY -                     ,NY,10012-0041,Proprietary  ,66,85,151,172,194,366
04095300,KING'S COLLEGE (THE)                    ,NY,10018-0110,Private      ,88,39,127,888,112,1000
04102300,NEW AGE TRAINING                        ,NY,10001-4006,Proprietary  ,18,115,133,21,133,154
04115500,TALMUDICAL SEMINARY OF BOBOV            ,NY,11219-3826,Private      ,0,0,0,0,1,1
04117100,EDP SCHOOL OF COMPUTER PROGRAMMING      ,NY,11235-0000,Private      ,6,59,65,17,94,111
04117700,"MONROE 2-ORLEANS BOCES, CENTER FOR WORK ",NY,14624-1119,Public       ,27,52,79,59,101,160
04119600,YESHIVA OF FAR ROCKAWAY DERECH AYSON RAB,NY,11691-5219,Private      ,4,0,4,5,0,5
04125600,CAREER SCHOOL OF NY                     ,NY,10301-2416,Private      ,13,50,63,26,73,99
04131500,COLLECTIVE (THE)                        ,NY,10011-2026,Proprietary  ,2,9,11,11,13,24
04133700,NEW YORK MEDICAL CAREER TRAINING CENTER ,NY,11354-6504,Proprietary  ,10,58,68,17,93,110
04133701,NEW YORK MEDICAL CAREER TRAINING CENTER ,NY,10018-6504,Proprietary  ,21,75,96,47,143,190
04134000,"JOHN PAOLO'S XTREME BEAUTY INSTITUTE, GO",NY,12020-1245,Proprietary  ,3,12,15,7,23,30
04134001,"JOHN PAOLO'S XTREME BEAUTY INSTITUTE, GO",NY,13417-1319,Proprietary  ,8,18,26,14,42,56
04137700,ANN MARIE'S WORLD OF BEAUTY SCHOOL      ,NY,13901-2308,Proprietary  ,0,0,0,2,2,4
04138100,YESHIVA OF MACHZIKAI HADAS              ,NY,11219-1408,Private      ,0,0,0,1,0,1
04144300,INSTITUTE OF CULINARY EDUCATION         ,NY,10010-5205,Proprietary  ,113,243,356,295,513,808
04148000,NEW LIFE BUSINESS INSTITUTE             ,NY,11432-6149,Proprietary  ,5,59,64,9,78,87
04151200,SALON PROFESSIONAL ACADEMY (THE)        ,NY,14150-9200,Proprietary  ,39,42,81,49,71,120
04155300,ONONDAGA SCHOOL OF THERAPEUTIC MASSAGE  ,NY,13210-1533,Proprietary  ,27,90,117,53,138,191
04156000,ACADEMY OF COSMETOLOGY & ESTHETICS NYC (,NY,10306-3003,Proprietary  ,24,40,64,71,88,159
04157500,ACCESS CAREERS                          ,NY,11201-5826,Proprietary  ,14,31,45,32,75,107
04165700,"JOHN PAOLO'S XTREME BEAUTY INSTITUTE, GO",NY,12110-3053,Proprietary  ,3,6,9,4,13,17
04166000,MANHATTAN INSTITUTE (THE)               ,NY,10016-6516,Proprietary  ,28,58,86,80,114,194
04167600,FINGER LAKES SCHOOL OF MASSAGE (THE)    ,NY,14850-1384,Proprietary  ,21,45,66,32,67,99
04167601,FINGER LAKES SCHOOL OF MASSAGE (THE) -  ,NY,10549-1103,Proprietary  ,9,37,46,14,55,69
04178700,ATELIER ESTHETIQUE INSTITUTE OF ESTHETIC,NY,10016-8804,Proprietary  ,7,49,56,12,82,94
04179800,SOTHEBY'S INSTITUTE OF ART - NY         ,NY,10022-6717,Proprietary  ,2,35,37,15,99,114
04180200,LONG ISLAND NAIL & SKIN CARE INSTITUTE  ,NY,11756-1316,Proprietary  ,4,21,25,6,39,45
04189000,LONG ISLAND BARBER INSTITUTE (THE)      ,NY,11550-6317,Proprietary  ,3,14,17,10,24,34
04190500,NEW YORK SCHOOL OF ESTHETICS & DAY SPA  ,NY,10591-3232,Proprietary  ,7,16,23,12,34,46
04192800,BE'ER YAAKOV TALMUDIC SEMINARY          ,NY,10977-1912,Private      ,0,1,1,0,1,1
04204300,AESTHETIC SCIENCE INSTITUTE (THE)       ,NY,12110-1095,Proprietary  ,8,18,26,15,37,52
04206200,DIGITAL FILM ACADEMY                    ,NY,10036-3708,Proprietary  ,31,49,80,94,123,217
04207400,YESHIVA GEDOLA OHR YISRAEL              ,NY,11229-1817,Private      ,1,0,1,2,0,2
04207600,AMERICAN ACADEMY OF PERSONAL TRAINING   ,NY,10011-7301,Proprietary  ,16,47,63,32,93,125
04208600,RELAY SCHOOL OF EDUCATION               ,NY,10011-4233,Private      ,1,93,94,3,161,164
04208800,GLORIA FRANCIS SCHOOL OF MAKE-UP ARTISTR,NY,11801-3873,Proprietary  ,5,12,17,8,14,22
04210100,STELLA AND CHARLES GUTTMAN COMMUNITY COL,NY,10018-2602,Public       ,526,100,626,3016,384,3400
04210400,BETH MEDRASH MEOR YITZCHOK              ,NY,10952-4023,Private      ,9,1,10,9,1,10
04210700,NEW YORK INSTITUTE OF BEAUTY            ,NY,11749-1479,Proprietary  ,14,47,61,23,58,81
04212500,CACTUS ACADEMY (THE)                    ,NY,11530-3402,Proprietary  ,19,18,37,34,40,74
04213400,ACCESS CAREERS                          ,NY,11550-0000,Proprietary  ,2,18,20,11,33,44
04213500,SHARP EDGEZ BARBER INSTITUTE            ,NY,14620-0000,Proprietary  ,6,22,28,8,26,34
04215900,YESHIVA GEDOLAH KESSER TORAH            ,NY,10952-2127,Private      ,10,0,10,10,0,10
04223100,ARROJO COSMETOLOGY SCHOOL               ,NY,10014-4960,Proprietary  ,29,63,92,63,119,182
04223200,GRACE INTERNATIONAL BEAUTY SCHOOL       ,NY,11355-2446,Proprietary  ,3,39,42,6,60,66
04223300,ALLIANCE COMPUTING SOLUTIONS            ,NY,11354-6507,Proprietary  ,0,11,11,5,16,21
04223800,ELECTRICAL TRAINING CENTER (THE)        ,NY,11726-2701,Proprietary  ,17,20,37,30,48,78
04225500,WESTCHESTER SCHOOL FOR DENTAL ASSISTANTS,NY,10606-1246,Proprietary  ,13,49,62,15,68,83
04227200,BET MEDRASH GADOL ATERET TORAH          ,NY,11223-1933,Private      ,5,3,8,7,4,11
04228300,PAUL MITCHELL THE SCHOOL                ,NY,12305-2303,Proprietary  ,29,24,53,60,47,107
04231500,YESHIVA SHOLOM SHACHNA                  ,NY,11230-2621,Private      ,0,0,0,1,0,1
04233700,CHRISTINE VALMY INTERNATIONAL SCHOOL FOR,NY,10016-7701,Proprietary  ,12,71,83,19,127,146
04234200,CENTER FOR ULTRASOUND RESEARCH & EDUCATI,NY,10801-5104,Proprietary  ,4,8,12,10,19,29
04234300,CULINARY TECH CENTER                    ,NY,10001-2320,Proprietary  ,16,83,99,53,166,219
04234900,AMG SCHOOL OF LICENSE PRACTICAL NURSING ,NY,11201-1728,Proprietary  ,2,17,19,2,17,19
04237500,DERMALOGICA ACADEMY                     ,NY,10011-2420,Proprietary  ,6,30,36,11,56,67
00267808,BRYANT & STRATTON COLLEGE - PARMA       ,OH,44130-0000,Proprietary  ,139,764,903,287,1644,1931
00301000,ANTIOCH UNIVERSITY                      ,OH,45387-1608,Private      ,21,302,323,157,567,724
00301100,ART ACADEMY OF CINCINNATI               ,OH,45202-7106,Private      ,114,69,183,377,161,538
00301200,ASHLAND UNIVERSITY                      ,OH,44805-3799,Private      ,515,822,1337,3423,1856,5279
00301300,ATHENAEUM OF OHIO                       ,OH,45230-2000,Private      ,0,3,3,1,11,12
00301400,BALDWIN-WALLACE COLLEGE                 ,OH,44017-2088,Private      ,856,444,1300,4294,1170,5464
00301600,BLUFFTON UNIVERSITY                     ,OH,45817-2104,Private      ,223,103,326,1207,271,1478
00301800,BOWLING GREEN STATE UNIVERSITY          ,OH,43403-0001,Public       ,2936,1543,4479,17430,4320,21750
00302300,CAPITAL UNIVERSITY                      ,OH,43209-2394,Private      ,588,748,1336,3812,1878,5690
00302400,CASE WESTERN RESERVE UNIV               ,OH,44106-0000,Private      ,1228,682,1910,10656,1724,12380
00302401,CASE WESTERN RESERVE UNIV - MED         ,OH,44106-0000,Private      ,9,397,406,74,1114,1188
00302402,CASE WESTERN RESERVE UNIV - DENTAL      ,OH,44106-0000,Private      ,6,119,125,37,296,333
00302403,CASE WESTERN RESERVE UNIV - LAW         ,OH,44106-0000,Private      ,5,196,201,25,718,743
00302404,CASE WESTERN RESERVE UNIV - UG          ,OH,44106-0000,Private      ,43,14,57,169,33,202
00302405,CASE WESTERN RESERVE UNIV - MSASS       ,OH,44106-0000,Private      ,1,215,216,13,571,584
00302406,CASE WESTERN RESERVE UNIV - NURS UG     ,OH,44106-0000,Private      ,40,51,91,192,131,323
00302407,CASE WESTERN RESERVE UNIV - WSOM        ,OH,44106-0000,Private      ,3,85,88,12,156,168
00302408,CASE WESTERN RESERVE UNIV -A&S GRAD     ,OH,44106-0000,Private      ,0,106,106,4,229,233
00302409,CASE WESTERN RESERVE UNIV -ENG GRAD     ,OH,44106-0000,Private      ,6,19,25,27,57,84
00302410,CASE WESTERN RESERVE UNIV -NURS GRD     ,OH,44106-0000,Private      ,1,142,143,16,317,333
00302500,CEDARVILLE UNIVERSITY                   ,OH,45314-8564,Private      ,683,158,841,3677,404,4081
00302600,CENTRAL STATE UNIVERSITY                ,OH,45384-1004,Public       ,510,302,812,2593,957,3550
00302900,CINCINNATI CHRISTIAN UNIVERSITY         ,OH,45204-3200,Private      ,126,176,302,509,406,915
00303000,OHIO CHRISTIAN UNIVERSITY               ,OH,43113-9487,Private      ,222,1132,1354,752,2701,3453
00303100,CLEVELAND INSTITUTE OF MUSIC            ,OH,44106-1776,Private      ,21,42,63,406,328,734
00303200,CLEVELAND STATE UNIVERSITY              ,OH,44115-2214,Public       ,2536,3856,6392,10704,9006,19710
00303300,MOUNT ST. JOSEPH UNIVERSITY             ,OH,45233-1670,Private      ,261,366,627,1798,1067,2865
00303500,OHIO DOMINICAN UNIVERSITY               ,OH,43219-2099,Private      ,320,568,888,1728,1466,3194
00303600,FRANCISCAN UNIV OF STEUBENVILLE         ,OH,43952-1763,Private      ,536,217,753,2111,508,2619
00303700,COLLEGE OF WOOSTER                      ,OH,44691-2363,Private      ,386,23,409,3340,102,3442
00303900,COLUMBUS COLLEGE OF ART AND DESIGN      ,OH,43215-1758,Private      ,256,177,433,1317,444,1761
00304000,CUYAHOGA COMMUNITY COLLEGE              ,OH,44115-2878,Public       ,3091,6738,9829,7463,13457,20920
00304100,"DEFIANCE COLLEGE, THE                   ",OH,43512-1695,Private      ,197,88,285,1045,205,1250
00304200,DENISON UNIVERSITY                      ,OH,43023-1329,Private      ,218,18,236,3306,115,3421
00304400,TRINITY LUTHERAN SEMINARY               ,OH,43209-0000,Private      ,0,48,48,1,94,95
00304500,UNIVERSITY OF FINDLAY                   ,OH,45840-3695,Private      ,558,428,986,3237,1099,4336
00304600,FRANKLIN UNIVERSITY                     ,OH,43215-5399,Private      ,282,2395,2677,766,6222,6988
00304800,HEIDELBERG UNIVERSITY                   ,OH,44883-2462,Private      ,324,93,417,1595,216,1811
00304900,HIRAM COLLEGE                           ,OH,44234-1808,Private      ,194,92,286,1325,244,1569
00305000,JOHN CARROLL UNIVERSITY                 ,OH,44118-4581,Private      ,679,236,915,4314,581,4895
00305100,KENT STATE UNIVERSITY                   ,OH,44242-0001,Public       ,4814,3524,8338,23933,9528,33461
00305101,KENT STATE UNIVERSITY - GEAUGA CAMPUS   ,OH,44021-9500,Public       ,280,263,543,709,707,1416
00305102,KENT STATE UNIVERSITY - STARK CAMPUS    ,OH,44720-7599,Public       ,839,982,1821,2539,2318,4857
00305103,KENT STATE UNIVERSITY - TUSCARAWAS CAMPU,OH,44663-9403,Public       ,272,319,591,789,724,1513
00305104,KENT STATE UNIVERSITY - TRUMBULL CAMPUS ,OH,44483-1998,Public       ,295,482,777,971,1306,2277
00305105,KENT STATE UNIVERSITY - ASHTABULA CAMPUS,OH,44004-2299,Public       ,224,451,675,699,1145,1844
00305106,KENT STATE UNIVERSITY - EAST LIVERPOOL C,OH,43920-3497,Public       ,141,219,360,350,536,886
00305107,KENT STATE UNIVERSITY - SALEM CAMPUS    ,OH,44460-9412,Public       ,239,326,565,775,786,1561
00306500,KENYON COLLEGE                          ,OH,43022-9623,Private      ,122,11,133,3822,83,3905
00306600,LAKE ERIE COLLEGE                       ,OH,44077-3389,Private      ,243,117,360,1087,285,1372
00306800,LORAIN COUNTY COMMUNITY COLLEGE         ,OH,44035-1691,Public       ,1084,2280,3364,2585,4209,6794
00306900,LOURDES COLLEGE                         ,OH,43560-2898,Private      ,242,324,566,875,797,1672
00307200,MALONE UNIVERSITY                       ,OH,44709-3897,Private      ,219,323,542,1566,806,2372
00307300,MARIETTA COLLEGE                        ,OH,45750-4033,Private      ,261,97,358,1931,268,2199
00307500,METHODIST THEOLOGICAL SCH IN OHIO       ,OH,43015-0000,Private      ,0,48,48,1,107,108
00307700,MIAMI UNIVERSITY                        ,OH,45056-1831,Public       ,1518,913,2431,21339,3528,24867
00307800,WRIGHT STATE UNIVERSITY                 ,OH,45435-0002,Public       ,2140,2451,4591,11387,7452,18839
00308300,UNIVERSITY OF MOUNT UNION               ,OH,44601-3993,Private      ,537,79,616,2899,259,3158
00308400,MUSKINGUM UNIVERSITY                    ,OH,43762-1199,Private      ,453,227,680,1884,438,2322
00308500,NOTRE DAME COLLEGE OF OHIO              ,OH,44121-4293,Private      ,477,452,929,2009,1024,3033
00308600,OBERLIN COLLEGE                         ,OH,44074-1090,Private      ,600,49,649,4951,172,5123
00308900,OHIO NORTHERN UNIVERSITY                ,OH,45810-1555,Private      ,603,274,877,3269,703,3972
00309000,OHIO STATE UNIVERSITY-ALL CAMPUSES      ,OH,43210-1358,Public       ,4722,4534,9256,52939,19272,72211
00310000,OHIO UNIVERSITY                         ,OH,45701-2979,Public       ,3158,3470,6628,22570,9278,31848
00310002,"OHIO UNIVERSITY, ZANESVILLE CAMPUS      ",OH,43701-0000,Public       ,282,365,647,1030,924,1954
00310003,"OHIO UNIVERSITY, LANCASTER CAMPUS       ",OH,43130-0000,Public       ,341,486,827,1280,1206,2486
00310004,"OHIO UNIVERSITY, SOUTHERN CAMPUS        ",OH,45638-0000,Public       ,187,423,610,686,1133,1819
00310005,"OHIO UNIVERSITY, CHILLICOTHE CAMPUS     ",OH,45601-0000,Public       ,268,488,756,940,1209,2149
00310006,"OHIO UNIVERSITY, EASTERN CAMPUS         ",OH,43950-0000,Public       ,118,106,224,367,255,622
00310008,OHIO UNIV COLL OF OSTEOPATHIC MED       ,OH,45701-0000,Public       ,1,230,231,20,729,749
00310900,OHIO WESLEYAN UNIVERSITY                ,OH,43015-2398,Private      ,293,47,340,2816,165,2981
00311000,OTTERBEIN UNIVERSITY                    ,OH,43081-2006,Private      ,307,236,543,3415,738,4153
00311300,PONTIFICAL COLLEGE JOSEPHINUM           ,OH,43235-1498,Private      ,10,6,16,34,10,44
00311400,FIRELANDS REGIONAL MEDICAL CENTER - SOUT,OH,44870-4788,Private      ,21,42,63,57,106,163
00311500,RABBINICAL COLLEGE OF TELSHE            ,OH,44092-2584,Private      ,3,2,5,6,2,8
00311600,UNIV OF RIO GRANDE                      ,OH,45674-3131,Private      ,371,455,826,1189,1019,2208
00311900,SINCLAIR COMMUNITY COLLEGE              ,OH,45402-1460,Public       ,2407,4289,6696,5756,8473,14229
00312100,TIFFIN UNIVERSITY                       ,OH,44883-2161,Private      ,518,869,1387,2181,2065,4246
00312200,UNITED THEOLOGICAL SEMINARY             ,OH,45406-0000,Private      ,0,151,151,0,390,390
00312300,UNIVERSITY OF AKRON                     ,OH,44325-6211,Public       ,2797,2406,5203,18992,8768,27760
00312500,UNIVERSITY OF CINCINNATI                ,OH,45221-0125,Public       ,5078,5948,11026,25482,15035,40517
00312504,UNIVERSITY OF CINCINNATI - MEDICINE     ,OH,45267-0553,Public       ,52,492,544,255,1337,1592
00312700,UNIVERSITY OF DAYTON                    ,OH,45469-0002,Private      ,1693,818,2511,12756,2255,15011
00313100,UNIVERSITY OF TOLEDO                    ,OH,43606-3390,Public       ,3205,2853,6058,14681,7154,21835
00313300,URBANA UNIVERSITY                       ,OH,43078-2091,Private      ,150,192,342,574,449,1023
00313400,URSULINE COLLEGE                        ,OH,44124-4398,Private      ,99,322,421,634,771,1405
00313500,WALSH UNIVERSITY                        ,OH,44720-3396,Private      ,284,361,645,2227,963,3190
00314100,WILBERFORCE UNIVERSITY                  ,OH,45384-1001,Private      ,140,149,289,465,321,786
00314200,WILMINGTON COLLEGE                      ,OH,45177-2499,Private      ,377,111,488,1882,314,2196
00314300,WITTENBERG UNIVERSITY                   ,OH,45501-2199,Private      ,228,95,323,3629,288,3917
00314400,XAVIER UNIVERSITY                       ,OH,45207-1035,Private      ,653,737,1390,7059,1930,8989
00314500,YOUNGSTOWN STATE UNIVERSITY             ,OH,44555-0001,Public       ,1640,1598,3238,7945,4343,12288
00398200,CLEVELAND INSTITUTE OF ART              ,OH,44106-1700,Private      ,108,67,175,946,185,1131
00406000,WINEBRENNER THEOLOGICAL SEMINARY        ,OH,45840-0000,Private      ,0,22,22,1,34,35
00485200,CLARK STATE COMMUNITY COLLEGE           ,OH,45505-4795,Public       ,554,1564,2118,1339,3259,4598
00485300,BRADFORD SCHOOL                         ,OH,43219-0000,Proprietary  ,229,191,420,505,433,938
00485500,DAVIS COLLEGE                           ,OH,43623-4307,Proprietary  ,28,146,174,60,296,356
00486100,UNIVERSITY OF NORTHWESTERN OHIO         ,OH,45805-1498,Private      ,1102,509,1611,3994,1217,5211
00486600,STAUTZENBERGER COLLEGE                  ,OH,43537-4007,Proprietary  ,165,472,637,291,737,1028
00510200,SCH OF DIAGNOSTIC IMAGING-CLEVELAND     ,OH,44119-0000,Private      ,6,18,24,8,27,35
00531300,NORTH CENTRAL STATE COLLEGE             ,OH,44901-0000,Public       ,291,608,899,860,1357,2217
00575300,OWENS STATE COMMUNITY COLLEGE           ,OH,43699-0000,Public       ,1262,2202,3464,3104,4428,7532
00648700,AULTMAN COLLEGE OF NURSING AND HEALTH SC,OH,44710-1799,Private      ,55,165,220,159,361,520
00648900,CHRIST COLLEGE OF NURSING AND HEALTH SCI,OH,45219-2906,Private      ,121,278,399,375,642,1017
00649400,GOOD SAMARITAN COLG-NURSING/HEALTH      ,OH,45220-2489,Private      ,92,201,293,260,423,683
00650700,TRINIT HEALTH SYSTEM SCH OF NURSING     ,OH,43952-2667,Private      ,23,54,77,58,110,168
00680400,LAKELAND COMMUNITY COLLEGE              ,OH,44094-5198,Public       ,762,1696,2458,1908,3367,5275
00686700,COLUMBUS STATE COMMUNITY COLLEGE        ,OH,43215-1786,Public       ,3678,6179,9857,9762,13495,23257
00703500,KETTERING COLLEGE OF MEDICAL ARTS       ,OH,45429-1299,Private      ,102,205,307,438,548,986
00708500,MOUNT VERNON NAZARENE UNIVERSITY        ,OH,43050-9500,Private      ,333,262,595,1408,652,2060
00708501,MOUNT VERNON NAZARENE UNIV - AGS        ,OH,43050-0000,Private      ,13,77,90,56,214,270
00727500,EASTERN GATEWAY COMMUNITY COLLEGE       ,OH,43952-3598,Public       ,384,760,1144,833,1508,2341
00732920,ITT TECHNICAL INSTITUTE                 ,OH,45414-3456,Proprietary  ,112,507,619,199,874,1073
00732992,ITT TECHNICAL INSTITUTE                 ,OH,44509-4098,Proprietary  ,91,283,374,240,834,1074
00747300,CHOFFIN CAREER & TECHNICAL CENTER       ,OH,44503-1628,Public       ,12,29,41,12,29,41
00759800,HOCKING TECHNICAL COLLEGE               ,OH,45764-9582,Public       ,867,697,1564,2140,1487,3627
00812900,ADULT AND COMMUNITY EDUCATION @ HUDSON  ,OH,43211-2017,Public       ,17,153,170,33,268,301
00813200,TOLEDO SCHOOL OF PRACTICAL NURSING      ,OH,43613-5110,Public       ,29,138,167,77,280,357
00813300,ZANE STATE COLLEGE                      ,OH,43701-2626,Public       ,283,368,651,834,883,1717
00819400,AKRON SCHOOL OF PRACTICAL NRSG          ,OH,44311-0000,Public       ,36,66,102,129,161,290
00827800,TERRA COMMUNITY COLLEGE                 ,OH,43420-9670,Public       ,214,425,639,500,838,1338
00867700,NORTHWEST STATE COMMUNITY COLLEGE       ,OH,43502-9542,Public       ,279,481,760,773,1016,1789
00888600,PORTAGE LAKES CAREER CENTER             ,OH,44685-9554,Public       ,14,40,54,25,72,97
00915600,WAYNE COUNTY SCHOOLS CAREER CENTER      ,OH,44677-9672,Public       ,13,76,89,33,129,162
00941200,FORTIS COLLEGE                          ,OH,44221-2998,Proprietary  ,63,448,511,111,712,823
00953000,GERBER AKRON BEAUTY SCHOOL              ,OH,44313-6995,Proprietary  ,4,34,38,17,82,99
00953100,SPA SCHOOL (THE)                        ,OH,43214-1524,Proprietary  ,17,88,105,41,154,195
00966000,TIFFIN ACADEMY OF HAIR DESIGN           ,OH,44883-2833,Proprietary  ,15,12,27,26,23,49
00982805,EVEREST INSTITUTE - COLUMBUS            ,OH,43230-6653,Proprietary  ,43,179,222,57,263,320
00994100,BELMONT TECHNICAL COLLEGE               ,OH,43950-9766,Public       ,203,338,541,426,565,991
00994200,SHAWNEE STATE UNIVERSITY                ,OH,45662-4344,Public       ,934,679,1613,3485,1507,4992
01001700,PAYNE THEOLOGICAL SEMINARY              ,OH,45384-0474,Private      ,1,58,59,1,95,96
01002700,JAMES A. RHODES STATE COLLEGE           ,OH,45804-3597,Public       ,390,663,1053,1128,1260,2388
01016800,NATIONWIDE BEAUTY ACADEMY               ,OH,43228-1000,Proprietary  ,47,67,114,75,147,222
01028000,OHIO STATE BEAUTY ACADEMY               ,OH,45801-0000,Proprietary  ,37,52,89,73,82,155
01032300,HANNAH E MULLINS SCH-PRAC NRSG          ,OH,44460-2906,Public       ,9,20,29,14,44,58
01034500,CINCINNATI STATE TECH & COMM CLG        ,OH,45223-2690,Public       ,1005,2331,3336,3194,6162,9356
01045300,WASHINGTON STATE CMTY COLLEGE           ,OH,45750-9225,Public       ,239,322,561,602,625,1227
01063000,NORTHERN INSTITUTE OF COSMETOLOGY       ,OH,44052-1803,Proprietary  ,6,28,34,11,39,50
01073600,MARION TECHNICAL COLLEGE                ,OH,43302-5694,Public       ,203,433,636,616,1079,1695
01088000,CHATFIELD COLLEGE                       ,OH,45118-9705,Private      ,40,130,170,88,231,319
01088100,STARK STATE COLLEGE                     ,OH,44720-7299,Public       ,1062,2817,3879,2566,5818,8384
01090600,CINCINNATI CLG OF MORTUARY SCIENCE      ,OH,45224-1428,Private      ,26,61,87,73,125,198
01092300,UNION INSTITUTE & UNIVERSITY            ,OH,45206-1925,Private      ,11,428,439,32,992,1024
01099300,HOBART INSTITUTE OF WELDING TECHNOLOGY  ,OH,45373-2400,Private      ,96,75,171,371,181,552
01104600,CENTRAL OHIO TECHNICAL COLLEGE          ,OH,43055-1767,Public       ,366,912,1278,1216,2697,3913
01170300,PENTA COUNTY JOINT VOCATIONAL SCH       ,OH,43551-0000,Public       ,8,49,57,16,67,83
01174400,NATIONAL BEAUTY COLLEGE                 ,OH,44720-0000,Proprietary  ,8,25,33,23,65,88
01174500,OHIO TECHNICAL COLLEGE                  ,OH,44103-1228,Proprietary  ,381,294,675,1126,671,1797
01216600,CAROUSEL BEAUTY COLLEGE                 ,OH,45402-8935,Proprietary  ,46,80,126,64,124,188
01216603,CAROUSEL BEAUTY COLLEGE - OF MIAMI VALLE,OH,45424-2063,Proprietary  ,2,4,6,4,13,17
01224800,CENTRAL SCHOOL OF PRACTICAL NURSING     ,OH,44131-2155,Private      ,7,46,53,22,127,149
01267200,CAROUSEL BEAUTY COLLEGE                 ,OH,45044-5113,Proprietary  ,3,12,15,5,17,22
01275000,EDISON COMMUNITY COLLEGE                ,OH,45356-9239,Public       ,256,631,887,679,1273,1952
01283800,LAURA AND ALVIN SIEGAL COLLEGE OF JUDAIC,OH,44122-7197,Private      ,0,0,0,2,4,6
01284800,MOLER-HOLLYWOOD BEAUTY COLLEGE          ,OH,45202-2577,Proprietary  ,3,19,22,11,44,55
01287000,SOUTHERN STATE COMMUNITY COLLEGE        ,OH,45133-9406,Public       ,288,561,849,677,1053,1730
01289100,ANTONELLI COLLEGE                       ,OH,45202-2592,Proprietary  ,31,159,190,72,302,374
01289600,VIRGINIA MARTI COLLEGE OF ART AND DESIGN,OH,44107-0778,Proprietary  ,26,69,95,72,117,189
01303922,SOUTH UNIVERSITY - CLEVELAND            ,OH,44128-5919,Proprietary  ,20,272,292,44,443,487
01313200,INTERNATIONAL CLG OF BROADCASTING       ,OH,45431-1898,Proprietary  ,19,62,81,35,102,137
02052000,KAPLAN COLLEGE                          ,OH,45439-1984,Proprietary  ,57,399,456,116,790,906
02054300,TRUMBULL BUSINESS COLLEGE               ,OH,44484-0000,Proprietary  ,11,122,133,22,200,222
02056800,DAYMAR COLLEGE                          ,OH,45601-1038,Proprietary  ,2,18,20,7,47,54
02056802,DAYMAR COLLEGE - LANCASTER              ,OH,43130-0000,Proprietary  ,10,50,60,15,96,111
02056803,DAYMAR COLLEGE - NEW BOSTON             ,OH,45662-4900,Proprietary  ,0,25,25,4,46,50
02056804,DAYMAR COLLEGE - JACKSON                ,OH,45640-1728,Proprietary  ,2,12,14,3,25,28
02066100,OHIO STATE COLLEGE/BARBER STYLING       ,OH,43213-0000,Proprietary  ,32,96,128,97,205,302
02073300,GALLIA-JACKSON-VINTON SCH ADULT ED      ,OH,45674-0000,Public       ,24,84,108,54,150,204
02110700,CLEVELAND INST OF DENTAL-MED ASST       ,OH,44115-2285,Proprietary  ,39,171,210,76,297,373
02116009,SANFORD-BROWN COLLEGE - MIDDLEBURG HEIGH,OH,44130-8362,Proprietary  ,0,2,2,1,14,15
02116900,UPPER VALLEY JVS                        ,OH,45356-0000,Public       ,14,73,87,29,143,172
02117300,GREAT OAKS INSTITUTE OF TECHNOLOGY      ,OH,45241-1581,Public       ,68,254,322,126,477,603
02128600,THE ART INSTITUTE OF CINCINNATI         ,OH,45246-0000,Proprietary  ,55,72,127,276,189,465
02140700,CANTON CITY SCHOOLS ADULT CAREER & TECH ,OH,44702-1710,Public       ,10,97,107,25,153,178
02158417,"HARRISON COLLEGE - COLUMBUS, OH         ",OH,43123-0000,Proprietary  ,44,169,213,73,394,467
02158500,OHIO BUSINESS COLLEGE                   ,OH,44035-0701,Proprietary  ,52,180,232,71,354,425
02158501,OHIO BUSINESS COLLEGE                   ,OH,44870-9953,Proprietary  ,19,133,152,36,213,249
02158503,OHIO BUSINESS COLLEGE - COLUMBUS        ,OH,43229-3523,Proprietary  ,41,153,194,95,327,422
02158504,OHIO BUSINESS COLLEGE - DAYTON          ,OH,45417-4094,Proprietary  ,8,34,42,20,82,102
02168100,TRI-COUNTY JOINT VOCATIONAL SCHOOL      ,OH,45764-0000,Public       ,14,41,55,24,78,102
02187900,ASHTABULA CO JOINT VOC SCH ADULT ED     ,OH,44047-0000,Public       ,7,64,71,11,95,106
02189000,MID-EAST CAREER & TECH CENTERS-ADULT ED ,OH,43701-4600,Public       ,51,113,164,101,202,303
02190700,FORTIS COLLEGE                          ,OH,45459-0000,Proprietary  ,86,716,802,143,1353,1496
02192100,BUTLER TECHNOLOGY AND CAREER DEVELOPMENT,OH,45011-0000,Public       ,40,145,185,114,303,417
02196300,COLLINS CAREER CENTER                   ,OH,45619-0000,Public       ,62,191,253,141,383,524
02210800,MEDINA COUNTY CAREER CENTER             ,OH,44256-0000,Public       ,14,41,55,21,66,87
02220500,GOD'S BIBLE SCHOOL & COLLEGE            ,OH,45210-0000,Private      ,84,39,123,134,67,201
02220800,CAREER & TECHNOLOGY EDUCATION CENTERS OF,OH,43055-0000,Public       ,37,76,113,91,194,285
02239800,PIONEER CAREER & TECHNOLOGY CENTER      ,OH,44875-9704,Public       ,0,10,10,5,22,27
02245600,WARREN COUNTY CAREER CENTER             ,OH,45036-0000,Public       ,25,62,87,44,120,164
02246300,INSTITUTE OF MEDICAL-DENTAL TECH        ,OH,45246-3317,Proprietary  ,70,239,309,112,424,536
02263700,MIAMI VALLEY CAREER TECHNOLOGY CTR      ,OH,45315-0000,Public       ,41,122,163,73,244,317
02269400,EASTERN HILLS ACAD OF HAIR DESIGN       ,OH,45255-0000,Proprietary  ,0,1,1,4,14,18
02269500,WESTERN HILLS SCHOOL OF BEAUTY & HAIR DE,OH,45211-0000,Proprietary  ,18,75,93,31,129,160
02272700,COLUMBIANA COUNTY CAREER CENTER         ,OH,44432-0000,Public       ,15,52,67,25,87,112
02287900,RAPHAEL'S SCHOOL OF BEAUTY CULTURE      ,OH,44446-0000,Proprietary  ,24,59,83,41,90,131
02301400,OHIO VALLEY COLLEGE OF TECHNOLOGY       ,OH,43920-9139,Proprietary  ,34,90,124,59,129,188
02304700,TRI-RIVERS CAREER CENTER                ,OH,43302-0000,Public       ,17,74,91,39,181,220
02311200,AMERICAN SCHOOL OF TECHNOLOGY           ,OH,43229-0000,Proprietary  ,25,164,189,55,293,348
02315500,TOLEDO ACADEMY OF BEAUTY CULTURE - EAST ,OH,43616-0000,Proprietary  ,11,43,54,16,70,86
02324400,ALLSTATE HAIRSTYLING & BARBER CLG       ,OH,44113-0000,Proprietary  ,17,84,101,44,187,231
02328500,MOLER-PICKENS BEAUTY COLLEGE            ,OH,45014-0000,Proprietary  ,1,8,9,4,19,23
02334300,EMPIRE BEAUTY SCHOOL                    ,OH,45239-3926,Proprietary  ,46,102,148,64,143,207
02336300,KNOX COUNTY CAREER CENTER               ,OH,43050-4298,Public       ,13,62,75,34,154,188
02336700,CUYAHOGA VALLEY CAREER CENTER           ,OH,44141-1296,Public       ,15,65,80,36,129,165
02337700,PROFESSIONAL SKILLS INSTITUTE           ,OH,43607-0000,Proprietary  ,30,168,198,64,348,412
02351500,WILLOUGHBY EASTLAKE SCH OF PRAC NSG     ,OH,44094-0000,Public       ,10,87,97,20,128,148
02352800,POLARIS CAREER CENTER-ADULT ED DEPT     ,OH,44130-0000,Public       ,27,87,114,49,183,232
02354200,SCIOTO COUNTY JOINT VOCATIONAL SCH      ,OH,45648-0000,Public       ,27,69,96,63,140,203
02454400,NORTHEAST OHIO MEDICAL UNIVERSITY       ,OH,44272-9621,Public       ,6,123,129,124,900,1024
02497800,GREENE COUNTY CAREER CENTER             ,OH,45385-0000,Public       ,5,12,17,15,28,43
02519300,OHIO STATE SCH COSMETOLOGY              ,OH,43110-2754,Proprietary  ,48,64,112,74,122,196
02522700,EASTLAND-FAIRFIELD CAREER AND TECHNICAL ,OH,43125-0000,Public       ,18,79,97,34,141,175
02528300,TDDS TECHNICAL INSTITUTE                ,OH,44429-0000,Proprietary  ,25,90,115,38,186,224
02529500,HAMRICK SCHOOL                          ,OH,44256-0000,Proprietary  ,8,73,81,11,110,121
02545800,INNER STATE BEAUTY SCHOOLS              ,OH,44124-0000,Proprietary  ,18,69,87,23,113,136
02553000,SCHOOL OF ADVERTISING ART               ,OH,45440-0000,Proprietary  ,95,16,111,280,35,315
02560000,CASAL AVEDA INSTITUTE                   ,OH,44515-0000,Proprietary  ,41,46,87,90,99,189
02560700,PICKAWAY ROSS CO JOINT VOC TECH SCH     ,OH,45601-0000,Public       ,15,106,121,45,216,261
02562300,APOLLO CAREER CENTER-ADULT EDUC         ,OH,45806-0000,Public       ,20,118,138,46,210,256
02563000,RAPHAELS SCHOOL OF BEAUTY CULTURE       ,OH,44601-2847,Proprietary  ,16,48,64,22,73,95
02568600,MAHONING COUNTY CAREER & TECH CENTR     ,OH,44406-0000,Public       ,16,34,50,31,61,92
02582900,KAPLAN CAREER INSTITUTE                 ,OH,44129-6810,Proprietary  ,0,7,7,6,61,67
02586400,TRUMBULL CAREER & TECH CENTER-ADULT     ,OH,44483-1997,Public       ,9,51,60,21,96,117
02588500,OHIO STATE SCHOOL OF COSMETOLOGY        ,OH,43081-0000,Proprietary  ,44,52,96,79,104,183
02599711,VATTEROTT COLLEGE - CLEVELAND           ,OH,44147-3502,Proprietary  ,28,137,165,35,180,215
02603800,LORAIN COUNTY JVS ADULT CAREER CTR      ,OH,44074-9799,Public       ,17,59,76,34,113,147
02611007,HERITAGE COLLEGE - COLUMBUS             ,OH,43213-4440,Proprietary  ,56,217,273,125,494,619
02620000,SANDUSKY CAREER CENTER                  ,OH,44870-4786,Public       ,4,30,34,12,57,69
03007900,GALLIPOLIS CAREER COLLEGE               ,OH,45631-2600,Proprietary  ,10,84,94,14,87,101
03015100,ALLIANCE HIGH SCH-CMTY SERVICES DIV     ,OH,44601-2899,Public       ,5,23,28,8,37,45
03015300,EHOVE CAREER CENTER                     ,OH,44846-9500,Public       ,27,114,141,54,215,269
03023700,MADISON ADULT CAREER CENTER             ,OH,44905-2718,Public       ,15,58,73,33,115,148
03024300,VALLEY BEAUTY SCHOOL                    ,OH,43725-2332,Proprietary  ,5,6,11,7,9,16
03026511,REMINGTON COLLEGE - CLEVELAND           ,OH,44125-1957,Private      ,37,161,198,89,352,441
03027100,FAIRVIEW ACADEMY                        ,OH,44126-2214,Proprietary  ,3,18,21,7,31,38
03034200,WASHINGTON COUNTY CAREER CENTER ADULT TE,OH,45750-9290,Public       ,32,138,170,70,227,297
03035801,HERITAGE INSTITUTE - HERITAGE COLLEGE/CL,OH,44130-3304,Proprietary  ,30,136,166,32,168,200
03051400,AUBURN CAREER CENTER                    ,OH,44077-9723,Public       ,8,41,49,22,112,134
03051500,US GRANT JOINT VOCATIONAL SCHOOL        ,OH,45106-9502,Public       ,0,6,6,3,11,14
03065900,BUCKEYE CAREER CENTER                   ,OH,44663-9437,Public       ,15,50,65,37,101,138
03067600,RAPHAEL'S SCHOOL OF BEAUTY CULTURE      ,OH,44512-2222,Proprietary  ,13,35,48,20,55,75
03068200,OHIO CENTER FOR BROADCASTING            ,OH,44125-6273,Proprietary  ,17,65,82,30,90,120
03068202,OHIO CENTER FOR BROADCASTING - COLUMBUS ,OH,43213-2571,Proprietary  ,15,74,89,44,129,173
03071900,MOUNT CARMEL COLLEGE OF NURSING         ,OH,43222-1598,Private      ,208,314,522,697,708,1405
03078000,OHIO CENTER FOR BROADCASTING            ,OH,45227-1509,Proprietary  ,8,34,42,23,80,103
03079000,ETI TECHNICAL COLLEGE                   ,OH,44446-4398,Proprietary  ,20,104,124,34,161,195
03084800,DELAWARE AREA CAREER CENTER             ,OH,43015-8969,Public       ,4,10,14,11,25,36
03084801,DELAWARE AREA CAREER CENTER -           ,OH,43015-9001,Public       ,2,8,10,4,15,19
03095600,VANTAGE CAREER CENTER                   ,OH,45891-1378,Public       ,5,25,30,9,51,60
03097000,MERCY COLLEGE OF OHIO                   ,OH,43604-1132,Private      ,168,453,621,498,1047,1545
03100100,PARAMOUNT BEAUTY ACADEMY                ,OH,45662-4136,Proprietary  ,5,25,30,15,56,71
03116200,DAYTON BARBER COLLEGE                   ,OH,45342-4196,Proprietary  ,4,31,35,6,50,56
03116300,OHIO COLLEGE OF MASSOTHERAPY            ,OH,44321-1363,Private      ,3,18,21,16,57,73
03116400,VANGUARD-SENTINELL VOC SCH DISTRICT     ,OH,43420-1197,Public       ,4,18,22,7,35,42
03117000,ASHLAND COUNTY-W HOLMES CAREER CTR      ,OH,44805-0000,Public       ,9,42,51,12,63,75
03319300,CREATIVE IMAGES-A CERTIFIED MATRIX      ,OH,45414-2557,Proprietary  ,55,112,167,83,169,252
03319301,CREATIVE IMAGES-A CERTIFIED MATRIX      ,OH,45459-0000,Proprietary  ,31,74,105,53,119,172
03425300,ROSEDALE BIBLE COLLEGE                  ,OH,43029-9517,Private      ,16,2,18,39,4,43
03457300,ALLEGHENY WESLEYAN COLLEGE              ,OH,44460-9598,Private      ,10,7,17,27,14,41
03468400,NATIONAL INSTITUTE OF MASSOTHERAPY      ,OH,44319-2100,Proprietary  ,2,19,21,7,49,56
03468500,ATS INSTITUTE OF TECHNOLOGY             ,OH,44143-2216,Proprietary  ,15,242,257,31,384,415
03475400,TRI-STATE BIBLE COLLEGE                 ,OH,45680-8402,Private      ,1,8,9,4,18,22
03534400,AMERICAN INST OF ALTERNATIVE MEDICI     ,OH,43229-1113,Proprietary  ,20,232,252,52,508,560
03583300,OHIO INSTITUTE OF ALLIED HEALTH         ,OH,45424-3646,Private      ,4,42,46,4,86,90
03626300,BROWN AVEDA INSTITUTE                   ,OH,44060-6212,Proprietary  ,60,103,163,117,214,331
03700300,REGENCY BEAUTY INSTITUTE - CLEVELAND    ,OH,44094-0000,Proprietary  ,55,156,211,96,259,355
03726300,TEMPLE BAPTIST COLLEGE                  ,OH,45240-0000,Private      ,0,0,0,1,8,9
03747300,BEXLEY HALL SEMINARY                    ,OH,43209-2325,Private      ,0,16,16,1,33,34
03776400,HEALING ARTS INSTITUTE                  ,OH,43551-3138,Proprietary  ,4,28,32,11,42,53
03837300,AVEDA FREDRIC'S INSTITUTE               ,OH,45208-1304,Proprietary  ,40,53,93,85,127,212
04051307,ART INSTITUTE OF PHOENIX (THE) - BROWN M,OH,45215-1107,Proprietary  ,46,305,351,94,513,607
04051308,ART INSTITUTE OF PHOENIX (THE) - BROWN M,OH,44320-4420,Proprietary  ,45,136,181,88,292,380
04051317,ART INSTITUTE OF PHOENIX (THE) - BROWN M,OH,45840-6848,Proprietary  ,75,349,424,194,1007,1201
04051326,ART INSTITUTE OF PHOENIX (THE) - BROWN M,OH,44718-3674,Proprietary  ,37,228,265,57,333,390
04068300,FOUR COUNTY CAREER CENTER               ,OH,43512-9541,Public       ,0,10,10,2,26,28
04074300,HONDROS COLLEGE                         ,OH,43081-3855,Proprietary  ,186,1598,1784,337,2749,3086
04117300,DAYTON SCHOOL OF MEDICAL MASSAGE        ,OH,45429-1111,Proprietary  ,28,144,172,67,246,313
04118300,NORTHCOAST MEDICAL TRAINING ACADEMY     ,OH,44240-4174,Proprietary  ,22,68,90,42,106,148
04124500,TECHSKILLS                              ,OH,43231-0000,Proprietary  ,19,159,178,36,251,287
04126000,OHIO ACADEMY PAUL MITCHELL PARTNER SCHOO,OH,44087-3107,Proprietary  ,40,87,127,72,141,213
04137800,AVEDA INSTITUTE COLUMBUS                ,OH,43201-2333,Proprietary  ,109,169,278,213,289,502
04138000,INSTITUTE OF THERAPEUTIC MASSAGE        ,OH,45875-0350,Proprietary  ,0,0,0,5,7,12
04149100,PAUL MITCHELL THE SCHOOL CINCINNATI     ,OH,45241-1702,Proprietary  ,49,75,124,94,145,239
04149101,PAUL MITCHELL THE SCHOOL CINCINNATI - TO,OH,43560-2539,Proprietary  ,23,39,62,42,74,116
04151400,VANITY SCHOOL OF COSMETOLOGY            ,OH,44035-0000,Proprietary  ,8,30,38,16,49,65
04152100,TOLEDO RESTAURANT TRAINING CENTER       ,OH,43604-6508,Private      ,4,33,37,7,58,65
04152600,PIKE COUNTY CAREER TECHNOLOGY CENTER    ,OH,45661-9114,Public       ,0,7,7,2,16,18
04153300,OHIO ACADEMY COLUMBUS (THE)             ,OH,43231-6038,Proprietary  ,42,69,111,93,132,225
04166800,SALON PROFESSIONAL ACADEMY (THE)        ,OH,45551-0000,Proprietary  ,23,7,30,37,23,60
04167700,ARTISAN COLLEGE OF COSMETOLOGY (THE)    ,OH,45840-6848,Proprietary  ,7,7,14,14,20,34
04177300,OHIO MEDICAL CAREER COLLEGE             ,OH,45417-4094,Proprietary  ,33,177,210,73,356,429
04185900,ELITE SCHOOL OF COSMETOLOGY             ,OH,44857-2714,Proprietary  ,8,30,38,10,48,58
04189100,SALON INSTITUTE - TOLEDO CAMPUS         ,OH,43615-1731,Proprietary  ,28,37,65,41,62,103
04192200,ATHENA CAREER ACADEMY                   ,OH,43560-2796,Proprietary  ,12,138,150,26,262,288
04206700,ELITE WELDING ACADEMY                   ,OH,45246-1013,Proprietary  ,22,36,58,48,64,112
04220900,NATIONAL PERSONAL TRAINING INSTITUTE OF ,OH,43235-5739,Proprietary  ,6,29,35,15,66,81
04224300,VALOR CHRISTIAN COLLEGE                 ,OH,43216-0800,Private      ,28,89,117,77,215,292
04225700,LABARBERIA INSTITUTE OF HAIR            ,OH,44106-1923,Proprietary  ,13,60,73,22,98,120
04244300,ANTIOCH COLLEGE                         ,OH,45387-1683,Private      ,8,5,13,8,5,13
        ,INVALID SCHOOL CODE                     ,  ,00000-0000,,255,1261,1516,452,1946,2398
00134500,ADAMS STATE COLLEGE                     ,CO,81102-2373,Public       ,495,640,1135,2168,1373,3541
00134600,ARAPAHOE COMMUNITY COLLEGE              ,CO,80160-9002,Public       ,910,1856,2766,2114,3593,5707
00134700,COLORADO COLLEGE                        ,CO,80903-3294,Private      ,413,282,695,3232,675,3907
00134800,COLORADO SCHOOL OF MINES                ,CO,80401-1887,Public       ,479,271,750,6394,1040,7434
00134900,UNIVERSITY OF NORTHERN COLORADO         ,CO,80639-0001,Public       ,1326,1323,2649,9687,3784,13471
00135000,COLORADO STATE UNIVERSITY               ,CO,80523-0100,Public       ,3169,2723,5892,23182,8274,31456
00135200,DENVER  SEMINARY                        ,CO,80120-2192,Private      ,3,220,223,8,474,482
00135300,FORT LEWIS COLLEGE                      ,CO,81301-3999,Public       ,976,440,1416,4098,1190,5288
00135400,ILIFF SCHOOL OF THEOLOGY                ,CO,80210-0000,Private      ,0,95,95,7,268,275
00135500,LAMAR COMMUNITY COLLEGE                 ,CO,81052-3999,Public       ,125,64,189,317,135,452
00135800,COLORADO MESA UNIVERSITY                ,CO,81501-3122,Public       ,1661,1179,2840,6638,2475,9113
00135900,COLORADO NORTHWESTERN COMMUNITY COLLEGE ,CO,81648-3598,Public       ,147,159,306,392,273,665
00136000,METROPOLITAN STATE UNIVERSITY OF DENVER ,CO,80204-3362,Public       ,2993,4582,7575,9449,10388,19837
00136100,NORTHEASTERN JUNIOR COLLEGE             ,CO,80751-2399,Public       ,272,129,401,848,275,1123
00136200,OTERO JUNIOR COLLEGE                    ,CO,81050-3346,Public       ,151,177,328,433,333,766
00136300,REGIS UNIVERSITY                        ,CO,80221-1099,Private      ,589,2519,3108,3656,5697,9353
00136500,COLORADO STATE UNIVERSITY-PUEBLO        ,CO,81001-4901,Public       ,679,662,1341,5474,2076,7550
00136800,TRINIDAD STATE JR COLLEGE               ,CO,81082-2396,Public       ,183,291,474,522,533,1055
00137000,UNIVERSITY OF COLORADO-BOULDER          ,CO,80309-0077,Public       ,2815,2004,4819,26435,7521,33956
00137100,UNIVERSITY OF DENVER                    ,CO,80208-2000,Private      ,649,1633,2282,9902,7854,17756
00137200,WESTERN STATE COLORADO UNIVERSITY       ,CO,81231-0000,Public       ,435,213,648,2208,497,2705
00405702,NATIONAL AMERICAN UNIVERSITY - COLORADO ,CO,80920-4001,Proprietary  ,14,121,135,28,242,270
00405703,NATIONAL AMERICAN UNIVERSITY            ,CO,80222-0000,Proprietary  ,6,79,85,14,157,171
00450300,EVEREST COLLEGE                         ,CO,80916-3548,Proprietary  ,32,225,257,67,474,541
00450600,COLORADO MOUNTAIN COLLEGE               ,CO,81602-0000,Public       ,412,562,974,1477,1275,2752
00450700,EVEREST COLLEGE                         ,CO,80229-4339,Proprietary  ,38,131,169,65,232,297
00450701,"EVEREST COLLEGE- EVEREST COLLEGE, AURORA",CO,80012-5692,Proprietary  ,41,165,206,65,271,336
00450800,UNIVERSITY OF COLORADO DENVER           ,CO,80204-2029,Public       ,1980,4471,6451,9537,11865,21402
00450900,UNIV OF COLORADO AT COLO SPRINGS        ,CO,80918-3735,Public       ,1322,1857,3179,8979,5255,14234
00559600,EMILY GRIFFITH OPPORTUNITY SCH          ,CO,80204-2197,Public       ,182,521,703,488,1043,1531
00729700,REDSTONE COLLEGE                        ,CO,80020-9988,Proprietary  ,65,191,256,116,386,502
00732912,ITT TECHNICAL INSTITUTE                 ,CO,80229-5338,Proprietary  ,57,324,381,98,509,607
00754800,WESTWOOD COLLEGE - DENVER NORTH         ,CO,80221-3653,Proprietary  ,64,280,344,111,558,669
00754801,WESTWOOD COLLEGE - DENVER SOUTH         ,CO,80227-3653,Proprietary  ,38,145,183,71,365,436
00758200,AIMS COMMUNITY COLLEGE                  ,CO,80632-0000,Public       ,589,1023,1612,1566,2162,3728
00764900,ROCKY MOUNTAIN COLG OF ART & DESIGN     ,CO,80214-0000,Proprietary  ,244,391,635,646,838,1484
00793300,FRONT RANGE COMMUNITY COLLEGE           ,CO,80031-2199,Public       ,2076,3660,5736,5024,7454,12478
00793806,LINCOLN COLLEGE OF TECHNOLOGY - DENVER  ,CO,80239-3006,Proprietary  ,357,343,700,705,628,1333
00863500,INTELLITEC MEDICAL INSTITUTE            ,CO,80909-0000,Proprietary  ,38,202,240,59,328,387
00887100,CONCORDE CAREER INSTITUTE               ,CO,80203-0000,Proprietary  ,153,455,608,240,847,1087
00889600,PIKES PEAK COMMUNITY COLLEGE            ,CO,80906-5498,Public       ,1231,3334,4565,3130,6863,9993
00940100,COLORADO CHRISTIAN UNIVERSITY           ,CO,80226-7449,Private      ,474,1535,2009,1841,3249,5090
00954200,COMMUNITY COLLEGE OF DENVER             ,CO,80217-2026,Public       ,1717,2906,4623,4420,6089,10509
00954300,RED ROCKS COMMUNITY COLLEGE             ,CO,80228-1255,Public       ,874,1702,2576,2172,3358,5530
00998100,MORGAN COMMUNITY COLLEGE                ,CO,80701-4399,Public       ,78,218,296,254,421,675
01014800,COLORADO TECHNICAL UNIVERSITY           ,CO,80907-3896,Proprietary  ,131,1439,1570,312,2926,3238
01014802,COLORADO TECHNICAL UNIV - DENVER        ,CO,80111-3201,Proprietary  ,31,328,359,84,638,722
01014805,COLORADO TECH UNIV - ON LINE            ,CO,80907-0000,Proprietary  ,555,12355,12910,1027,24511,25538
01014812,COLORADO TECHNICAL UNIVERSITY - WESTMINS,CO,80021-3498,Proprietary  ,13,130,143,38,266,304
01157200,COLORADO SCHOOL OF TRADES               ,CO,80215-2996,Proprietary  ,19,115,134,54,201,255
01267000,BEL-REA INST OF ANIMAL TECH             ,CO,80247-3048,Proprietary  ,121,192,313,259,371,630
01285000,INTERNATIONAL SALON AND SPA ACADEMY     ,CO,80918-3684,Proprietary  ,32,102,134,43,165,208
01287500,PICKENS TECHNICAL COLLEGE               ,CO,80011-9307,Public       ,158,305,463,324,514,838
01300700,NAZARENE BIBLE COLLEGE                  ,CO,80910-3704,Private      ,15,175,190,38,358,396
02078900,ART INSTITUTE OF COLORADO (THE)         ,CO,80203-2983,Proprietary  ,360,486,846,976,967,1943
02116300,PUEBLO COMMUNITY COLLEGE                ,CO,81004-0000,Public       ,558,1564,2122,1333,3031,4364
02117500,NAROPA UNIVERSITY                       ,CO,80302-0000,Private      ,72,239,311,349,960,1309
02156200,DELTA - MONTROSE TECHNICAL COLLEGE      ,CO,81416-0000,Public       ,25,59,84,49,105,154
02165200,SALON PROFESSIONAL ACADEMY (THE)        ,CO,81504-5309,Proprietary  ,16,38,54,41,61,102
02211901,CHEEKS INTERNATIONAL ACADEMY OF BEAUTY C,CO,80525-3053,Proprietary  ,6,12,18,17,23,40
02211902,CHEEKS INTERNATIONAL ACDMY BTY CULT     ,CO,80631-0000,Proprietary  ,3,7,10,13,17,30
02253700,INTELLITEC COLLEGE                      ,CO,80909-0000,Proprietary  ,57,399,456,98,541,639
02267500,GLENWOOD BEAUTY ACADEMY                 ,CO,81601-0000,Proprietary  ,3,9,12,8,20,28
02276900,COMMUNITY COLLEGE OF AURORA             ,CO,80011-9036,Public       ,865,1939,2804,2087,3723,5810
02296004,PRINCE INSTITUTE - SOUTHEAST - PRINCE IN,CO,80031-2943,Proprietary  ,0,6,6,0,13,13
02518500,HAIR DYNAMICS EDUCATION CENTER          ,CO,80525-0000,Proprietary  ,18,50,68,45,80,125
02594300,COLLEGE AMERICA - DENVER                ,CO,80222-3380,Proprietary  ,103,649,752,163,1002,1165
02611000,HERITAGE COLLEGE                        ,CO,80212-7413,Proprietary  ,41,151,192,78,258,336
03006300,INST OF BUSINESS & MEDICAL CAREERS      ,CO,80525-3044,Proprietary  ,154,501,655,232,912,1144
03010622,VIRGINIA COLLEGE - ECOTECH INSTITUTE - A,CO,80012-4627,Proprietary  ,18,85,103,41,172,213
03014900,PLATT COLLEGE                           ,CO,80014-3141,Proprietary  ,17,92,109,38,191,229
03027400,XENON INTERNATIONAL ACADEMY III         ,CO,80014-1193,Proprietary  ,8,26,34,20,49,69
03030606,UTAH COLLEGE OF MASSAGE THERAPY - DENVER,CO,80031-2921,Proprietary  ,21,33,54,31,62,93
03030607,UTAH COLLEGE OF MASSAGE THERAPY - DENVER,CO,80012-2523,Proprietary  ,33,48,81,46,93,139
03066900,INTELLITEC COLLEGE                      ,CO,81506-3994,Proprietary  ,70,247,317,105,366,471
03068201,OHIO CENTER FOR BROADCASTING - COLORADO ,CO,80214-4129,Proprietary  ,17,31,48,28,58,86
03289300,COLORADO HEIGHTS UNIVERSITY             ,CO,80236-2711,Private      ,42,75,117,102,157,259
03306300,MONTESSORI EDUC CRT OF THE ROCKIES      ,CO,80301-2587,Private      ,0,23,23,6,43,49
03534300,JONES INTERNATIONAL UNIVERSITY          ,CO,80112-3446,Proprietary  ,0,90,90,16,522,538
03545300,UNIVERSITY OF THE ROCKIES               ,CO,80903-3612,Proprietary  ,21,533,554,66,1351,1417
03584400,COLORADO SCHOOL OF HEALING ARTS         ,CO,80226-4332,Proprietary  ,27,102,129,42,160,202
03670300,TONI & GUY HAIRDRESSING ACADEMY         ,CO,80911-0000,Proprietary  ,23,74,97,47,108,155
03686300,COLORADO SCHOOL OF TRADITIONAL CHINESE M,CO,80206-2127,Proprietary  ,2,46,48,14,95,109
03776300,AUGUSTE ESCOFFIER SCHOOL OF CULINARY ART,CO,80305-5961,Proprietary  ,74,115,189,182,228,410
03976300,MASSAGE THERAPY INSTITUTE OF COLORADO   ,CO,80206-2127,Proprietary  ,12,54,66,36,117,153
04080300,ASPEN UNIVERSITY                        ,CO,80246-1930,Proprietary  ,37,297,334,103,706,809
04093300,ACADEMY OF NATURAL THERAPY              ,CO,80631-3425,Proprietary  ,12,31,43,30,75,105
04121200,INSTITUTE OF TAOIST EDUCATION AND ACUPUN,CO,80027-1028,Private      ,1,15,16,4,22,26
04125100,MONTESSORI CASA INTERNATIONAL           ,CO,80111-5263,Private      ,0,0,0,0,3,3
04127700,AMERICAN SENTINEL UNIVERSITY            ,CO,80014-6510,Proprietary  ,11,408,419,18,803,821
04139300,NATIONAL BEAUTY COLLEGE                 ,CO,80221-0000,Proprietary  ,11,46,57,19,72,91
04148300,DENVER SCHOOL OF NURSING                ,CO,80202-1213,Proprietary  ,96,425,521,287,875,1162
04167100,AVEDA INSTITUTE DENVER                  ,CO,80202-0000,Proprietary  ,84,135,219,169,262,431
04170200,PAUL MITCHELL THE SCHOOL COLORADO SPRING,CO,80903-0000,Proprietary  ,37,130,167,80,224,304
04172500,ROLF INSTITUTE OF STRUCTURAL INTEGRATION,CO,80301-0000,Private      ,2,33,35,3,71,74
04173800,SALON PROFESSIONAL ACADEMY (THE)        ,CO,80918-2932,Proprietary  ,21,51,72,31,87,118
04177100,PIMA MEDICAL INSTITUTE-SOUTH DENVER     ,CO,80231-0000,Proprietary  ,103,268,371,212,503,715
04179700,UNITED BEAUTY COLLEGE                   ,CO,80223-2936,Proprietary  ,10,36,46,23,74,97
04183700,HEALING ARTS INSTITUTE                  ,CO,80525-3479,Proprietary  ,12,46,58,29,80,109
04184900,COLLEGE OF INTERNATIONAL ESTHETICS      ,CO,80002-3754,Proprietary  ,10,41,51,26,84,110
04185000,COLORADO ACADEMY OF VETERINARY TECHNOLOG,CO,80906-4944,Proprietary  ,30,91,121,68,166,234
04185400,NATIONAL PERSONAL TRAINING INSTITUTE OF ,CO,80401-3304,Proprietary  ,6,26,32,17,57,74
04195300,LONGS PEAK ACADEMY                      ,CO,80501-6458,Proprietary  ,13,35,48,24,66,90
04202600,NEW DIMENSIONS BEAUTY ACADEMY           ,CO,80138-9801,Proprietary  ,10,30,40,17,49,66
04208700,COLORADO STATE UNIVERSITY - GLOBAL CAMPU,CO,80111-0000,Public       ,154,3416,3570,406,6441,6847
04218900,ROCKY VISTA UNIVERSITY COLLEGE OF OSTEOP,CO,80134-9498,Proprietary  ,0,296,296,1,583,584
04221400,PAUL MITCHELL THE SCHOOL DENVER         ,CO,80226-7395,Proprietary  ,32,49,81,80,101,181
00267811,BRYANT & STRATTON COLLEGE - VIRGINIA BEA,VA,23462-4417,Proprietary  ,50,280,330,167,762,929
00370200,AVERETT UNIVERSITY                      ,VA,24541-3692,Private      ,383,421,804,1525,871,2396
00370300,BLUEFIELD COLLEGE                       ,VA,24605-1799,Private      ,210,245,455,867,552,1419
00370400,BRIDGEWATER COLLEGE                     ,VA,22812-1599,Private      ,244,35,279,3526,178,3704
00370500,COLLEGE OF WILLIAM & MARY               ,VA,23187-8795,Public       ,649,593,1242,10825,3480,14305
00370600,CHRISTOPHER NEWPORT UNIVERSITY          ,VA,23606-3072,Public       ,594,290,884,7636,901,8537
00370700,RICHARD BLAND COLLEGE                   ,VA,23805-7100,Public       ,384,203,587,1310,494,1804
00370800,EASTERN MENNONITE UNIVERSITY            ,VA,22802-2462,Private      ,262,183,445,1244,477,1721
00370900,EMORY & HENRY COLLEGE                   ,VA,24327-0010,Private      ,271,59,330,1507,180,1687
00371100,FERRUM COLLEGE                          ,VA,24088-2612,Private      ,480,82,562,2456,236,2692
00371200,TIDEWATER COMMUNITY COLLEGE             ,VA,23510-1910,Public       ,2579,6397,8976,7498,14447,21945
00371300,HAMPDEN-SYDNEY COLLEGE                  ,VA,23943-0128,Private      ,371,20,391,1746,61,1807
00371400,HAMPTON UNIVERSITY                      ,VA,23668-0099,Private      ,1025,789,1814,8241,2400,10641
00371500,HOLLINS UNIVERSITY                      ,VA,24020-0000,Private      ,136,143,279,1258,466,1724
00371900,LONGWOOD UNIVERSITY                     ,VA,23909-1899,Public       ,518,178,696,5691,816,6507
00372000,LYNCHBURG COLLEGE                       ,VA,24501-3199,Private      ,563,354,917,3223,936,4159
00372100,JAMES MADISON UNIVERSITY                ,VA,22807-3780,Public       ,2179,636,2815,23253,2705,25958
00372300,MARY BALDWIN COLLEGE                    ,VA,24401-3610,Private      ,281,325,606,1455,918,2373
00372400,MARYMOUNT UNIVERSITY                    ,VA,22207-4224,Private      ,404,567,971,2441,1722,4163
00372600,AMERICAN NATIONAL UNIVERSITY            ,VA,24153-4524,Proprietary  ,109,929,1038,260,2305,2565
00372700,NORTHERN VA CMTY CLG                    ,VA,22003-3743,Public       ,6195,7501,13696,13677,14148,27825
00372800,OLD DOMINION UNIVERSITY                 ,VA,23529-0052,Public       ,3138,4392,7530,17647,11914,29561
00373200,RADFORD UNIVERSITY                      ,VA,24142-6905,Public       ,1515,680,2195,10508,2289,12797
00373300,RANDOLPH-MACON COLLEGE                  ,VA,23005-5505,Private      ,442,27,469,2524,127,2651
00373400,RANDOLPH COLLEGE                        ,VA,24503-1526,Private      ,195,64,259,1038,167,1205
00373500,VIRGINIA COMMONWEALTH UNIVERSITY        ,VA,23284-9004,Public       ,3428,3805,7233,23820,11564,35384
00373600,ROANOKE COLLEGE                         ,VA,24153-3794,Private      ,303,61,364,3252,217,3469
00373700,SHENANDOAH UNIVERSITY                   ,VA,22601-5195,Private      ,507,745,1252,2973,1947,4920
00373800,SOUTHERN VIRGINIA UNIVERSITY            ,VA,24416-3038,Private      ,295,149,444,992,258,1250
00374200,SWEET BRIAR COLLEGE                     ,VA,24595-9998,Private      ,25,7,32,675,47,722
00374300,UNION PRESBYTERIAN SEMINARY             ,VA,23227-0000,Private      ,0,26,26,0,57,57
00374400,UNIVERSITY OF RICHMOND                  ,VA,23173-0001,Private      ,676,677,1353,6587,2091,8678
00374500,UNIVERSITY OF VIRGINIA - SFS            ,VA,22903-0000,Public       ,671,1591,2262,21151,7111,28262
00374600,UNIVERSITY OF MARY WASHINGTON           ,VA,22401-5358,Public       ,549,340,889,5546,1104,6650
00374700,UNIV OF VIRGINIA'S COLLEGE AT WISE      ,VA,24293-4412,Public       ,335,181,516,1631,435,2066
00374800,EASTERN SHORE COMMUNITY COLLEGE         ,VA,23410-3001,Public       ,105,166,271,229,301,530
00374900,GEORGE MASON UNIVERSITY                 ,VA,22030-4444,Public       ,2027,2955,4982,23856,12478,36334
00375100,PATRICK HENRY COMMUNITY COLLEGE         ,VA,24112-5311,Public       ,400,592,992,864,1053,1917
00375300,VIRGINIA MILITARY INSTITUTE             ,VA,24450-2138,Public       ,276,22,298,1978,79,2057
00375400,VIRGINIA POLYTECH INST & STATE UNIV     ,VA,24061-2000,Public       ,1988,863,2851,26734,4010,30744
00375800,DANVILLE COMMUNITY COLLEGE              ,VA,24541-4004,Public       ,444,750,1194,964,1265,2229
00375900,J. SARGEANT REYNOLDS COMMUNITY CLG      ,VA,23285-0000,Public       ,1410,3295,4705,3646,7200,10846
00376000,VIRGINIA WESTERN CMTY COLLEGE           ,VA,24038-0000,Public       ,802,1303,2105,2524,2595,5119
00376100,WYTHEVILLE COMMUNITY COLLEGE            ,VA,24382-3308,Public       ,428,492,920,943,959,1902
00376200,VIRGINIA UNIVERSITY OF LYNCHBURG        ,VA,24501-6400,Private      ,167,181,348,380,338,718
00376400,VIRGINIA STATE UNIVERSITY               ,VA,23806-0001,Public       ,1398,845,2243,7950,2472,10422
00376500,NORFOLK STATE UNIVERSITY                ,VA,23504-8000,Public       ,1200,1611,2811,5332,4350,9682
00376600,VIRGINIA UNION UNIVERSITY               ,VA,23220-1711,Private      ,736,488,1224,3387,1222,4609
00376700,VIRGINIA WESLEYAN COLLEGE               ,VA,23502-5599,Private      ,414,218,632,2031,552,2583
00376800,WASHINGTON & LEE UNIVERSITY             ,VA,24450-0303,Private      ,456,139,595,2842,840,3682
00400400,JOHN TYLER COMMUNITY COLLEGE            ,VA,23831-5316,Public       ,1162,1785,2947,2966,3794,6760
00450301,EVEREST COLLEGE -  MCLEAN               ,VA,22182-2214,Proprietary  ,5,22,27,10,54,64
00498800,CENTRAL VIRGINIA COMMUNITY COLLEGE      ,VA,24502-2498,Public       ,593,740,1333,1287,1475,2762
00499200,MILLER-MOTTE TECHNICAL COLLEGE          ,VA,24505-0000,Proprietary  ,64,271,335,115,415,530
00499600,DABNEY S LANCASTER COMMUNITY CLG        ,VA,24422-1000,Public       ,89,109,198,414,331,745
00522300,NEW RIVER COMMUNITY COLLEGE             ,VA,24084-1127,Public       ,496,644,1140,1207,1366,2573
00662200,COLLEGE OF HEALTH SCIENCES - CHRV       ,VA,24031-0000,Private      ,193,402,595,587,898,1485
00681900,BLUE RIDGE COMMUNITY COLLEGE            ,VA,24486-0080,Public       ,490,662,1152,1671,1590,3261
00687100,THOMAS NELSON COMMUNITY COLLEGE         ,VA,23670-0000,Public       ,1168,2735,3903,2806,5762,8568
00709900,VIRGINIA HIGHLANDS COMMUNITY CLG        ,VA,24210-4210,Public       ,376,497,873,790,943,1733
00726000,SOUTHWEST VIRGINIA COMMUNITY CLG        ,VA,24641-0000,Public       ,380,548,928,852,989,1841
00865900,LORD FAIRFAX COMMUNITY COLLEGE          ,VA,22645-0047,Public       ,625,829,1454,1553,1735,3288
00866000,GERMANNA COMMUNITY COLLEGE              ,VA,22508-0339,Public       ,968,1274,2242,2246,2586,4832
00866100,SOUTHSIDE VIRGINIA CMTY CLG             ,VA,23821-2930,Public       ,469,878,1347,875,1435,2310
00915900,PAUL D CAMP COMMUNITY COLLEGE           ,VA,23851-0737,Public       ,120,355,475,315,688,1003
00916000,RAPPAHANNOCK COMMUNITY COLLEGE          ,VA,23149-2616,Public       ,200,393,593,590,803,1393
00926700,EVEREST COLLEGE                         ,VA,23606-4203,Proprietary  ,17,158,175,49,343,392
00926701,EVEREST COLLEGE - CHESAPEAKE            ,VA,23320-2637,Proprietary  ,42,234,276,70,383,453
00942000,SANFORD-BROWN COLLEGE                   ,VA,22102-4301,Proprietary  ,0,11,11,4,26,30
00953500,STAUNTON SCHOOL OF COSMETOLOGY          ,VA,24401-4323,Proprietary  ,6,21,27,20,34,54
00953700,VIRGINIA SCH OF HAIR DESIGN             ,VA,23669-0000,Proprietary  ,12,56,68,24,100,124
00962900,MOUNTAIN EMPIRE COMMUNITY COLLEGE       ,VA,24219-0700,Public       ,368,587,955,732,937,1669
00992800,PIEDMONT VIRGINIA COMMUNITY COLLEGE     ,VA,22902-7589,Public       ,570,887,1457,1349,1766,3115
01004300,BON SECOURS MEMORIAL COLLEGE OF NURSING ,VA,23227-4612,Private      ,100,300,400,244,638,882
01019800,ECPI UNIVERSITY                         ,VA,23462-6542,Proprietary  ,302,2015,2317,578,3678,4256
01019802,ECPI UNIVERSITY - NEWPORT NEWS          ,VA,23606-4298,Proprietary  ,124,622,746,273,1202,1475
01019807,ECPI UNIVERSITY - MANASSAS              ,VA,20109-2665,Proprietary  ,92,272,364,142,487,629
01019813,ECPI UNIVERSITY - CULINARY INSTITUTE OF ,VA,23513-2448,Proprietary  ,55,108,163,154,256,410
01019814,ECPI UNIVERSITY - VIRGINIA BEACH HEALTH ,VA,23462-6540,Proprietary  ,20,193,213,60,500,560
01019815,ECPI UNIVERSITY - RICHMOND SOUTH        ,VA,23236-3659,Proprietary  ,98,278,376,195,584,779
01019816,ECPI UNIVERSITY - INNSBROOK             ,VA,23060-3359,Proprietary  ,54,164,218,110,290,400
01019817,ECPI UNIVERSITY - RICHMOND WEST         ,VA,23294-3730,Proprietary  ,65,211,276,151,447,598
01033800,EASTERN VIRGINIA MEDICAL SCHOOL         ,VA,23501-1980,Public       ,14,394,408,58,1669,1727
01159600,SYLVAIN MELLOUL INTERNATIONAL HAIR ACADE,VA,24502-2652,Proprietary  ,31,58,89,50,92,142
01162601,WESTWOOD COLLEGE - SOUTH BAY - ARLINGTON,VA,22203-4167,Proprietary  ,59,186,245,94,341,435
01162602,WESTWOOD COLLEGE - SOUTH BAY - ANNANDALE,VA,22003-2602,Proprietary  ,37,182,219,57,288,345
01274400,SOUTHSIDE REGIONAL MED CTR PROF SCHOOLS ,VA,23803-5133,Proprietary  ,32,108,140,92,209,301
02053000,LIBERTY UNIVERSITY                      ,VA,24502-0000,Private      ,5653,27173,32826,20511,53199,73710
02108800,WARDS CORNER BEAUTY ACADEMY             ,VA,23505-0000,Proprietary  ,6,59,65,19,117,136
02111600,DANVILLE REGIONAL MEDICAL CENTER SCHOOL ,VA,24541-0000,Proprietary  ,12,26,38,29,52,81
02128700,CENTRAL SCHOOL OF PRACTICAL NURSING     ,VA,23502-2230,Public       ,20,73,93,50,181,231
02140000,RIVERSIDE SCHOOL OF HEALTH CAREERS      ,VA,23608-3802,Private      ,43,240,283,123,494,617
02149901,PAUL MITCHELL THE SCHOOL-JACKSONVILLE - ,VA,22102-0000,Proprietary  ,20,53,73,38,92,130
02149902,PAUL MITCHELL THE SCHOOL-JACKSONVILLE - ,VA,22192-0000,Proprietary  ,31,51,82,62,94,156
02175800,LYNCHBURG GENERAL HOSP SCH OF NURSG     ,VA,24501-0000,Private      ,25,102,127,82,188,270
02197600,WOODROW WILSON REHABILITATION CTR       ,VA,22939-0000,Public       ,16,12,28,26,21,47
02242400,HENRICO CTY ST MARYS HOSP PRAC NRSG     ,VA,23075-0000,Public       ,3,25,28,7,54,61
02320900,TIDEWATER TECH                          ,VA,23502-1747,Proprietary  ,58,290,348,141,527,668
02334400,CENTURA COLLEGE                         ,VA,23452-0000,Proprietary  ,94,442,536,164,873,1037
02342700,FORTIS COLLEGE                          ,VA,23502-4101,Proprietary  ,63,263,326,118,504,622
02342701,FORTIS COLLEGE - RICHMOND CAMPUS        ,VA,23230-0000,Proprietary  ,69,326,395,126,563,689
02358500,BON SECOURS SAINT MARY'S HOSPITAL SCHOOL,VA,23227-4612,Private      ,31,88,119,81,204,285
02538800,SUFFOLK BEAUTY ACADEMY                  ,VA,23434-0000,Proprietary  ,5,37,42,19,69,88
02541200,STRATFORD UNIVERSITY                    ,VA,22043-0000,Proprietary  ,201,1334,1535,431,2324,2755
02541201,STRATFORD UNIVERSITY-WOODBRIDGE         ,VA,22192-0000,Proprietary  ,0,0,0,54,246,300
02588900,MEDTECH INSTITUTE                       ,VA,22042-3013,Proprietary  ,112,408,520,171,637,808
02610100,WASHINGTON COUNTY ADULT SKILL CTR       ,VA,24210-2346,Public       ,9,31,40,21,67,88
02617508,EVEREST COLLEGE - WOODBRIDGE            ,VA,22192-6808,Proprietary  ,70,242,312,103,380,483
03002400,GRAHAM WEBB INTERNATIONAL ACAD HAIR     ,VA,22209-2129,Proprietary  ,7,41,48,13,75,88
03010700,BAR PALMA BEAUTY CAREERS  ACADEMY       ,VA,24014-2255,Proprietary  ,16,47,63,31,71,102
03042800,"VIRGINIA BEACH CITY SCHOOLS, SCH.-PR.NSG",VA,23456-0038,Public       ,13,43,56,35,108,143
03091300,REGENT UNIVERSITY                       ,VA,23464-9800,Private      ,442,2779,3221,1681,5505,7186
03092700,SKYLINE COLLEGE                         ,VA,24012-1603,Proprietary  ,12,59,71,27,125,152
03096500,SPRINGFIELD BEAUTY ACADEMY              ,VA,22003-3016,Proprietary  ,3,18,21,5,25,30
03106500,SENTARA COLLEGE OF HEALTH SCIENCES      ,VA,23320-2843,Private      ,68,377,445,182,695,877
03116900,BAPTIST THEOLOGICAL SEM.-RICHMOND       ,VA,23227-0000,Private      ,2,47,49,3,90,93
03126300,AVIATION INSTITUTE OF MAINTENANCE       ,VA,23320-5987,Proprietary  ,21,107,128,56,228,284
03126400,CENTURA COLLEGE                         ,VA,23235-5230,Proprietary  ,45,220,265,77,459,536
03127500,ADVANCED TECHNOLOGY INSTITUTE           ,VA,23462-2409,Proprietary  ,195,190,385,353,405,758
03280400,VIRGINIA SCHOOL OF MASSAGE              ,VA,22903-0000,Proprietary  ,7,35,42,15,45,60
03409500,CHESTER CAREER COLLEGE                  ,VA,23836-2516,Proprietary  ,27,118,145,57,215,272
03455300,CRESCENT COSMETOLOGY UNIVERSITY         ,VA,23666-3115,Proprietary  ,4,11,15,9,26,35
03559300,APPALACHIAN SCHOOL OF LAW               ,VA,24614-0000,Private      ,2,65,67,9,202,211
03645400,RUDY & KELLY ACADEMY OF HAIR AND NA     ,VA,23464-6857,Proprietary  ,50,112,162,87,212,299
03654300,CAREER TRAINING SOLUTIONS               ,VA,22406-1014,Proprietary  ,53,189,242,95,378,473
03709300,EDWARD VIA VIRGINIA CLG OSTEOPATHIC MED ,VA,24060-6360,Private      ,1,488,489,3,1023,1026
03862600,VIRGINIA BAPTIST COLLEGE                ,VA,22407-0000,Private      ,14,31,45,24,59,83
03872400,INSTITUTE FOR THE PSYCHOLOGICAL SCIENCES,VA,22202-3609,Private      ,2,49,51,10,128,138
03876300,CULPEPER COSMETOLOGY TRAINING CENTER    ,VA,22701-3155,Public       ,10,12,22,16,27,43
03883400,AVIATION INSTITUTE OF MAINTENANCE       ,VA,20110-4156,Proprietary  ,33,83,116,56,144,200
03966300,CENTRAL BAPTIST THEOLOGICAL SEMINARY OF ,VA,23464-6847,Private      ,3,10,13,3,26,29
04038400,AVI CAREER INSTITUTE                    ,VA,22066-1839,Proprietary  ,0,14,14,1,26,27
04110300,UNIVERSITY OF MANAGEMENT AND TECHNOLOGY ,VA,22209-1609,Proprietary  ,6,194,200,19,319,338
04124000,DOMINION SCHOOL OF HAIR DESIGN          ,VA,23062-2221,Proprietary  ,2,8,10,10,24,34
04127300,COLUMBIA COLLEGE                        ,VA,22031-4413,Proprietary  ,7,103,110,25,172,197
04137300,CAYCE/REILLY SCHOOL OF MASSOTHERAPY     ,VA,23451-2061,Private      ,1,29,30,5,57,62
04140000,GLOBAL HEALTH NURSE TRAINING SERVICES   ,VA,22314-4585,Proprietary  ,13,213,226,38,429,467
04153800,BETHEL COLLEGE                          ,VA,23666-3122,Private      ,9,33,42,22,74,96
04156200,INSTITUTE OF ADVANCED MEDICAL ESTHETICS ,VA,23294-4701,Proprietary  ,5,33,38,13,63,76
04169400,NORTHERN VIRGINIA SCHOOL OF THERAPEUTIC ,VA,22046-4302,Proprietary  ,9,48,57,31,87,118
04171500,COSMOPOLITAN BEAUTY & TECH SCHOOL       ,VA,22003-3204,Proprietary  ,6,73,79,11,91,102
04179900,TOMORROW'S IMAGE BARBER ACADEMY OF VIRGI,VA,23602-5532,Proprietary  ,3,23,26,7,39,46
04180600,APPALACHIAN COLLEGE OF PHARMACY         ,VA,24631-9210,Private      ,5,83,88,19,211,230
04214700,LUCKES BEAUTY ACADEMY                   ,VA,23601-1303,Proprietary  ,7,27,34,18,50,68
04218600,VIRGINIA TECH CARILION SCHOOL OF MEDICIN,VA,24016-4950,Private      ,28,96,124,175,388,563
04219000,IGLOBAL UNIVERSITY                      ,VA,22003-2400,Proprietary  ,0,5,5,2,17,19
04220100,NATIONAL PERSONAL TRAINING INSTITUTE    ,VA,22182-2412,Proprietary  ,4,17,21,8,37,45
04220400,CHRYSM INSTITUTE OF ESTHETICS (THE)     ,VA,23462-3650,Proprietary  ,7,42,49,10,95,105
04221000,"STANDARD HEALTHCARE SERVICES, COLLEGE OF",VA,22046-4612,Proprietary  ,5,99,104,11,207,218
04235400,SAINT MICHAEL COLLEGE OF ALLIED HEALTH  ,VA,22309-2348,Proprietary  ,5,54,59,13,103,116
04238700,DERMAL SCIENCE INTERNATIONAL AESTHETICS ,VA,20190-5226,Proprietary  ,2,31,33,4,66,70
04241500,WAVE LEADERSHIP COLLEGE                 ,VA,23454-2140,Private      ,12,19,31,14,25,39
00107000,THUNDERBIRD SCHOOL OF GLOBAL MANAGEMENT ,AZ,85306-6000,Private      ,0,0,0,5,51,56
00107100,ARIZONA WESTERN COLLEGE                 ,AZ,85366-0000,Public       ,1873,1790,3663,3738,3052,6790
00107200,COCHISE COLLEGE                         ,AZ,85607-6190,Public       ,693,1006,1699,1341,1786,3127
00107300,EASTERN ARIZONA COLLEGE                 ,AZ,85552-0769,Public       ,465,504,969,1208,867,2075
00107400,GRAND CANYON UNIVERSITY                 ,AZ,85017-3030,Proprietary  ,5360,18954,24314,19390,37905,57295
00107600,GLENDALE COMMUNITY COLLEGE              ,AZ,85302-3090,Public       ,3830,4873,8703,8189,9007,17196
00107700,MESA COMMUNITY COLLEGE                  ,AZ,85202-4866,Public       ,3488,5288,8776,7400,10003,17403
00107800,PHOENIX COLLEGE                         ,AZ,85013-4234,Public       ,2239,4266,6505,5077,8170,13247
00107900,YAVAPAI COLLEGE                         ,AZ,86301-3297,Public       ,652,1319,1971,1572,2714,4286
00108100,ARIZONA STATE UNIV (ALL CAMPUSES)       ,AZ,85287-0412,Public       ,10822,16028,26850,58055,43843,101898
00108200,NORTHERN ARIZONA UNIVERSITY             ,AZ,86011-0001,Public       ,4001,4286,8287,28950,11915,40865
00108300,UNIVERSITY OF ARIZONA                   ,AZ,85721-0066,Public       ,5576,4340,9916,34004,13568,47572
00165701,MIDWESTERN UNIVERSITY                   ,AZ,85308-0000,Private      ,49,1114,1163,171,4015,4186
00446700,TUCSON COLLEGE                          ,AZ,85711-3781,Proprietary  ,57,165,222,144,325,469
00711300,ARIZONA CHRISTIAN UNIVERSITY            ,AZ,85032-7097,Private      ,317,196,513,1115,427,1542
00726600,PIMA COUNTY COMMUNITY COLLEGE           ,AZ,85709-1110,Public       ,3117,4895,8012,7439,9231,16670
00728300,CENTRAL ARIZONA COLLEGE                 ,AZ,85228-9779,Public       ,1101,1533,2634,2064,2647,4711
00732911,ITT TECHNICAL INSTITUTE                 ,AZ,85282-9272,Proprietary  ,146,890,1036,285,1497,1782
00732990,ITT TECHNICAL INSTITUTE                 ,AZ,85704-5829,Proprietary  ,212,827,1039,373,1451,1824
00822100,UNIVERSAL TECHNICAL INSTITUTE           ,AZ,85323-7946,Proprietary  ,2743,2448,5191,11111,8139,19250
00824600,DINÉ COLLEGE                            ,AZ,86556-0126,Public       ,284,408,692,428,673,1101
00830300,GATEWAY COMMUNITY COLLEGE               ,AZ,85034-1795,Public       ,1184,2710,3894,2758,5094,7852
00830302,MARICOPA SKILL CENTER                   ,AZ,85034-0000,Public       ,146,394,540,310,753,1063
00830400,SCOTTSDALE COMMUNITY COLLEGE            ,AZ,85250-0000,Public       ,1269,1584,2853,2961,2972,5933
00886400,ARIZONA ACADEMY OF BEAUTY               ,AZ,85712-5021,Proprietary  ,20,55,75,53,101,154
01085800,AVALON SCHOOL OF COSMETOLOGY            ,AZ,85210-4010,Proprietary  ,196,347,543,305,513,818
01168900,REFRIGERATION SCHOOL                    ,AZ,85034-0000,Proprietary  ,58,303,361,79,506,585
01180200,ARIZONA ACADEMY OF BEAUTY-NORTH         ,AZ,85705-2720,Proprietary  ,8,29,37,26,54,80
01186200,NORTHLAND PIONEER COLLEGE               ,AZ,86025-0610,Public       ,221,543,764,430,1029,1459
01186400,MOHAVE COMMUNITY COLLEGE                ,AZ,86409-1238,Public       ,452,1125,1577,858,2063,2921
01218400,INTERNATIONAL ACADEMY OF HAIR DESIGN    ,AZ,85282-6730,Proprietary  ,12,50,62,25,80,105
02065300,PRESCOTT COLLEGE                        ,AZ,86301-0000,Private      ,92,315,407,376,647,1023
02098800,UNIVERSITY OF PHOENIX                   ,AZ,85040-0000,Proprietary  ,3005,57395,60400,6489,110541,117030
02100500,UNIVERSAL TECHNICAL INSTITUTE           ,AZ,85027-0000,Proprietary  ,2340,2481,4821,10207,8093,18300
02100600,CARRINGTON COLLEGE                      ,AZ,85015-4096,Proprietary  ,478,1367,1845,952,2652,3604
02113800,ROBERTO-VENN SCH OF LUTHIERY            ,AZ,85040-0000,Proprietary  ,13,19,32,22,32,54
02146600,SOUTH MOUNTAIN COMMUNITY COLLEGE        ,AZ,85040-0000,Public       ,913,1387,2300,1959,2547,4506
02160305,COLLINS COLLEGE                         ,AZ,85040-4000,Proprietary  ,22,58,80,53,132,185
02160306,INTERNATIONAL ACADEMY OF DESIGN AND TECH,AZ,85281-6705,Proprietary  ,12,30,42,29,61,90
02171500,WESTERN INTERNATIONAL UNIVERSITY        ,AZ,85021-0000,Proprietary  ,23,332,355,59,692,751
02177500,RIO SALADO COMMUNITY COLLEGE            ,AZ,85281-6948,Public       ,854,4249,5103,1873,8383,10256
02199900,AMERICAN INDIAN CLG-ASSEMBLIES GOD      ,AZ,85021-0000,Private      ,18,31,49,46,78,124
02217100,PIMA MEDICAL INSTITUTE                  ,AZ,85716-0000,Proprietary  ,982,2875,3857,2005,5356,7361
02218800,BROOKLINE COLLEGE                       ,AZ,85021-5815,Proprietary  ,114,723,837,222,1225,1447
02218804,BROOKLINE COLLEGE - MESA                ,AZ,85204-4448,Proprietary  ,60,236,296,116,398,514
02218805,BROOKLINE COLLEGE - TUCSON              ,AZ,85711-5444,Proprietary  ,71,228,299,126,383,509
02263100,ANTHEM COLLEGE                          ,AZ,85014-4973,Proprietary  ,28,100,128,83,192,275
02280500,CHARLES OF ITALY BEAUTY COLLEGE         ,AZ,86403-0000,Proprietary  ,10,33,43,25,60,85
02295000,EVEREST COLLEGE                         ,AZ,85021-1610,Proprietary  ,77,768,845,220,2100,2320
02295002,EVEREST COLLEGE - MESA                  ,AZ,85206-4704,Proprietary  ,30,177,207,89,475,564
02306807,ARIZONA AUTOMOTIVE INSTITUTE            ,AZ,85301-3503,Proprietary  ,188,561,749,285,808,1093
02317800,AMERICAN INSTITUTE OF TECHNOLOGY        ,AZ,85043-0000,Proprietary  ,57,313,370,140,485,625
02491500,SOUTHWEST UNIVERSITY OF VISUAL ARTS     ,AZ,85716-0000,Proprietary  ,41,51,92,107,116,223
02533200,FRANK LLOYD WRIGHT SCHOOL OF ARCHITECTUR,AZ,85261-4430,Private      ,7,15,22,18,33,51
02559000,UNIVERSITY OF ADVANCING TECHNOLOGY      ,AZ,85283-0000,Proprietary  ,212,193,405,780,440,1220
02582700,CORTIVA INSTITUTE - TUCSON              ,AZ,85710-3503,Proprietary  ,22,77,99,47,152,199
02616700,LE CORDON BLEU COLLEGE OF CULINARY ARTS ,AZ,85251-2729,Proprietary  ,247,961,1208,516,2175,2691
02623600,PARADISE VALLEY COMMUNITY COLLEGE       ,AZ,85032-1210,Public       ,1114,1665,2779,2579,3092,5671
02623800,CORTIVA INSTITUTE - SCOTTSDALE          ,AZ,85257-4218,Proprietary  ,8,47,55,11,77,88
03005000,SAFFORD COLLEGE OF BEAUTY CULTURE       ,AZ,85546-3309,Proprietary  ,2,14,16,10,24,34
03010613,VIRGINIA COLLEGE - GOLF ACADEMY OF AMERI,AZ,85225-3412,Proprietary  ,10,37,47,24,64,88
03030604,UTAH COLLEGE OF MASSAGE THERAPY - ARIZON,AZ,85282-0000,Proprietary  ,21,65,86,34,105,139
03030605,UTAH COLLEGE OF MASSAGE THERAPY - ARIZON,AZ,85051-3470,Proprietary  ,32,76,108,49,138,187
03034400,CONSERVATORY RECORDING ARTS & SCIS      ,AZ,85282-1707,Proprietary  ,195,172,367,403,408,811
03072200,CHANDLER-GILBERT COMMUNITY COLLEGE      ,AZ,85225-2499,Public       ,1769,2089,3858,3937,3891,7828
03076400,BRYMAN SCHOOL OF ARIZONA (THE)          ,AZ,85029-4919,Proprietary  ,11,62,73,27,135,162
03097800,CARSTEN INSTITUTE OF HAIR & BEAUTY      ,AZ,85282-5404,Proprietary  ,23,51,74,57,103,160
03100400,COCONINO COUNTY COMMUNITY COLLEGE       ,AZ,86001-0000,Public       ,599,636,1235,1662,1325,2987
03107000,SOUTHWEST CLG OF NATUROPATHIC MED       ,AZ,85282-0000,Private      ,5,264,269,9,473,482
03115000,ARIZONA COLLEGE OF ALLIED HEALTH        ,AZ,85302-3843,Proprietary  ,133,446,579,206,664,870
03120300,COLLEGE AMERICA                         ,AZ,86004-3936,Proprietary  ,222,660,882,292,973,1265
03156300,ESTRELLA MOUNTAIN COMMUNITY COLLEGE     ,AZ,85392-1010,Public       ,1859,2348,4207,3876,4464,8340
03347300,INTERNATIONAL BAPTIST COLLEGE           ,AZ,85282-6799,Private      ,15,13,28,24,18,42
03445300,HDS TRUCK DRIVING INSTITUTE             ,AZ,85731-0000,Proprietary  ,3,25,28,7,61,68
03478400,PHOENIX SEMINARY                        ,AZ,85018-7611,Private      ,3,55,58,7,138,145
03572300,EAST VALLEY INSTITUTE OF TECHNOLOGY     ,AZ,85201-6910,Public       ,127,203,330,264,409,673
03593300,SOUTHWEST INSTITUTE OF HEALING ARTS     ,AZ,85281-3658,Proprietary  ,53,462,515,111,951,1062
03617500,PHOENIX INSTITUTE OF HERBAL MEDICINE & A,AZ,85012-0000,Proprietary  ,14,123,137,36,243,279
03695500,ARIZONA SCHOOL OF ACUPUNCTURE AND ORIENT,AZ,85712-1100,Proprietary  ,7,8,15,16,40,56
03784400,TOHONO O'ODHAM COMMUNITY COLLEGE        ,AZ,85634-3129,Public       ,27,47,74,54,67,121
03813300,NORTHCENTRAL UNIVERSITY                 ,AZ,86314-2336,Proprietary  ,22,2107,2129,52,4537,4589
03814300,TURNING POINT BEAUTY COLLEGE            ,AZ,85222-4229,Proprietary  ,5,22,27,12,31,43
04051300,ART INSTITUTE OF PHOENIX (THE)          ,AZ,85021-2859,Proprietary  ,1707,5459,7166,3340,9929,13269
04051306,ART INSTITUTE OF PHOENIX (THE) - ART INS,AZ,85712-2732,Proprietary  ,112,177,289,299,394,693
04051325,ART INSTITUTE OF PHOENIX (THE) - BROWN M,AZ,85712-5300,Proprietary  ,57,287,344,101,436,537
04051327,ART INSTITUTE OF PHOENIX (THE) - BROWN M,AZ,85029-1348,Proprietary  ,44,129,173,113,285,398
04059300,TUCSON COLLEGE OF BEAUTY                ,AZ,85705-2451,Proprietary  ,19,53,72,46,87,133
04120900,ARIZONA CULINARY INSTITUTE              ,AZ,85259-4939,Proprietary  ,54,100,154,146,211,357
04131400,ARIZONA SUMMIT LAW SCHOOL               ,AZ,85004-4418,Proprietary  ,16,289,305,51,753,804
04148700,AMERICAN INSTITUTE OF INTERIOR DESIGN   ,AZ,85268-3827,Proprietary  ,8,11,19,22,38,60
04152900,STUDIO ACADEMY OF BEAUTY (THE)          ,AZ,85224-3600,Proprietary  ,47,161,208,81,213,294
04157400,NATIONAL PARALEGAL COLLEGE              ,AZ,85014-1262,Proprietary  ,28,420,448,58,941,999
04174100,PAUL MITCHELL THE SCHOOL PHOENIX        ,AZ,85017-1919,Proprietary  ,57,102,159,119,202,321
04174200,ALL BEAUTY COLLEGE                      ,AZ,86426-8326,Proprietary  ,13,48,61,25,104,129
04175300,PENROSE ACADEMY                         ,AZ,85254-4065,Proprietary  ,44,76,120,65,121,186
04177500,PURE AESTHETICS                         ,AZ,85711-2328,Proprietary  ,8,23,31,19,52,71
04194500,AVEDA INSTITUTE TUCSON                  ,AZ,85719-4876,Proprietary  ,35,61,96,73,110,183
04194501,AVEDA INSTITUTE TUCSON - PHOENIX        ,AZ,85284-1064,Proprietary  ,44,69,113,72,127,199
04217600,SESSIONS COLLEGE FOR PROFESSIONAL DESIGN,AZ,85281-2840,Proprietary  ,5,57,62,14,113,127
04233100,ARIZONA SCHOOL OF INTEGRATIVE STUDIES   ,AZ,86324-3106,Proprietary  ,6,14,20,9,32,41
04233101,ARIZONA SCHOOL OF INTEGRATIVE STUDIES - ,AZ,86001-5510,Proprietary  ,12,25,37,24,51,75
04233102,ARIZONA SCHOOL OF INTEGRATIVE STUDIES - ,AZ,86303-4711,Proprietary  ,6,31,37,20,58,78
04233103,ARIZONA SCHOOL OF INTEGRATIVE STUDIES - ,AZ,85705-8330,Proprietary  ,13,38,51,24,83,107
04246400,AVENTIS COLLEGE                         ,AZ,85282-1118,Proprietary  ,0,1,1,1,5,6
00142800,DELAWARE STATE UNIVERSITY               ,DE,19901-2277,Public       ,1278,660,1938,7673,1939,9612
00142900,GOLDEY BEACOM COLLEGE                   ,DE,19808-1993,Private      ,224,168,392,588,384,972
00143100,UNIVERSITY OF DELAWARE                  ,DE,19716-0099,Public       ,4480,1016,5496,25431,2579,28010
00143300,WESLEY COLLEGE                          ,DE,19901-3875,Private      ,696,290,986,2665,697,3362
00331301,WIDENER UNIV SCHOOL OF LAW - DE         ,DE,19803-0000,Private      ,16,277,293,46,800,846
00794800,WILMINGTON UNIVERSITY                   ,DE,19720-6491,Private      ,1026,3808,4834,2555,7186,9741
01172700,DELAWARE TECHNICAL COMMUNITY COLLEGE    ,DE,19901-8736,Public       ,3016,3575,6591,5944,6628,12572
02125200,BEEBE SCHOOL OF NURSING                 ,DE,19958-1462,Private      ,26,45,71,63,91,154
02190400,SCHILLING DOUGLAS SCH OF HAIR DSGN      ,DE,19711-0000,Proprietary  ,44,47,91,61,69,130
02586902,STAR TECHNICAL INSTITUTE -              ,DE,19901-4615,Proprietary  ,10,35,45,18,71,89
03025800,DAWN TRAINING CENTRE                    ,DE,19805-1511,Proprietary  ,37,144,181,64,282,346
03543300,HARRIS SCHOOL OF BUSINESS               ,DE,19803-5341,Proprietary  ,27,104,131,47,168,215
03702300,DELAWARE LEARNING INSTITUTE OF COSMETOLO,DE,19939-9759,Proprietary  ,11,32,43,23,61,84
04130700,ACADEMY OF MASSAGE AND BODYWORK         ,DE,19701-1321,Proprietary  ,9,33,42,18,52,70
04139800,DELAWARE COLLEGE OF ART & DESIGN        ,DE,19801-3007,Private      ,92,52,144,359,131,490
04171100,PAUL MITCHELL THE SCHOOL-DELAWARE       ,DE,19702-5108,Proprietary  ,41,49,90,59,75,134
        ,FEDERAL STUDENT AID USE ONLY            ,DC,20202-0000,,0,0,0,0,1,1
00143400,AMERICAN UNIVERSITY                     ,DC,20016-8020,Private      ,1523,1722,3245,13552,7803,21355
00143700,CATHOLIC UNIVERSITY OF AMERICA          ,DC,20064-0002,Private      ,581,628,1209,5014,1791,6805
00143711,"CATHOLIC UNIV AMERICA, LAW SCHOOL       ",DC,20064-0000,Private      ,5,216,221,41,841,882
00144100,UNIV OF THE DISTRICT OF COLUMBIA        ,DC,20008-0000,Public       ,864,2221,3085,2345,4688,7033
00144102,UNIV OF THE DIST OF COLU -SCHOOL OF LAW ,DC,20008-1173,Public       ,17,207,224,67,726,793
00144300,GALLAUDET UNIVERSITY                    ,DC,20002-3695,Private      ,230,341,571,783,894,1677
00144400,GEORGE WASHINGTON UNIVERSITY            ,DC,20052-2353,Private      ,1572,2944,4516,13715,9153,22868
00144402,GEORGE WASHINGTON UNIV LAW SCHL         ,DC,20052-0000,Private      ,14,638,652,66,3394,3460
00144403,GEORGE WASHINGTON UNIV SCH MED          ,DC,20052-0000,Private      ,14,451,465,86,1434,1520
00144437,GEORGE WASHINGTON UNIVERSITY            ,DC,20006-4804,Private      ,0,0,0,524,281,805
00144500,GEORGETOWN UNIVERSITY                   ,DC,20057-1252,Private      ,1179,1268,2447,11888,3551,15439
00144501,"GEORGETOWN UNIV, SCH OF MEDICINE        ",DC,20007-0000,Private      ,8,334,342,61,1132,1193
00144502,GEORGETOWN UNIVERSITY - GRADUATE SCHOOL ,DC,20057-0004,Private      ,16,1040,1056,59,3434,3493
00144503,GEORGETOWN UNIV LAW CENTER              ,DC,20001-0000,Private      ,9,812,821,49,4514,4563
00144800,HOWARD UNIVERSITY                       ,DC,20059-0001,Private      ,1396,1793,3189,14884,7333,22217
00145900,STRAYER UNIVERSITY                      ,DC,20005-2603,Proprietary  ,668,20318,20986,1093,32030,33123
00146000,TRINITY UNIVERSITY                      ,DC,20017-1004,Private      ,264,706,970,1270,1756,3026
00146400,WESLEY THEOLOGICAL SEMINARY             ,DC,20016-0000,Private      ,0,121,121,0,281,281
00207701,JOHNS HOPKINS UNIV SCH ADV INTL STU     ,DC,20036-0000,Private      ,10,192,202,69,1247,1316
01280300,DOMINICAN HOUSE OF STUDIES              ,DC,20017-1584,Private      ,1,9,10,1,17,18
02132800,NAT'L CONSERVATORY DRAMATIC ARTS        ,DC,20007-2758,Private      ,5,19,24,12,39,51
03104300,CAREER BLAZERS LEARNING CENTER OF WASHIN,DC,20037-1881,Proprietary  ,18,252,270,23,306,329
03218300,POTOMAC COLLEGE                         ,DC,20016-1860,Proprietary  ,8,82,90,33,160,193
03409600,BENNETT CAREER INSTITUTE                ,DC,20017-1754,Proprietary  ,21,96,117,57,199,256
03750300,TECHNICAL LEARNING CENTERS              ,DC,20006-3749,Proprietary  ,66,286,352,81,367,448
04114400,INSTITUTE OF WORLD POLITICS (THE)       ,DC,20036-1464,Private      ,1,46,47,7,112,119
04142700,PONTIFICAL JOHN PAUL II INSTITUTE FOR ST,DC,20064-0001,Private      ,0,6,6,1,15,16
04190000,RADIANS COLLEGE                         ,DC,20005-3542,Proprietary  ,21,349,370,50,762,812
04202500,GRADUATE SCHOOL                         ,DC,20024-2520,Private      ,3,28,31,7,80,87
00154100,ABRAHAM BALDWIN AGRICULTURAL CLG        ,GA,31794-0000,Public       ,1604,687,2291,2779,1147,3926
00154200,AGNES SCOTT COLLEGE                     ,GA,30030-3770,Private      ,326,146,472,1494,396,1890
00154300,DARTON COLLEGE                          ,GA,31707-3098,Public       ,1833,2810,4643,2981,4553,7534
00154400,ALBANY STATE UNIVERSITY                 ,GA,31705-2796,Public       ,2401,2134,4535,5642,3648,9290
00154500,ANDREW COLLEGE                          ,GA,39840-1395,Private      ,176,33,209,328,63,391
00154600,ARMSTRONG ATLANTIC STATE UNIVERSITY     ,GA,31419-1997,Public       ,2014,2040,4054,5635,4756,10391
00154700,POINT UNIVERSITY                        ,GA,30344-1999,Private      ,400,299,699,854,742,1596
00155400,BERRY COLLEGE                           ,GA,30149-5007,Private      ,776,103,879,3812,268,4080
00155500,THOMAS UNIVERSITY                       ,GA,31792-7499,Private      ,203,545,748,386,904,1290
00155600,BRENAU UNIVERSITY                       ,GA,30501-3668,Private      ,440,1355,1795,1473,2694,4167
00155700,BREWTON PARKER COLLEGE                  ,GA,30445-0000,Private      ,227,75,302,397,117,514
00155800,COLLEGE OF COASTAL GEORGIA              ,GA,31520-3644,Public       ,1034,936,1970,1984,1607,3591
00155900,CLARK ATLANTA UNIVERSITY                ,GA,30314-4385,Private      ,2115,1689,3804,9036,4193,13229
00156000,COLUMBIA THEOLOGICAL SEMINARY           ,GA,30031-0000,Private      ,2,115,117,5,178,183
00156100,COLUMBUS STATE UNIVERSITY               ,GA,31907-5645,Public       ,2422,2602,5024,5760,5001,10761
00156200,GEORGIA PERIMETER COLLEGE               ,GA,30021-0000,Public       ,6067,7632,13699,11341,14506,25847
00156300,EMMANUEL COLLEGE                        ,GA,30639-0000,Private      ,383,59,442,800,112,912
00156400,EMORY UNIVERSITY                        ,GA,30322-1960,Private      ,1522,2337,3859,13286,8658,21944
00156600,FORT VALLEY STATE UNIVERSITY            ,GA,31030-3298,Public       ,1327,1015,2342,3285,1963,5248
00156800,INTERDENOMINATIONAL THEOLOGY CENTER     ,GA,30314-0000,Private      ,1,149,150,3,325,328
00156900,GEORGIA INSTITUTE OF TECHNOLOGY         ,GA,30332-0325,Public       ,4746,2164,6910,22677,5076,27753
00157000,SOUTHERN POLYTECHNIC STATE UNIV         ,GA,30060-2896,Public       ,1233,968,2201,3591,2271,5862
00157100,GEORGIA MILITARY COLLEGE                ,GA,31061-3398,Public       ,2008,2357,4365,3682,4219,7901
00157200,GEORGIA SOUTHERN UNIVERSITY             ,GA,30460-8065,Public       ,8873,3353,12226,21208,6412,27620
00157300,GEORGIA SOUTHWESTERN STATE UNIV         ,GA,31709-4693,Public       ,1139,954,2093,2363,1688,4051
00157400,GEORGIA STATE UNIVERSITY                ,GA,30303-3010,Public       ,10726,9302,20028,29571,20539,50110
00157500,GORDON COLLEGE                          ,GA,30204-1762,Public       ,1856,1029,2885,3441,1914,5355
00157700,KENNESAW STATE UNIVERSITY               ,GA,30144-5591,Public       ,10548,6377,16925,27146,13674,40820
00157800,LAGRANGE COLLEGE                        ,GA,30240-2999,Private      ,428,235,663,1405,443,1848
00157900,GEORGIA REGENTS UNIVERSITY              ,GA,30912-0004,Public       ,1801,2191,3992,4737,5397,10134
00158000,MERCER UNIVERSITY                       ,GA,31207-0003,Private      ,1346,3576,4922,5738,6771,12509
00158100,MIDDLE GEORGIA STATE COLLEGE            ,GA,31014-1599,Public       ,2130,1741,3871,5214,4207,9421
00158200,MOREHOUSE COLLEGE                       ,GA,30314-3773,Private      ,772,392,1164,3674,984,4658
00158500,UNIVERSITY OF NORTH GEORGIA             ,GA,30597-0001,Public       ,5362,2085,7447,12574,4355,16929
00158600,OGLETHORPE UNIVERSITY                   ,GA,30319-2737,Private      ,398,204,602,2150,486,2636
00158700,PAINE COLLEGE                           ,GA,30901-3182,Private      ,383,247,630,837,459,1296
00158800,PIEDMONT COLLEGE                        ,GA,30535-5644,Private      ,468,734,1202,1109,1256,2365
00158900,REINHARDT UNIVERSITY                    ,GA,30183-2981,Private      ,539,301,840,1351,531,1882
00159000,SAVANNAH STATE UNIVERSITY               ,GA,31404-5298,Public       ,3294,1529,4823,6943,2841,9784
00159100,SHORTER UNIVERSITY                      ,GA,30165-4298,Private      ,652,851,1503,1563,1511,3074
00159200,SOUTH GEORGIA STATE COLLEGE             ,GA,31533-8104,Public       ,1113,667,1780,1726,1071,2797
00159400,SPELMAN COLLEGE                         ,GA,30314-4399,Private      ,791,408,1199,5848,1244,7092
00159600,TOCCOA FALLS COLLEGE                    ,GA,30598-0001,Private      ,270,90,360,680,178,858
00159700,TRUETT MCCONNELL COLLEGE                ,GA,30528-1264,Private      ,344,89,433,728,161,889
00159800,UNIVERSITY OF GEORGIA                   ,GA,30602-6114,Public       ,8991,3843,12834,28672,9308,37980
00159900,VALDOSTA STATE UNIVERSITY               ,GA,31698-0001,Public       ,4513,2871,7384,10002,5198,15200
00160000,WESLEYAN COLLEGE                        ,GA,31210-4407,Private      ,175,274,449,513,504,1017
00160100,UNIV OF WEST GEORGIA                    ,GA,30118-0002,Public       ,5661,2803,8464,12319,5204,17523
00160200,GEORGIA COLLEGE & STATE UNIVERSITY      ,GA,31061-0490,Public       ,2605,884,3489,6738,1699,8437
00160400,YOUNG HARRIS COLLEGE                    ,GA,30582-4137,Private      ,541,54,595,1421,121,1542
00348400,COVENANT COLLEGE                        ,GA,30750-4164,Private      ,198,26,224,1153,91,1244
00395600,DALTON STATE COLLEGE                    ,GA,30720-3797,Public       ,2128,1372,3500,3848,2436,6284
00402400,GEORGIA NORTHWESTERN TECHNICAL COLLEGE  ,GA,30161-6757,Public       ,1230,2317,3547,1910,3773,5683
00411700,GRADY HEALTH SYSTEM                     ,GA,30303-3050,Public       ,51,290,341,128,608,736
00489808,MCCANN SCHOOL OF BUSINESS & TECHNOLOGY -,GA,31210-0246,Proprietary  ,22,71,93,34,134,168
00525400,LANIER TECHNICAL COLLEGE                ,GA,30566-3499,Public       ,709,1373,2082,1215,2449,3664
00525500,MOULTRIE TECHNICAL COLLEGE              ,GA,31768-0000,Public       ,157,341,498,233,609,842
00525600,WIREGRASS GEORGIA TECHNICAL COLLEGE     ,GA,31602-0929,Public       ,557,1479,2036,901,2533,3434
00551100,COASTAL PINES TECHNICAL COLLEGE         ,GA,31501-4016,Public       ,345,755,1100,435,1047,1482
00551102,COASTAL PINES TECHNICAL COLLEGE - JESUP ,GA,31545-4465,Public       ,0,9,9,68,257,325
00559900,AUGUSTA TECHNICAL COLLEGE               ,GA,30906-3399,Public       ,747,2063,2810,1333,3508,4841
00560000,ATHENS TECHNICAL COLLEGE                ,GA,30601-1579,Public       ,1153,1535,2688,1946,2846,4792
00560100,ALBANY TECHNICAL COLLEGE                ,GA,31701-2648,Public       ,626,1968,2594,969,3169,4138
00561500,SOUTHWEST GEORGIA TECHNICAL COLLEGE     ,GA,31792-2622,Public       ,447,938,1385,667,1581,2248
00561700,SOUTH GEORGIA TECHNICAL COLLEGE         ,GA,31709-8167,Public       ,315,437,752,515,702,1217
00561800,SAVANNAH TECHNICAL COLLEGE              ,GA,31405-5594,Public       ,862,2315,3177,1515,4264,5779
00561900,NORTH GEORGIA TECHNICAL COLLEGE         ,GA,30523-0000,Public       ,634,856,1490,1106,1562,2668
00562000,CHATTAHOOCHEE TECHNICAL COLLEGE         ,GA,30060-3398,Public       ,2262,3795,6057,3833,6568,10401
00562100,SOUTHERN CRESCENT TECHNICAL COLLEGE     ,GA,30223-2097,Public       ,856,1981,2837,1372,3492,4864
00562200,GEORGIA PIEDMONT TECHNICAL COLLEGE      ,GA,30021-2397,Public       ,594,2356,2950,963,4181,5144
00562400,COLUMBUS TECHNICAL COLLEGE              ,GA,31904-6572,Public       ,636,1580,2216,1152,2802,3954
00576300,CENTRAL GEORGIA TECHNICAL COLLEGE       ,GA,31206-3628,Public       ,888,2702,3590,1516,4504,6020
00854300,ATLANTA TECHNICAL COLLEGE               ,GA,30310-4499,Public       ,935,3596,4531,1916,7336,9252
00897600,CLAYTON STATE UNIVERSITY                ,GA,30260-0285,Public       ,2596,3727,6323,5336,6726,12062
00927000,ART INSTITUTE OF ATLANTA (THE)          ,GA,30328-1649,Proprietary  ,1964,1907,3871,4721,3854,8575
00950700,GEORGIA HIGHLANDS COLLEGE               ,GA,30162-0000,Public       ,2264,1566,3830,3769,2749,6518
00982806,EVEREST INSTITUTE - JONESBORO           ,GA,30236-0000,Proprietary  ,37,186,223,61,322,383
00982807,EVEREST INSTITUTE - MARIETTA            ,GA,30067-8340,Proprietary  ,45,226,271,73,400,473
00982808,EVEREST INSTITUTE - EVEREST COLLEGE- ATL,GA,30331-2620,Proprietary  ,119,451,570,201,800,1001
00982811,EVEREST INSTITUTE - NORCROSS            ,GA,30093-2813,Proprietary  ,50,231,281,92,430,522
01031903,FORTIS INSTITUTE - FORTIS COLLEGE       ,GA,30080-7630,Proprietary  ,75,265,340,119,435,554
01048700,WEST GEORGIA TECHNICAL COLLEGE          ,GA,30182-6476,Public       ,1903,2871,4774,2977,4962,7939
01077100,GUPTON JONES COLLEGE                    ,GA,30035-4022,Private      ,41,97,138,91,200,291
01099700,EAST GEORGIA COLLEGE                    ,GA,30401-2699,Public       ,1413,524,1937,2415,931,3346
01107400,BAINBRIDGE COLLEGE                      ,GA,39819-8400,Public       ,434,808,1242,691,1436,2127
01157400,BAUDER COLLEGE                          ,GA,30313-2439,Proprietary  ,29,169,198,76,383,459
01205100,PRO WAY HAIR SCHOOL                     ,GA,30083-2884,Proprietary  ,21,75,96,36,123,159
01216500,ATLANTA METROPOLITAN COLLEGE            ,GA,30310-4498,Public       ,1250,2397,3647,2505,4774,7279
01246109,LINCOLN COLLEGE OF TECHNOLOGY - MARIETTA,GA,30067-8638,Proprietary  ,37,190,227,75,294,369
01303900,SOUTH UNIVERSITY                        ,GA,31406-4881,Proprietary  ,812,6120,6932,1428,10678,12106
02060900,BROWN CLG OF COURT REPORTING & M.T.     ,GA,30318-2570,Proprietary  ,11,185,196,27,299,326
02074800,LIFE UNIVERSITY                         ,GA,30060-0000,Private      ,235,747,982,558,2422,2980
02113613,AMERICAN INTERCONTINENTAL UNIVERSITY    ,GA,30328-1649,Proprietary  ,154,801,955,364,1734,2098
02116000,SANFORD-BROWN COLLEGE                   ,GA,30328-4803,Proprietary  ,53,274,327,118,582,700
02141500,SAVANNAH COLLEGE OF ART & DESIGN        ,GA,31402-3146,Private      ,2620,1358,3978,9879,3222,13101
02202800,AUGUSTA AREA DIET INTERN UNIV HOSP      ,GA,30901-0000,Private      ,4,32,36,15,67,82
02217200,PORTFOLIO CENTER                        ,GA,30309-0000,Proprietary  ,20,34,54,29,69,98
02266200,AMERICAN PROFESSIONAL INSTITUTE         ,GA,31201-3185,Private      ,20,80,100,29,145,174
02284300,INTERACTIVE COLLEGE OF TECHNOLOGY       ,GA,30341-0000,Proprietary  ,63,517,580,94,776,870
02284308,INTERACTIVE LEARNING SYSTEMS            ,GA,30260-0000,Proprietary  ,16,81,97,20,119,139
02284309,INTERACTIVE COLLEGE OF TECHNOLOGY       ,GA,30501-0000,Proprietary  ,35,122,157,63,183,246
02285500,"CREATIVE CIRCUS, THE                    ",GA,30324-0000,Proprietary  ,24,79,103,60,219,279
02288400,GWINNETT TECHNICAL COLLEGE              ,GA,30043-5702,Public       ,1791,3736,5527,2944,6467,9411
02313902,WESTWOOD COLLEGE - O'HARE AIRPORT - ATLA,GA,30345-2807,Proprietary  ,49,218,267,91,465,556
02321400,ROFFLER-MOLER HAIRSTYLING COLLEGE       ,GA,30062-0000,Proprietary  ,25,48,73,33,75,108
02482100,MOREHOUSE SCHOOL OF MEDICINE            ,GA,30310-0000,Private      ,51,254,305,141,839,980
02520000,INTERNATIONAL SCH SKIN & NAILCARE       ,GA,30342-1119,Proprietary  ,20,118,138,44,214,258
02559315,(UNITED EDUCATION INSTITUTE) - UEI MORRO,GA,30260-2941,Proprietary  ,8,67,75,17,125,142
02577000,PAUL MITCHELL THE SCHOOL - ESANI        ,GA,30076-1507,Proprietary  ,46,87,133,84,154,238
02577700,BEAUTY COLLEGE OF AMERICA               ,GA,30297-0000,Proprietary  ,25,45,70,41,77,118
02580200,ATLANTA SCHOOL OF MASSAGE               ,GA,30338-0000,Proprietary  ,46,220,266,109,452,561
02583000,GWINNETT COLLEGE OF BUSINESS            ,GA,30047-3447,Proprietary  ,44,326,370,77,468,545
02614206,MILLER - MOTTE TECHNICAL COLLEGE - COLUM,GA,31907-3222,Proprietary  ,70,417,487,121,680,801
02614207,MILLER - MOTTE TECHNICAL COLLEGE - AUGUS,GA,30907-0921,Proprietary  ,52,386,438,102,680,782
03005400,GEORGIA CAREER INSTITUTE                ,GA,30013-2076,Proprietary  ,85,230,315,137,374,511
03010619,VIRGINIA COLLEGE - AUGUSTA              ,GA,30909-5515,Proprietary  ,74,356,430,153,720,873
03010623,VIRGINIA COLLEGE - MACON                ,GA,31206-3180,Proprietary  ,61,242,303,108,472,580
03022601,WESTERN CULINARY INSTITUTE - LE CORDON B,GA,30084-5893,Proprietary  ,187,392,579,368,832,1200
03030000,OGEECHEE TECHNICAL COLLEGE              ,GA,30458-8049,Public       ,724,1138,1862,1082,1915,2997
03042700,LAURUSTECHNICAL INSTITUTE               ,GA,30030-1506,Proprietary  ,0,1,1,16,95,111
03066500,SOUTHEASTERN TECHNICAL COLLEGE          ,GA,30474-8817,Public       ,314,687,1001,480,1024,1504
03076300,BEULAH HEIGHTS BIBLE COLLEGE            ,GA,30316-1873,Private      ,8,242,250,24,418,442
03079202,WESTWOOD COLLEGE - ATLANTA MIDTOWN      ,GA,30309-2848,Proprietary  ,126,408,534,242,807,1049
03089100,GEORGIA INSTITUTE OF COSMETOLOGY        ,GA,30606-3152,Proprietary  ,86,182,268,127,258,385
03090600,COBB BEAUTY COLLEGE                     ,GA,30144-2828,Proprietary  ,33,64,97,60,120,180
03100900,LUTHER RICE UNIVERSITY                  ,GA,30038-2454,Private      ,18,443,461,32,777,809
03102000,RIVERTOWN SCHOOL OF BEAUTY              ,GA,31904-4747,Proprietary  ,36,97,133,50,166,216
03104500,ATLANTA INSTITUTE OF MUSIC              ,GA,30096-4988,Proprietary  ,101,118,219,211,223,434
03116100,VOGUE BEAUTY AND BARBER SCHOOL          ,GA,30141-2226,Proprietary  ,26,82,108,42,148,190
03155500,OCONEE FALL LINE TECHNICAL COLLEGE      ,GA,31082-6179,Public       ,171,584,755,259,846,1105
03173300,ATLANTA'S JOHN MARSHALL LAW SCHOOL      ,GA,30309-0000,Proprietary  ,14,562,576,54,1172,1226
03418300,GWINNETT COLLEGE-SANDY SPRINGS          ,GA,30328-3161,Proprietary  ,28,131,159,60,215,275
03445500,FAYETTE BEAUTY ACADEMY                  ,GA,30214-1191,Proprietary  ,16,62,78,27,103,130
03523300,AVIATION INSTITUTE OF MAINTENANCE       ,GA,30096-5038,Proprietary  ,112,336,448,169,540,709
03635300,CARVER BIBLE COLLEGE                    ,GA,30331-1300,Private      ,15,65,80,32,134,166
03804400,MEDTECH INSTITUTE                       ,GA,30339-6040,Proprietary  ,31,165,196,69,322,391
03812300,OMNITECH INSTITUTE                      ,GA,30035-1206,Proprietary  ,13,64,77,18,100,118
04021300,AUGUSTA SCHOOL OF MASSAGE               ,GA,30809-0000,Proprietary  ,6,26,32,12,49,61
04051331,ART INSTITUTE OF PHOENIX (THE) - BROWN M,GA,30319-3054,Proprietary  ,63,135,198,121,282,403
04142900,GEORGIA GWINNETT COLLEGE                ,GA,30043-7409,Public       ,5673,3215,8888,10080,6092,16172
04147000,PAUL MITCHELL THE SCHOOL ATLANTA        ,GA,30318-5241,Proprietary  ,140,232,372,271,448,719
04147700,LAKE LANIER SCHOOL OF MASSAGE           ,GA,30501-4546,Proprietary  ,12,64,76,19,88,107
04149900,PROFILE INSTITUTE OF BARBER-STYLING     ,GA,30315-8459,Proprietary  ,15,81,96,26,157,183
04150900,PROCESS INSTITUTE OF COSMETOLOGY (THE)  ,GA,30043-7344,Proprietary  ,43,54,97,64,94,158
04152300,GEORGIA BEAUTY ACADEMY                  ,GA,30721-3952,Proprietary  ,29,61,90,52,97,149
04156500,GEORGIA CHRISTIAN UNIVERSITY            ,GA,30047-3778,Private      ,16,39,55,39,72,111
04160200,ATLANTA BEAUTY ACADEMY                  ,GA,30340-1334,Proprietary  ,35,116,151,72,190,262
04203800,WOODRUFF MEDICAL TRAINING AND TESTING   ,GA,30033-6103,Proprietary  ,7,95,102,21,166,187
04204500,ELAINE STERLING INSTITUTE(THE)          ,GA,30342-2633,Proprietary  ,15,56,71,29,120,149
04206400,HELMS COLLEGE                           ,GA,31206-5309,Private      ,38,113,151,68,205,273
04206600,SAE INSTITUTE OF TECHNOLOGY - ATLANTA   ,GA,30303-1736,Proprietary  ,123,199,322,246,401,647
04218000,UNITED MEDICAL AND BUSINESS INSTITUTE   ,GA,30344-6977,Proprietary  ,9,55,64,17,90,107
04221100,NEW HORIZONS MEDICAL INSTITUTE          ,GA,30071-2965,Proprietary  ,19,132,151,37,274,311
00149911,EVEREST COLLEGE - MERRIONETTE PARK      ,IL,60803-4517,Proprietary  ,5,17,22,19,51,70
00162800,AMERICAN ACADEMY OF ART                 ,IL,60604-4302,Proprietary  ,122,82,204,823,278,1101
00163300,AUGUSTANA COLLEGE                       ,IL,61201-2296,Private      ,112,51,163,4583,245,4828
00163400,AURORA UNIVERSITY                       ,IL,60506-4892,Private      ,447,934,1381,4238,3043,7281
00163600,SOUTHWESTERN ILLINOIS COLLEGE           ,IL,62221-5899,Public       ,921,1573,2494,3245,4047,7292
00163800,BLACK HAWK COLLEGE                      ,IL,61265-5899,Public       ,618,801,1419,2143,1851,3994
00163900,BLACKBURN COLLEGE                       ,IL,62626-1498,Private      ,70,30,100,921,171,1092
00164000,PRAIRIE STATE COLLEGE                   ,IL,60411-8226,Public       ,539,1111,1650,2525,3533,6058
00164100,BRADLEY UNIVERSITY                      ,IL,61625-0002,Private      ,365,253,618,8253,1011,9264
00164300,SPOON RIVER COLLEGE                     ,IL,61520-8907,Public       ,135,206,341,703,676,1379
00164700,CITY COLLEGES OF CHICAGO                ,IL,60606-6998,Public       ,560,1380,1940,3515,4920,8435
00164800,TRUMAN COLLEGE                          ,IL,60640-5691,Public       ,462,1325,1787,2525,4064,6589
00164900,RICHARD J DALEY COLLEGE                 ,IL,60652-1299,Public       ,522,1089,1611,3134,3419,6553
00165000,CITY COLLEGES OF CHICAGO-MALCOLM X      ,IL,60612-3197,Public       ,735,2057,2792,4171,6675,10846
00165200,HAROLD WASHINGTON COLLEGE               ,IL,60601-2403,Public       ,1318,2127,3445,7703,6967,14670
00165400,KENNEDY KING COLLEGE                    ,IL,60621-3798,Public       ,409,1590,1999,2242,5103,7345
00165500,WRIGHT COLLEGE                          ,IL,60634-1591,Public       ,912,1563,2475,5104,4841,9945
00165700,MIDWESTERN UNIVERSITY                   ,IL,60515-1200,Private      ,11,934,945,114,3573,3687
00165900,ROSALIND FRANKLIN UNIVERSITY OF MEDICINE,IL,60064-3095,Private      ,11,604,615,64,2610,2674
00166100,CHICAGO THEOLOGICAL SEMINARY            ,IL,60637-0000,Private      ,2,69,71,16,204,220
00166300,SPERTUS COLLEGE                         ,IL,60605-1995,Private      ,0,10,10,1,37,38
00166400,UNIVERSITY OF ST FRANCIS                ,IL,60435-6188,Private      ,217,629,846,1995,1886,3881
00166500,COLUMBIA COLLEGE                        ,IL,60605-1996,Private      ,1531,988,2519,12546,4063,16609
00166600,CONCORDIA UNIVERSITY                    ,IL,60305-1499,Private      ,187,1144,1331,3012,3005,6017
00166900,DANVILLE AREA COMMUNITY COLLEGE         ,IL,61832-5199,Public       ,170,389,559,691,937,1628
00167100,DEPAUL UNIVERSITY                       ,IL,60604-2287,Private      ,1330,2272,3602,23483,13104,36587
00167400,EASTERN ILLINOIS UNIVERSITY             ,IL,61920-3099,Public       ,958,673,1631,9971,2885,12856
00167500,ELGIN COMMUNITY COLLEGE                 ,IL,60123-7193,Public       ,1014,1229,2243,3545,2855,6400
00167600,ELMHURST COLLEGE                        ,IL,60126-3296,Private      ,402,336,738,3863,1302,5165
00167800,EUREKA COLLEGE                          ,IL,61530-9976,Private      ,83,30,113,1140,156,1296
00168100,HIGHLAND COMMUNITY COLLEGE              ,IL,61032-9341,Public       ,226,283,509,770,643,1413
00168200,GARRETT-EVANGELICAL THEOLOGICAL SEM     ,IL,60201-0000,Private      ,0,49,49,3,134,137
00168400,GREENVILLE COLLEGE                      ,IL,62246-1199,Private      ,161,115,276,1528,362,1890
00168500,HEBREW THEOLOGICAL COLLEGE              ,IL,60077-3263,Private      ,156,6,162,422,27,449
00168800,ILLINOIS COLLEGE                        ,IL,62650-2299,Private      ,71,42,113,1795,217,2012
00168900,ILLINOIS COLLEGE OF OPTOMETRY           ,IL,60616-3878,Private      ,5,119,124,39,600,639
00169100,ILLINOIS INSTITUTE OF TECHNOLOGY        ,IL,60616-0000,Private      ,257,489,746,3892,1866,5758
00169103,CHICAGO KENT COLLEGE OF LAW             ,IL,60661-0000,Private      ,12,314,326,65,1272,1337
00169200,ILLINOIS STATE UNIVERSITY               ,IL,61790-1000,Public       ,2398,1098,3496,23565,4309,27874
00169300,NORTHEASTERN ILLINOIS UNIV              ,IL,60625-4699,Public       ,674,1597,2271,7010,6708,13718
00169400,CHICAGO STATE UNIVERSITY                ,IL,60628-1598,Public       ,598,2179,2777,5210,8906,14116
00169600,ILLINOIS WESLEYAN UNIVERSITY            ,IL,61701-0000,Private      ,116,47,163,3277,199,3476
00169800,JOHN MARSHALL LAW SCHOOL                ,IL,60604-0000,Private      ,6,510,516,57,1544,1601
00169900,JOLIET JUNIOR COLLEGE                   ,IL,60431-8938,Public       ,1704,1767,3471,6408,4516,10924
00170000,JUDSON UNIVERSITY                       ,IL,60123-1498,Private      ,136,205,341,1079,684,1763
00170100,KASKASKIA COLLEGE                       ,IL,62801-7878,Public       ,271,510,781,1107,1070,2177
00170300,KENDALL COLLEGE                         ,IL,60622-4278,Proprietary  ,142,360,502,864,1235,2099
00170400,KNOX COLLEGE                            ,IL,61401-4999,Private      ,80,17,97,2810,134,2944
00170500,ILLINOIS VALLEY COMMUNITY COLLEGE       ,IL,61348-9692,Public       ,278,352,630,1239,1070,2309
00170600,LAKE FOREST COLLEGE                     ,IL,60045-2399,Private      ,152,28,180,2597,233,2830
00170700,LEWIS UNIVERSITY                        ,IL,60446-2200,Private      ,453,837,1290,5943,2977,8920
00170800,LINCOLN CHRISTIAN UNIVERSITY            ,IL,62656-2167,Private      ,66,146,212,397,462,859
00170900,LINCOLN COLLEGE                         ,IL,62656-1699,Private      ,120,100,220,1215,546,1761
00171000,LOYOLA UNIVERSITY CHICAGO               ,IL,60626-0000,Private      ,1034,1954,2988,19223,9145,28368
00171200,LUTHERAN SCHOOL OF THEOL AT CHICAGO     ,IL,60615-0000,Private      ,1,16,17,6,45,51
00171600,MACCORMAC COLLEGE                       ,IL,60602-4405,Private      ,10,55,65,50,190,240
00171700,MACMURRAY COLLEGE                       ,IL,62650-2590,Private      ,92,42,134,845,232,1077
00172100,MCCORMICK THEOLOGICAL SEMINARY          ,IL,60615-5108,Private      ,0,51,51,3,110,113
00172200,MCKENDREE UNIVERSITY                    ,IL,62254-1299,Private      ,235,358,593,2029,1128,3157
00172300,MEADVILLE LOMBARD THEOLOGICAL SCHOOL    ,IL,60637-1602,Private      ,0,17,17,0,105,105
00172400,MILLIKIN UNIVERSITY                     ,IL,62522-2084,Private      ,183,184,367,3079,706,3785
00172500,MONMOUTH COLLEGE                        ,IL,61462-1963,Private      ,79,17,96,2215,165,2380
00172700,MOODY BIBLE INSTITUTE                   ,IL,60610-3214,Private      ,780,775,1555,1997,1466,3463
00172800,MORTON COLLEGE                          ,IL,60804-4398,Public       ,441,539,980,2327,1553,3880
00173200,NATIONAL UNIV OF HEALTH SCIENCES        ,IL,60148-4583,Private      ,13,322,335,45,650,695
00173300,NATIONAL-LOUIS UNIVERSITY               ,IL,60603-3032,Private      ,50,1522,1572,428,4271,4699
00173400,NORTH CENTRAL COLLEGE                   ,IL,60540-4690,Private      ,209,186,395,5024,742,5766
00173500,NORTH PARK UNIVERSITY                   ,IL,60625-4895,Private      ,261,371,632,3429,1592,5021
00173600,NORTHERN BAPTIST THEOL SEMINARY         ,IL,60148-0000,Private      ,0,29,29,2,55,57
00173700,NORTHERN ILLINOIS UNIVERSITY            ,IL,60115-2854,Public       ,2202,1938,4140,21927,8382,30309
00173900,NORTHWESTERN UNIV                       ,IL,60208-0001,Private      ,1468,2117,3585,19119,8242,27361
00174100,OLIVET NAZARENE UNIVERSITY              ,IL,60914-2271,Private      ,313,743,1056,3907,1981,5888
00174200,IL EASTERN COMM COLGS-OLNEY CENTRAL     ,IL,62450-1099,Public       ,96,166,262,473,404,877
00174500,QUINCY UNIVERSITY                       ,IL,62301-2699,Private      ,188,132,320,1569,409,1978
00174600,ROBERT MORRIS UNIVERSITY ILLINOIS       ,IL,60605-1225,Private      ,510,771,1281,5087,3749,8836
00174700,ROCK VALLEY COLLEGE                     ,IL,61114-5699,Public       ,827,1190,2017,3136,3163,6299
00174800,ROCKFORD UNIVERSITY                     ,IL,61108-2393,Private      ,194,254,448,1450,957,2407
00174900,ROOSEVELT UNIVERSITY                    ,IL,60605-1394,Private      ,558,1340,1898,5291,5062,10353
00175000,DOMINICAN UNIVERSITY                    ,IL,60305-1066,Private      ,188,501,689,4070,1631,5701
00175200,SAUK VALLEY COMMUNITY COLLEGE           ,IL,61021-9112,Public       ,226,278,504,861,670,1531
00175300,SCHOOL OF ART INSTITUTE OF CHICAGO      ,IL,60603-3013,Private      ,451,395,846,4064,2102,6166
00175600,SHIMER COLLEGE                          ,IL,60616-3893,Private      ,11,13,24,84,52,136
00175700,SOUTHEASTERN ILLINOIS COLLEGE           ,IL,62946-4925,Public       ,129,169,298,546,533,1079
00175800,SOUTHERN ILL UNIV-CARBONDALE            ,IL,62901-0000,Public       ,1837,1885,3722,17283,6670,23953
00175900,SOUTHERN ILL UNIV-EDWARDSVILLE          ,IL,62026-1060,Public       ,1933,1576,3509,13646,5043,18689
00175924,SO IL UNIV-SCHL OF DENTAL MEDICINE      ,IL,62002-0000,Public       ,1,73,74,8,168,176
00176500,UNIVERSITY OF ST MARY OF THE LAKE       ,IL,60060-0000,Private      ,0,4,4,3,13,16
00176700,BENEDICTINE UNIVERSITY                  ,IL,60532-0900,Private      ,314,995,1309,3452,2900,6352
00176800,ST XAVIER UNIVERSITY                    ,IL,60655-3199,Private      ,344,610,954,6607,2510,9117
00176900,SOUTH SUBURBAN COLLEGE                  ,IL,60473-9978,Public       ,454,1155,1609,2338,3667,6005
00177100,TRINITY CHRISTIAN COLLEGE               ,IL,60463-0929,Private      ,91,189,280,1281,748,2029
00177200,TRINITY INTERNATIONAL UNIVERSITY        ,IL,60015-1283,Private      ,118,242,360,862,746,1608
00177300,TRITON COLLEGE                          ,IL,60171-1995,Public       ,714,1098,1812,3724,3373,7097
00177400,UNIVERSITY OF CHICAGO                   ,IL,60637-1476,Private      ,1393,629,2022,17427,3174,20601
00177401,UNIV OF CHICAGO PRITZKER SCH OF MED     ,IL,60637-0000,Private      ,8,140,148,72,538,610
00177403,"UNIV OF CHICAGO, BOOTH SCH OF BUS       ",IL,60637-0000,Private      ,20,428,448,102,898,1000
00177405,UNIVERSITY OF CHICAGO GRADUATE          ,IL,60637-0000,Private      ,16,824,840,131,4059,4190
00177500,UNIV OF ILLINOIS @ URBANA-CHAMPAIGN     ,IL,61820-5796,Public       ,1936,1447,3383,33252,7468,40720
00177600,UNIV OF ILLINOIS AT CHICAGO             ,IL,60607-0000,Public       ,1963,3098,5061,27652,15876,43528
00177800,VANDERCOOK COLLEGE OF MUSIC             ,IL,60616-3731,Private      ,15,28,43,152,90,242
00177900,IL EASTERN COMM COLGS-WABASH VALLEY     ,IL,62863-2699,Public       ,91,117,208,431,255,686
00178000,WESTERN ILLINOIS UNIVERSITY             ,IL,61455-1390,Public       ,1187,1008,2195,13019,3992,17011
00178100,WHEATON COLLEGE                         ,IL,60187-5535,Private      ,405,183,588,2958,441,3399
00178300,WORSHAM COLLEGE OF MORTUARY SCIENCE     ,IL,60090-2646,Proprietary  ,17,31,48,70,112,182
00396100,HARPER COLLEGE                          ,IL,60067-7398,Public       ,1253,1319,2572,4843,3126,7969
00456000,GEM CITY COLLEGE                        ,IL,62301-4949,Proprietary  ,6,21,27,19,33,52
00456800,MIDSTATE COLLEGE                        ,IL,61614-3558,Proprietary  ,21,145,166,90,623,713
00621400,BLESSING RIEMAN COLLEGE OF NURSING      ,IL,62301-0000,Private      ,18,55,73,150,180,330
00621401,BLESSING HOSPITAL - SCHOOL OF MEDICAL LA,IL,62305-7005,Private      ,6,8,14,12,27,39
00621402,BLESSING HOSPITAL - SCHOOL OF RADIOLOGIC,IL,62305-7005,Private      ,1,12,13,21,26,47
00622500,TRINITY COLLEGE OF NURSING AND HEALTH SC,IL,61201-5317,Private      ,32,67,99,150,225,375
00622800,METHODIST MED CTR OF ILL SCH NRSNG      ,IL,61636-0000,Private      ,45,115,160,283,514,797
00624000,ST FRANCIS MED CLG OF NRSG              ,IL,61603-3783,Private      ,49,120,169,344,457,801
00638500,CHAMBERLAIN COLLEGE OF NURSING          ,IL,60101-0000,Proprietary  ,829,11099,11928,2382,23060,25442
00665600,COLLEGE OF DUPAGE                       ,IL,60137-6599,Public       ,2416,2551,4967,10188,6822,17010
00675300,ILLINOIS CENTRAL COLLEGE                ,IL,61635-0001,Public       ,752,1160,1912,3686,3109,6795
00693100,WAUBONSEE COMMUNITY COLLEGE             ,IL,60554-0000,Public       ,766,954,1720,2962,2471,5433
00711800,PARKLAND COLLEGE                        ,IL,61821-1899,Public       ,788,878,1666,3698,2485,6183
00711900,REND LAKE COLLEGE                       ,IL,62846-9801,Public       ,248,337,585,943,772,1715
00717000,LINCOLN LAND COMMUNITY COLLEGE          ,IL,62794-9256,Public       ,681,1097,1778,2501,2610,5111
00726500,CARL SANDBURG COLLEGE                   ,IL,61401-9576,Public       ,149,268,417,1078,968,2046
00730307,LINCOLN COLLEGE OF TECHNOLOGY - MELROSE ,IL,60160-1605,Proprietary  ,214,176,390,549,347,896
00754900,COYNE AMERICAN INSTITUTE                ,IL,60607-1300,Proprietary  ,109,331,440,246,646,892
00764400,LAKE LAND COLLEGE                       ,IL,61938-9366,Public       ,405,510,915,1871,1406,3277
00768400,KISHWAUKEE COLLEGE                      ,IL,60150-9699,Public       ,409,452,861,1886,1462,3348
00769000,KANKAKEE COMMUNITY COLLEGE              ,IL,60901-6505,Public       ,346,621,967,1245,1499,2744
00769100,MCHENRY COUNTY COLLEGE                  ,IL,60012-2761,Public       ,626,660,1286,1944,1483,3427
00769200,MORAINE VALLEY COMMUNITY COLLEGE        ,IL,60465-0937,Public       ,1505,1470,2975,6462,4270,10732
00769300,SHAWNEE COMMUNITY COLLEGE               ,IL,62992-9725,Public       ,128,243,371,509,548,1057
00769400,COLLEGE OF LAKE COUNTY                  ,IL,60030-1198,Public       ,978,1206,2184,3832,2933,6765
00807600,JOHN A LOGAN COLLEGE                    ,IL,62918-2500,Public       ,386,596,982,1494,1519,3013
00825900,EDUCATORS OF BEAUTY                     ,IL,61081-3611,Proprietary  ,14,14,28,25,26,51
00825901,EDUCATORS OF BEAUTY                     ,IL,61104-0000,Proprietary  ,12,9,21,42,46,88
00832800,ALVAREITA'S COLLEGE OF COSMETOLOGY      ,IL,62025-2041,Proprietary  ,0,0,0,29,36,65
00869402,RASMUSSEN COLLEGE - ROCKFORD            ,IL,61108-2513,Proprietary  ,63,404,467,164,910,1074
00869403,RASMUSSEN COLLEGE - AURORA              ,IL,60506-6219,Proprietary  ,42,238,280,107,503,610
00869404,RASMUSSEN COLLEGE - ROMEOVILLE          ,IL,60446-0000,Proprietary  ,61,358,419,144,793,937
00869418,RASMUSSEN COLLEGE -  MOKENA             ,IL,60448-0000,Proprietary  ,30,205,235,47,435,482
00888000,MORRISON INSTITUTE OF TECHNOLOGY        ,IL,61270-2959,Private      ,18,8,26,124,31,155
00893800,GRAHAM HOSPITAL SCH OF NURSING          ,IL,61520-2497,Private      ,5,8,13,25,61,86
00893900,CANNELLA SCHOOL OF HAIR DESIGN          ,IL,60406-2130,Proprietary  ,12,20,32,23,50,73
00914500,GOVERNORS STATE UNIVERSITY              ,IL,60466-0975,Public       ,441,1705,2146,2551,6021,8572
00923200,CATHOLIC THEOLOGICAL UNION              ,IL,60615-0000,Private      ,1,15,16,7,35,42
00933300,UNIV OF ILLINOIS AT SPRINGFIELD         ,IL,62703-5407,Public       ,288,818,1106,2723,2535,5258
00947500,EDUCATORS OF BEAUTY                     ,IL,61301-2404,Proprietary  ,8,14,22,20,23,43
00959500,CANNELLA SCHOOL OF HAIR DESIGN          ,IL,60617-4303,Proprietary  ,12,54,66,56,135,191
00976700,OLIVE-HARVEY COLLEGE                    ,IL,60628-1696,Public       ,270,935,1205,1561,3238,4799
00978600,IL EASTERN COMM COLGS-LINCOLN TRAIL     ,IL,62454-5708,Public       ,59,101,160,330,278,608
00980000,RUSH UNIVERSITY                         ,IL,60612-3806,Private      ,56,544,600,361,2979,3340
00982810,EVEREST INSTITUTE - EVEREST COLLEGE- BED,IL,60629-5819,Proprietary  ,5,19,24,38,74,112
00989600,OAKTON COMMUNITY COLLEGE                ,IL,60016-1268,Public       ,675,834,1509,3413,2400,5813
00998700,SAINT ANTHONY COLLEGE OF NURSING        ,IL,61108-2468,Private      ,45,102,147,195,394,589
01002000,LEWIS AND CLARK COMMUNITY COLLEGE       ,IL,62035-2466,Public       ,478,681,1159,1742,1569,3311
01050100,LAKEVIEW  COLLEGE OF NURSING            ,IL,61832-3781,Private      ,42,74,116,205,280,485
01069500,TRI-COUNTY BEAUTY ACADEMY               ,IL,62056-2036,Proprietary  ,2,9,11,10,13,23
01071000,CAPITAL AREA SCH OF PRAC NRSG           ,IL,62707-0000,Public       ,19,140,159,57,323,380
01072700,DEVRY UNIVERSITY                        ,IL,60618-5994,Proprietary  ,2290,20571,22861,6428,48082,54510
01083600,PIVOT POINT ACADEMY                     ,IL,60626-0000,Proprietary  ,20,48,68,115,185,300
01087900,RICHLAND COMMUNITY COLLEGE              ,IL,62521-8513,Public       ,275,531,806,913,1324,2237
01091303,ROCKFORD CAREER COLLEGE                 ,IL,61108-3900,Proprietary  ,112,438,550,255,756,1011
01181000,TAYLOR BUSINESS INSTITUTE               ,IL,60606-5111,Proprietary  ,5,38,43,30,111,141
01185800,EVEREST COLLEGE                         ,IL,60077-1074,Proprietary  ,1,20,21,26,63,89
01185802,EVEREST COLLEGE - BURR RIDGE            ,IL,60527-7826,Proprietary  ,2,10,12,14,32,46
01185803,EVEREST COLLEGE - MELROSE PARK          ,IL,60160-1526,Proprietary  ,9,29,38,52,99,151
01236200,NORTHWESTERN COLLEGE                    ,IL,60630-2298,Proprietary  ,160,605,765,1407,2596,4003
01238500,BLOOMINGTON-NORMAL SCH RADIOGRAPHY      ,IL,61761-4604,Private      ,4,18,22,20,32,52
01258400,ILLINOIS INSTITUTE OF ART (THE)         ,IL,60654-1593,Proprietary  ,639,713,1352,3040,2310,5350
01281300,JOHN WOOD COMMUNITY COLLEGE             ,IL,62305-0401,Public       ,165,315,480,950,879,1829
01308800,CAPRI OAK FOREST COLLEGE OF BEAUTY      ,IL,60452-2798,Proprietary  ,22,36,58,66,72,138
02055200,HARRINGTON COLLEGE OF DESIGN            ,IL,60606-3433,Proprietary  ,21,63,84,170,324,494
02068100,ADLER SCH OF PROFESSIONAL PSYCHLGY      ,IL,60601-0000,Private      ,14,492,506,90,1351,1441
02069300,VATTEROTT COLLEGE                       ,IL,62305-5938,Proprietary  ,27,91,118,56,167,223
02073200,TELSHE YESHIVA-CHICAGO                  ,IL,60625-0000,Private      ,1,4,5,34,9,43
02074400,IL EASTERN COMM COLGS-FRONTIER          ,IL,62837-0000,Public       ,40,74,114,146,191,337
02113600,AMERICAN INTERCONTINENTAL UNIVERSITY    ,IL,60192-3713,Proprietary  ,371,7262,7633,712,14114,14826
02117400,BECK AREA CAREER CENTER                 ,IL,62278-0000,Public       ,11,57,68,24,105,129
02124400,UNIVERSITY OF SPA & COSMETOLOGY ART     ,IL,62704-0000,Proprietary  ,40,70,110,75,122,197
02150600,COSMETOLOGY AND SPA INSTITUTE (THE)     ,IL,60014-4003,Proprietary  ,20,36,56,53,85,138
02155300,THE CHICAGO SCHOOL OF PROF PSYCHOLOGY   ,IL,60610-4705,Private      ,15,1498,1513,76,4460,4536
02160300,INTERNATIONAL ACAD OF DESIGN & TECH     ,IL,60602-3319,Proprietary  ,38,65,103,140,172,312
02168600,EAST WEST UNIVERSITY                    ,IL,60605-0000,Private      ,82,149,231,1134,1039,2173
02179900,ARGOSY UNIVERSITY                       ,IL,60601-7757,Proprietary  ,1344,8264,9608,3299,16354,19653
02185400,ST AUGUSTINE COLLEGE                    ,IL,60640-0000,Private      ,58,174,232,589,1643,2232
02192400,MR JOHNS SCHOOL OF COSMETOLOGY          ,IL,62521-0000,Proprietary  ,9,38,47,16,54,70
02202600,CANNELLA SCHOOL OF HAIR DESIGN          ,IL,60181-1321,Proprietary  ,4,12,16,13,31,44
02214100,RESURRECTION UNIVERSITY                 ,IL,60302-2519,Private      ,29,188,217,243,783,1026
02228100,MAC DANIEL'S BEAUTY SCHOOL              ,IL,60640-0000,Proprietary  ,11,24,35,35,74,109
02261200,HAIR PROFESSIONALS ACAD COSMETOLOGY     ,IL,60118-0000,Proprietary  ,19,87,106,30,119,149
02261201,HAIR PROFESSIONALS ACADEMY OF COSMETOLOG,IL,60118-9333,Proprietary  ,1,4,5,2,7,9
02262100,HAIR PROFESSIONALS SCH COSMETOLOGY      ,IL,60543-0000,Proprietary  ,10,11,21,18,21,39
02291200,CANNELLA SCHOOL OF HAIR DESIGN          ,IL,60639-0000,Proprietary  ,6,37,43,45,119,164
02295500,CANNELLA SCHOOL OF HAIR DESIGN          ,IL,60120-0000,Proprietary  ,3,17,20,11,43,54
02297500,OEHRLEIN SCHOOL OF COSMETOLOGY          ,IL,61611-0000,Proprietary  ,16,21,37,40,50,90
02312300,LA' JAMES COLLEGE HAIRSTYLING           ,IL,61244-0000,Proprietary  ,6,16,22,11,32,43
02313900,WESTWOOD COLLEGE - O'HARE AIRPORT       ,IL,60631-2801,Proprietary  ,51,128,179,169,414,583
02317300,CONCEPT COLLEGE OF COSMETOLOGY          ,IL,61832-0000,Proprietary  ,2,23,25,13,55,68
02319200,LAKE FOREST GRAD SCHL OF MGMT           ,IL,60045-4824,Private      ,1,46,47,6,104,110
02323300,PROFESSIONAL'S CHOICE HAIR DSN ACAD     ,IL,60435-0000,Proprietary  ,10,14,24,22,36,58
02332200,HAIR PROFESSIONALS CAREER COLLEGE       ,IL,60178-0000,Proprietary  ,4,16,20,8,26,34
02349400,ALVAREITA'S COLLEGE OF COSMETOLOGY      ,IL,62035-0000,Proprietary  ,0,0,0,5,3,8
02349500,CANNELLA SCHOOL OF HAIR DESIGN          ,IL,60632-0000,Proprietary  ,35,76,111,88,158,246
02352200,LE CORDON BLEU COLLEGE OF CULINARY ARTS ,IL,60610-3050,Proprietary  ,171,465,636,599,1084,1683
02498200,G SKIN & BEAUTY INSTITUTE               ,IL,60523-1805,Proprietary  ,24,117,141,54,174,228
02498201,HAIR PROFESSIONALS ACADEMY OF COSMETOLOG,IL,60563-0000,Proprietary  ,0,11,11,11,25,36
02522800,FOX COLLEGE                             ,IL,60638-1999,Proprietary  ,62,98,160,350,422,772
02536700,BELL MAR BEAUTY COLLEGE                 ,IL,60650-0000,Proprietary  ,6,20,26,22,46,68
02556100,ENVIRONMENTAL TECHNICAL INSTITUTE       ,IL,60143-0000,Proprietary  ,10,67,77,23,94,117
02556600,NILES SCHOOL OF COSMETOLOGY             ,IL,60714-0000,Proprietary  ,0,11,11,9,20,29
02573700,INSTITUTE FOR CLINICAL SOCIAL WORK      ,IL,60605-1229,Private      ,9,60,69,41,194,235
02584900,"FIRST INSTITUTE, INC.                   ",IL,60014-7489,Proprietary  ,33,90,123,53,137,190
02587700,HAIR PROFESSIONALS CAREER COLLEGE       ,IL,60465-1929,Proprietary  ,10,26,36,27,42,69
02599716,VATTEROTT COLLEGE - FAIRVIEW HEIGHTS    ,IL,62208-2029,Proprietary  ,70,333,403,113,454,567
02622700,KNOWLEDGE SYSTEMS INSTITUTE             ,IL,60076-0000,Private      ,0,4,4,1,7,8
03002000,HAIRMASTERS INST OF COSMETOLOGY         ,IL,61701-5547,Proprietary  ,4,20,24,17,25,42
03027702,PACIFIC COLLEGE OF ORIENTAL MEDICINE - C,IL,60601-7296,Proprietary  ,3,58,61,10,170,180
03065300,TREND SETTERS COLL OF COSMETOLOGY       ,IL,60915-0000,Proprietary  ,20,28,48,34,48,82
03065301,PAUL MITCHELL THE SCHOOL TINLEY PARK    ,IL,60477-6273,Proprietary  ,43,50,93,111,148,259
03072701,WESTWOOD COLLEGE - RIVER OAKS           ,IL,60409-5503,Proprietary  ,51,170,221,117,377,494
03072702,WESTWOOD COLLEGE OF TECHNOLOGY          ,IL,60602-0000,Proprietary  ,63,249,312,188,616,804
03078400,CAMEO BEAUTY ACADEMY                    ,IL,60453-3196,Proprietary  ,11,25,36,30,56,86
03079200,WESTWOOD COLLEGE - DUPAGE               ,IL,60517-2321,Proprietary  ,36,74,110,102,242,344
03082900,ROSEL SCHOOL OF COSMETOLOGY             ,IL,60659-1913,Proprietary  ,7,19,26,36,57,93
03083800,HEARTLAND COMMUNITY COLLEGE             ,IL,61761-9446,Public       ,450,485,935,2198,1456,3654
03098000,ST JOHN'S COLLEGE OF NURSING            ,IL,62702-5321,Private      ,11,58,69,116,194,310
03098002,ST JOHN'S HOSP SCH MED TECH             ,IL,62769-5324,Private      ,4,20,24,20,48,68
03099700,CAIN'S BARBER COLLEGE                   ,IL,60615-3510,Proprietary  ,17,111,128,77,262,339
03099800,ILLINOIS SCHOOL OF HEALTH CAREERS       ,IL,60604-0000,Proprietary  ,10,45,55,132,330,462
03101800,ILLINOIS CENTER FOR BROADCASTING        ,IL,60148-7015,Proprietary  ,22,55,77,62,123,185
03128500,NATIONAL LATINO EDUCATION INSTITUTE     ,IL,60609-2205,Private      ,10,30,40,46,84,130
03199300,CHRISTIAN LIFE COLLEGE                  ,IL,60056-2522,Private      ,5,4,9,12,13,25
03368300,MIDWEST TECHNICAL INSTITUTE             ,IL,62707-8805,Proprietary  ,345,1015,1360,723,1769,2492
03416300,COMPUTER SYSTEMS INSTITUTE              ,IL,60077-0000,Proprietary  ,114,434,548,230,642,872
03448300,BUSINESS INDUSTRIAL RESOURCES           ,IL,60659-1298,Proprietary  ,14,25,39,14,25,39
03455700,CORTIVA INSTITUTE - CHICAGO             ,IL,60602-3315,Proprietary  ,40,105,145,100,215,315
03455701,CORTIVA INSTITUTE - CHICAGO             ,IL,60014-6285,Proprietary  ,3,19,22,13,35,48
03490301,PAUL MITCHELL THE SCHOOL CHICAGO        ,IL,60607-0000,Proprietary  ,104,182,286,394,446,840
03490302,PAUL MITCHELL THE SCHOOL ESCANABA - PAUL,IL,60148-0000,Proprietary  ,49,59,108,94,104,198
03510300,ERIKSON INSTITUTE                       ,IL,60654-4510,Private      ,0,63,63,7,307,314
03643300,"MR. JOHN'S SCHOOL OF JACKSONVILLE,  INC,",IL,62650-3488,Proprietary  ,4,7,11,10,14,24
03684300,NORTHSHORE UNIVERSITY HEALTHSYSTEM SCHOO,IL,60201-9872,Private      ,1,2,3,9,45,54
03881400,EUROPEAN MASSAGE THERAPY SCHOOL         ,IL,60077-2269,Proprietary  ,8,38,46,15,63,78
03891300,SOMA INSTITUTE - THE NATIONAL SCHOOL OF ,IL,60604-4466,Proprietary  ,9,32,41,23,71,94
03914300,"CALC, INSTITUTE OF TECHNOLOGY           ",IL,62002-5946,Proprietary  ,7,50,57,17,95,112
04117500,SOLEX MEDICAL ACADEMY                   ,IL,60090-3104,Proprietary  ,1,3,4,5,9,14
04117600,LARRY'S BARBER COLLEGE                  ,IL,60628-2322,Proprietary  ,25,100,125,84,262,346
04118400,CHICAGO ORT TECHNICAL INSTITUTE         ,IL,60077-3210,Private      ,15,79,94,40,138,178
04124700,AMBRIA COLLEGE OF NURSING               ,IL,60192-3712,Proprietary  ,35,257,292,91,609,700
04136900,UNIVERSITY OF AESTHETICS (THE)          ,IL,60622-2151,Proprietary  ,0,19,19,7,42,49
04137000,UNIVERSITY OF AESTHETICS & COSMETOLOGY (,IL,60515-4607,Proprietary  ,4,10,14,11,29,40
04137500,TRICOCI UNIVERSITY OF BEAUTY CULTURE    ,IL,60656-1805,Proprietary  ,44,77,121,174,221,395
04139000,MIDWESTERN CAREER COLLEGE               ,IL,60606-3103,Proprietary  ,9,142,151,42,344,386
04141000,AVEDA INSTITUTE CHICAGO                 ,IL,60647-0000,Proprietary  ,42,91,133,173,274,447
04147100,TRICOCI UNIVERSITY OF BEAUTY CULTURE    ,IL,60048-2906,Proprietary  ,31,45,76,69,83,152
04147200,TRICOCI UNIVERSITY OF BEAUTY CULTURE    ,IL,60455-1824,Proprietary  ,27,60,87,68,127,195
04147300,TRICOCI UNIVERSITY OF BEAUTY CULTURE    ,IL,60139-3119,Proprietary  ,28,50,78,77,93,170
04147400,TRICOCI UNIVERSITY OF BEAUTY CULTURE    ,IL,61614-4831,Proprietary  ,21,50,71,52,99,151
04147500,TRICOCI UNIVERSITY OF BEAUTY CULTURE    ,IL,61108-2337,Proprietary  ,29,47,76,64,112,176
04160600,PAUL MITCHELL THE SCHOOL NORMAL         ,IL,61761-0000,Proprietary  ,32,42,74,68,74,142
04167800,INNOVATIONS DESIGN ACADEMY              ,IL,61520-2625,Proprietary  ,7,14,21,16,38,54
04168500,SOLEX COLLEGE                           ,IL,60090-3192,Proprietary  ,3,56,59,9,103,112
04170800,UNITY COSMETOLOGY COLLEGE               ,IL,61764-9652,Proprietary  ,6,11,17,8,17,25
04174900,SKIN CARE AND SPA INSTITUTE             ,IL,60077-2200,Proprietary  ,6,42,48,8,59,67
04175000,UNIVERSAL SPA TRAINING ACADEMY          ,IL,60515-0000,Proprietary  ,4,36,40,16,76,92
04175800,J RENEE CAREER FACILITATION             ,IL,60014-7986,Proprietary  ,5,40,45,11,92,103
04179100,PCCTI  IT & HEALTHCARE                  ,IL,60523-0000,Proprietary  ,7,133,140,17,295,312
04187400,COSMETOLOGY CONCEPTS                    ,IL,60452-2501,Proprietary  ,17,65,82,50,128,178
04189200,SALON PROFESSIONAL ACADEMY (THE)        ,IL,60404-8789,Proprietary  ,9,19,28,21,40,61
04189400,SHEAR LEARNING ACADEMY OF COSMETOLOGY   ,IL,62523-1208,Proprietary  ,3,15,18,7,21,28
04189600,STATE CAREER SCHOOL                     ,IL,60085-5129,Proprietary  ,9,28,37,30,67,97
04192000,CURVE METRIC SCHOOL OF HAIR DESIGN      ,IL,60707-1118,Proprietary  ,4,20,24,6,23,29
04195600,TRIBECA FLASHPOINT MEDIA ARTS ACADEMY   ,IL,60602-2716,Proprietary  ,87,93,180,358,203,561
04224400,NETWORKS BARBER COLLEGE                 ,IL,60409-3401,Proprietary  ,3,11,14,7,21,28
04224500,TRENZ BEAUTY ACADEMY                    ,IL,60409-0000,Proprietary  ,5,19,24,11,40,51
04225300,CREATIVE TOUCH COSMETOLOGY SCHOOL       ,IL,62298-1609,Proprietary  ,1,5,6,6,8,14
04227900,MORTHLAND COLLEGE                       ,IL,62896-2742,Private      ,33,12,45,111,25,136
04229900,DEBUTANTES SCHOOL OF COSMETOLOGY AND NAI,IL,60115-3301,Proprietary  ,4,24,28,20,39,59
04232300,HVAC TECHNICAL INSTITUTE                ,IL,60632-4457,Proprietary  ,16,70,86,40,111,151
11072707,DEVRY UNIVERSITY - DOWNERS              ,IL,60515-0000,Proprietary  ,107,1394,1501,365,3985,4350
00195100,ALICE LLOYD COLLEGE                     ,KY,41844-9703,Private      ,58,31,89,1192,209,1401
00195200,ASBURY COLLEGE                          ,KY,40390-1198,Private      ,180,190,370,1631,557,2188
00195300,ASBURY THEOLOGICAL SEMINARY             ,KY,40390-0000,Private      ,3,309,312,18,850,868
00195400,BELLARMINE UNIVERSITY                   ,KY,40205-1877,Private      ,247,437,684,5325,1568,6893
00195500,BEREA COLLEGE                           ,KY,40403-0000,Private      ,149,100,249,2959,690,3649
00195800,BRESCIA UNIVERSITY                      ,KY,42301-3023,Private      ,69,245,314,1045,814,1859
00195900,CAMPBELLSVILLE UNIVERSITY               ,KY,42718-2799,Private      ,218,378,596,2693,1358,4051
00196000,SPALDING UNIVERSITY                     ,KY,40203-2188,Private      ,134,560,694,1379,2273,3652
00196100,CENTRE COLLEGE                          ,KY,40422-1394,Private      ,89,28,117,2440,120,2560
00196200,UNIVERSITY OF THE CUMBERLANDS           ,KY,40769-1372,Private      ,184,1303,1487,2561,3079,5640
00196300,EASTERN KENTUCKY UNIVERSITY             ,KY,40475-3102,Public       ,1573,2490,4063,13692,8262,21954
00196400,GEORGETOWN COLLEGE                      ,KY,40324-1628,Private      ,155,178,333,1834,479,2313
00196500,KENTUCKY CHRISTIAN UNIVERSITY           ,KY,41143-2205,Private      ,108,72,180,964,233,1197
00196800,KENTUCKY STATE UNIVERSITY               ,KY,40601-2355,Public       ,379,406,785,2501,1427,3928
00196900,KENTUCKY WESLEYAN COLLEGE               ,KY,42301-6057,Private      ,128,80,208,1283,303,1586
00197100,LEXINGTON THEOLOGICAL SEMINARY          ,KY,40508-0000,Private      ,1,24,25,7,51,58
00197200,LINDSEY WILSON COLLEGE                  ,KY,42728-1223,Private      ,135,374,509,2909,1446,4355
00197400,LOUISVILLE PRESBYTERIAN THEOL SEM       ,KY,40205-0000,Private      ,4,75,79,14,129,143
00197500,MIDWAY UNIVERSITY                       ,KY,40347-1120,Private      ,55,316,371,498,1121,1619
00197600,MOREHEAD STATE UNIVERSITY               ,KY,40351-1689,Public       ,903,1222,2125,7718,3654,11372
00197700,MURRAY STATE UNIVERSITY                 ,KY,42071-0009,Public       ,1106,1240,2346,7216,3413,10629
00197900,WEST KENTUCKY CMNTY & TECHNICAL COLG    ,KY,42002-7380,Public       ,417,1046,1463,1790,2747,4537
00198000,UNIVERSITY OF PIKEVILLE                 ,KY,41501-1194,Private      ,157,279,436,2323,1419,3742
00198300,ST. CATHARINE COLLEGE                   ,KY,40061-9499,Private      ,67,65,132,702,255,957
00198700,TRANSYLVANIA UNIVERSITY                 ,KY,40508-1797,Private      ,130,61,191,2033,234,2267
00198800,UNION COLLEGE                           ,KY,40906-1499,Private      ,111,139,250,1214,513,1727
00198900,UNIVERSITY OF KENTUCKY                  ,KY,40506-0054,Public       ,2635,2193,4828,24579,8144,32723
00198901,UNIV OF KY-COLLEGE OF DENTISTRY         ,KY,40536-0000,Public       ,0,154,154,50,285,335
00198902,UNIV OF KY-COLLEGE OF MEDICINE          ,KY,40536-0000,Public       ,8,165,173,85,568,653
00199000,ASHLAND COMMUNITY AND TECHNICAL COLLEGE ,KY,41101-3683,Public       ,297,729,1026,1137,1806,2943
00199100,ELIZABETHTOWN COMMUNITY  AND TECHNICAL C,KY,42701-3081,Public       ,430,1115,1545,2131,3018,5149
00199300,HENDERSON COMMUNITY COLLEGE             ,KY,42420-4699,Public       ,134,297,431,539,874,1413
00199400,HOPKINSVILLE COMMUNITY COLLEGE          ,KY,42241-2621,Public       ,261,995,1256,792,2432,3224
00199600,BIG SANDY COMMUNITY AND TECHNICAL COLG  ,KY,41653-1815,Public       ,271,650,921,1854,2198,4052
00199700,SOMERSET COMMUNITY COLLEGE              ,KY,42501-2973,Public       ,449,1483,1932,2501,4412,6913
00199800,SOUTHEAST KENTUCKY COMMUNITY AND TECHNIC,KY,40823-1099,Public       ,196,485,681,1019,1351,2370
00199900,UNIVERSITY OF LOUISVILLE                ,KY,40292-0000,Public       ,1746,2695,4441,15652,10109,25761
00200100,THOMAS MORE COLLEGE                     ,KY,41017-3495,Private      ,163,168,331,1504,568,2072
00200200,WESTERN KENTUCKY UNIVERSITY             ,KY,42101-3576,Public       ,1914,2190,4104,14968,6989,21957
00461800,SPENCERIAN COLLEGE                      ,KY,40216-2605,Proprietary  ,69,287,356,351,948,1299
00461900,SULLIVAN UNIVERSITY                     ,KY,40205-3000,Proprietary  ,280,1015,1295,1532,3771,5303
00493402,DAYMAR COLLEGE - BOWLING GREEN          ,KY,42101-4063,Proprietary  ,31,173,204,82,286,368
00493406,DAYMAR COLLEGE - RUSSELLVILLE           ,KY,42276-1622,Proprietary  ,3,25,28,8,52,60
00524400,BLUEGRASS COMMUNITY & TECHNICAL COLLEGE ,KY,40506-0235,Public       ,1066,2387,3453,4583,6279,10862
00527100,BOWLING GREEN TECHNICAL COLLEGE         ,KY,42101-3601,Public       ,349,821,1170,1641,2431,4072
00527300,GATEWAY COMMUNITY & TECHNOLOGY COLL     ,KY,41011-0000,Public       ,349,896,1245,1316,2510,3826
00696000,MAYSVILLE CMNTY & TECHNCL COLG          ,KY,41056-8910,Public       ,222,739,961,988,1930,2918
00696100,JEFFERSON COMMUNITY AND TECHNICAL COLLEG,KY,40202-2005,Public       ,1211,2688,3899,5659,8852,14511
00696200,HAZARD COMMUNITY COLLEGE                ,KY,41701-2402,Public       ,154,516,670,1153,1607,2760
00696203,KY TECH-KNOTT CO. TECHNOLOGY CTR        ,KY,41822-0000,Public       ,0,3,3,3,13,16
00696204,KY TECH-LESLIE COUNTY AREA TECH CTR     ,KY,41749-0000,Public       ,0,3,3,5,10,15
00696205,KY TECH-LEE COUNTY AREA TECH CTR        ,KY,41311-0000,Public       ,0,0,0,1,4,5
00696206,KY TECH-LETCHER CNTY AREA TECH CTR      ,KY,41858-0000,Public       ,3,14,17,18,39,57
00696207,KY TECH-BREATHITT COUNTY VOC ED CTR     ,KY,41339-0000,Public       ,3,11,14,16,36,52
00736205,MEDTECH COLLEGE - LEXINGTON             ,KY,40511-1200,Proprietary  ,52,294,346,96,455,551
00842500,DAYMAR COLLEGE                          ,KY,42001-0000,Proprietary  ,1,34,35,18,83,101
00901000,MADISONVILLE COMMUNITY COLLEGE          ,KY,42431-9199,Public       ,208,661,869,873,1529,2402
00927500,NORTHERN KENTUCKY UNIVERSITY            ,KY,41099-0001,Public       ,1657,1919,3576,10132,5396,15528
00931300,DAYMAR COLLEGE                          ,KY,42301-5830,Proprietary  ,19,222,241,46,519,565
00931302,DAYMAR COLLEGE - LOUISVILLE             ,KY,40219-1973,Proprietary  ,0,0,0,34,61,95
00931305,DAYMAR COLLEGE - BELLEVUE               ,KY,41073-2416,Proprietary  ,0,8,8,2,17,19
00931309,DAYMAR COLLEGE - LOUISVILLE EAST        ,KY,40245-1629,Proprietary  ,0,0,0,11,28,39
00931310,DAYMAR COLLEGE -  MADISONVILLE          ,KY,42431-0000,Proprietary  ,5,66,71,16,112,128
01042400,SALON PROFESSIONAL ACADEMY THE          ,KY,40502-0000,Proprietary  ,25,102,127,85,195,280
01048901,NATIONAL COLLEGE - FLORENCE CAMPUS      ,KY,41042-1812,Proprietary  ,8,31,39,29,134,163
01048902,NATIONAL COLLEGE - PIKEVILLE CAMPUS     ,KY,41501-1518,Proprietary  ,14,103,117,132,392,524
01048903,NATIONAL COLLEGE - DANVILLE CAMPUS      ,KY,40422-1517,Proprietary  ,3,50,53,29,177,206
01048904,NATIONAL COLLEGE - RICHMOND CAMPUS      ,KY,40475-2309,Proprietary  ,8,61,69,40,190,230
01048906,NATIONAL COLLEGE - LOUISVILLE CAMPUS    ,KY,40216-4147,Proprietary  ,24,112,136,69,419,488
01048907,NATIONAL COLLEGE - LEXINGTON CAMPUS     ,KY,40509-2256,Proprietary  ,15,127,142,53,330,383
01172500,COLLINS SCHOOL OF COSMETOLOGY           ,KY,40965-2809,Proprietary  ,4,8,12,22,31,53
01208800,SULLIVAN COLLEGE OF TECHNOLOGY AND DESIG,KY,40218-4528,Proprietary  ,86,187,273,464,593,1057
01272300,KY TECH-WAYNE COUNTY AREA TECH CTR      ,KY,42633-1088,Public       ,1,1,2,5,6,11
02159100,"APPALACHIAN BEAUTY SCHOOL, INC.         ",KY,41503-0000,Proprietary  ,8,13,21,25,44,69
02251500,TREND SETTERS ACAD OF BEAUTY CULT       ,KY,40258-0000,Proprietary  ,13,67,80,44,131,175
02275000,JENNY LEA ACADEMY OF COSMETOLOGY        ,KY,40831-0000,Proprietary  ,15,53,68,33,109,142
02284306,INTERACTIVE LEARNING SYSTEMS            ,KY,41042-0000,Proprietary  ,7,44,51,11,64,75
02323700,PAT WILSON'S BEAUTY COLLEGE             ,KY,42420-0000,Proprietary  ,0,17,17,2,34,36
02337200,PJ'S COLLEGE OF COSMETOLOGY             ,KY,42101-0000,Proprietary  ,23,138,161,84,282,366
02340800,PAUL MITCHELL THE SCHOOL LEXINGTON      ,KY,40514-1545,Proprietary  ,53,102,155,153,199,352
02351700,PAUL MITCHELL THE SCHOOL - LOUISVILLE   ,KY,40222-0000,Proprietary  ,36,101,137,167,232,399
02491100,BECKFIELD COLLEGE                       ,KY,41042-0000,Proprietary  ,64,593,657,180,1363,1543
02518900,BARRETT & COMPANY SCH HAIR DESIGN       ,KY,40356-0000,Proprietary  ,10,46,56,26,82,108
02526100,JENNY LEA ACADEMY OF COSMETOLOGY        ,KY,41858-0000,Proprietary  ,10,11,21,27,38,65
02535600,CLEAR CREEK BAPTIST BIBLE COLLEGE       ,KY,40977-0000,Private      ,18,42,60,39,78,117
02551100,PJ'S COLLEGE OF COSMETOLOGY             ,KY,42141-2434,Proprietary  ,8,25,33,31,54,85
02560800,SOUTHEAST SCHOOL OF COSMETOLOGY         ,KY,40962-0000,Proprietary  ,8,18,26,27,37,64
03002100,KENTUCKY MOUNTAIN BIBLE COLLEGE         ,KY,41385-0010,Private      ,16,9,25,39,21,60
03007000,FRONTIER SCH OF MIDWIFERY&FAMILY NU     ,KY,41749-0000,Private      ,1,578,579,10,1199,1209
03026200,HEAD'S WEST KENTUCKY BEAUTY COLLEGE     ,KY,42431-0000,Proprietary  ,2,32,34,16,56,72
03029200,NU-TEK ACADEMY OF BEAUTY                ,KY,40353-9767,Proprietary  ,4,8,12,10,22,32
03034500,OWENSBORO COMMUNITY & TECHNICAL COLLEGE ,KY,42303-1899,Public       ,279,653,932,1401,1638,3039
03083700,GALEN HEALTH INSTITUTES                 ,KY,40207-1047,Proprietary  ,332,2264,2596,728,4702,5430
03611300,BRIGHTON CENTER'S CENTER FOR EMPLOY     ,KY,41071-1968,Private      ,2,27,29,6,41,47
03804300,BELLEFONTE ACADEMY OF BEAUTY            ,KY,41169-2015,Proprietary  ,10,38,48,20,61,81
03885300,EMPLOYMENT SOLUTIONS                    ,KY,40517-3260,Private      ,20,116,136,43,199,242
04038300,ATA CAREER EDUCATION                    ,KY,40223-3832,Proprietary  ,48,317,365,133,664,797
04038701,IDEAL BEAUTY ACADEMY - LOUISVILLE       ,KY,40223-5606,Proprietary  ,7,33,40,47,79,126
04051316,ART INSTITUTE OF PHOENIX (THE) - ATS - (,KY,41017-2136,Proprietary  ,4,41,45,26,138,164
04051319,ART INSTITUTE OF PHOENIX (THE) - BROWN M,KY,40219-1916,Proprietary  ,27,73,100,123,332,455
04051320,ART INSTITUTE OF PHOENIX (THE) - BROWN M,KY,42240-3579,Proprietary  ,10,43,53,26,173,199
04123900,LEXINGTON HEALING ARTS ACADEMY          ,KY,40503-1932,Proprietary  ,7,48,55,34,117,151
04177600,LINDSEY INSTITUTE OF COSMETOLOGY        ,KY,42103-8036,Proprietary  ,15,29,44,64,65,129
04177700,TRI-STATE INSTITUTE OF HAIR DESIGN      ,KY,40744-5234,Proprietary  ,9,35,44,25,75,100
04178000,SIMMONS COLLEGE OF KENTUCKY             ,KY,40203-3322,Private      ,29,86,115,66,181,247
04204800,AMERICAN COLLEGE OF BARBERING           ,KY,40229-2862,Proprietary  ,9,41,50,37,115,152
04229300,MEDQUEST COLLEGE                        ,KY,40243-1882,Proprietary  ,32,74,106,63,140,203
00200300,CENTENARY COLLEGE OF LOUISIANA          ,LA,71104-3396,Private      ,312,128,440,770,244,1014
00200400,DILLARD UNIVERSITY                      ,LA,70122-3097,Private      ,713,463,1176,2484,991,3475
00200500,NICHOLLS STATE UNIVERSITY               ,LA,70310-0001,Public       ,2703,1189,3892,5174,2099,7273
00200600,GRAMBLING STATE UNIVERSITY              ,LA,71245-2215,Public       ,1720,1548,3268,3920,2684,6604
00200700,LOUISIANA COLLEGE                       ,LA,71359-0000,Private      ,469,276,745,892,447,1339
00200800,LOUISIANA TECH UNIVERSITY               ,LA,71272-0001,Public       ,3699,1209,4908,7447,2124,9571
00201000,LOUISIANA STATE UNIV & A&M COLG         ,LA,70803-5710,Public       ,9689,3299,12988,24518,6663,31181
00201100,LOUISIANA STATE UNIV-ALEXANDRIA         ,LA,71302-9121,Public       ,908,717,1625,1977,1475,3452
00201200,LOUISIANA STATE UNIV-EUNICE             ,LA,70535-6726,Public       ,956,646,1602,1760,1237,2997
00201300,LOUISIANA STATE UNIV-SHREVEPORT         ,LA,71115-2399,Public       ,1137,1864,3001,2212,3031,5243
00201400,LA STATE UNIV HEALTH SCIENCES CTR       ,LA,70112-2223,Public       ,311,1076,1387,568,2307,2875
00201500,(THE) UNIVERSITY OF NEW ORLEANS         ,LA,70148-0001,Public       ,2574,2600,5174,5564,4705,10269
00201600,LOYOLA UNIVERSITY NEW ORLEANS           ,LA,70118-6195,Private      ,1057,958,2015,4062,1924,5986
00201700,MCNEESE STATE UNIVERSITY                ,LA,70609-4510,Public       ,3019,1711,4730,5343,2828,8171
00201900,NEW ORLEANS BAPTIST THEOL SEMINARY      ,LA,70126-0000,Private      ,29,82,111,52,161,213
00202000,UNIVERSITY OF LOUISIANA AT MONROE       ,LA,71209-9001,Public       ,3187,2080,5267,6257,3498,9755
00202100,NORTHWESTERN STATE UNIVERSITY           ,LA,71497-0001,Public       ,2482,2209,4691,5025,3810,8835
00202200,NOTRE DAME SEMINARY                     ,LA,70118-0000,Private      ,1,6,7,8,17,25
00202300,OUR LADY OF HOLY CROSS COLLEGE          ,LA,70131-7399,Private      ,282,657,939,552,1015,1567
00202400,SOUTHEASTERN LOUISIANA UNIV             ,LA,70402-0001,Public       ,4987,2259,7246,9477,3893,13370
00202500,SOUTHERN UNIVERSITY A & M COLLEGE       ,LA,70813-9374,Public       ,3146,2720,5866,7053,4978,12031
00202600,SOUTHERN UNIV NEW ORLEANS               ,LA,70126-0002,Public       ,839,1812,2651,1748,3079,4827
00202700,ST JOSEPH SEMINARY COLLEGE              ,LA,70457-9990,Private      ,23,6,29,39,6,45
00202900,TULANE UNIVERSITY                       ,LA,70118-5698,Private      ,1467,2267,3734,12171,5462,17633
00203100,UNIV OF LOUISIANA AT LAFAYETTE          ,LA,70504-0001,Public       ,6898,2831,9729,13917,5115,19032
00203200,XAVIER UNIVERSITY OF LOUISIANA          ,LA,70125-1098,Private      ,1283,844,2127,4619,1575,6194
00462100,AYERS CAREER COLLEGE                    ,LA,71108-5845,Proprietary  ,27,151,178,43,269,312
00462500,DELGADO COMMUNITY COLLEGE               ,LA,70119-0000,Public       ,3063,6641,9704,5423,11515,16938
00546700,SOWELA TECHNICAL COMMUNITY COLLEGE      ,LA,70616-6950,Public       ,780,763,1543,1245,1295,2540
00546702,SOWELA TECHNICAL COMMUNITY COLLEGE - MOR,LA,70546-1327,Public       ,41,42,83,76,78,154
00548800,CAPITAL AREA TECHNICAL COLLEGE          ,LA,70807-0000,Public       ,88,236,324,177,460,637
00548812,LOUISIANA TECH COLG-FOLKES CAMPUS       ,LA,70748-0000,Public       ,5,19,24,13,36,49
00548817,LOUISIANA TEC CLG-JUMONVILLE MEM CP     ,LA,70760-0000,Public       ,5,18,23,12,26,38
00548842,LOUISIANA TECHNICAL COLLEGE - WESTSIDE C,LA,70765-0733,Public       ,10,37,47,24,59,83
00548900,CENTRAL LOUISIANA TECHNICAL COLLEGE     ,LA,71302-3137,Public       ,226,465,691,371,819,1190
00552600,SOUTH CENTRAL LOUISIANA TECHNICAL COLG  ,LA,70381-2148,Public       ,40,115,155,68,203,271
00552602,SOUTH CENTRAL LOUISIANA TECHNICAL COLG  ,LA,70302-4336,Public       ,40,86,126,76,171,247
00552603,SOUTH CENTRAL LOUISIANA TECHNICAL COLG  ,LA,70084-6632,Public       ,165,232,397,294,371,665
00576100,L. E. FLETCHER TECHNICAL COMMUNITY COLLE,LA,70360-2863,Public       ,569,484,1053,958,837,1795
00675600,NORTHSHORE TECHNICAL COLLEGE            ,LA,70427-5866,Public       ,297,416,713,500,671,1171
00768600,SOUTHERN UNIV AT SHREVEPORT/BOSSIER     ,LA,71107-4795,Public       ,666,1000,1666,1134,1679,2813
00806700,LSU HEALTH SCIENCES CENTR-SHREVEPOR     ,LA,71130-3932,Public       ,94,524,618,242,942,1184
00989800,DEMMON SCHOOL OF BEAUTY                 ,LA,70607-2128,Proprietary  ,14,33,47,27,64,91
00997500,NORTHWEST LOUISIANA TECHNICAL COLLEGE   ,LA,71055-2422,Public       ,122,177,299,174,290,464
00997503,NORTHWEST LOUISIANA TECHNICAL COLLEGE   ,LA,71137-8527,Public       ,114,370,484,191,634,825
00997504,NORTHWEST LOUISIANA TECHNICAL COLLEGE   ,LA,71052-1236,Public       ,22,55,77,37,87,124
00997505,NORTHWEST LOUISIANA TECHNICAL COLLEGE   ,LA,71449-0790,Public       ,12,26,38,28,47,75
00997506,NORTHWEST LOUISIANA TECHNICAL COLLEGE   ,LA,71458-0657,Public       ,73,104,177,133,175,308
01109700,CLOYD'S BEAUTY SCHOOL #1                ,LA,71291-3131,Proprietary  ,21,44,65,28,79,107
01163100,"D-JAY'S SCHL OF BEAUTY, ARTS & SCI      ",LA,70806-0000,Proprietary  ,15,42,57,32,82,114
01184100,JOHN JAY BEAUTY COLLEGE                 ,LA,70124-2592,Proprietary  ,32,77,109,65,131,196
01282300,PAT GOINS RUSTON BEAUTY SCHOOL          ,LA,71270-4301,Proprietary  ,21,36,57,31,48,79
01287900,PAT GOINS BENTON ROAD BEAUTY SCHOOL     ,LA,71111-4838,Proprietary  ,12,37,49,15,62,77
01288000,CELEBRITY STYLIST BEAUTY SCHOOL         ,LA,71201-5167,Proprietary  ,16,30,46,25,59,84
01288001,CELEBRITY STYLIST BEAUTY SCHOOL - CELEBR,LA,71201-5133,Proprietary  ,0,3,3,0,3,3
02055400,BOSSIER PARISH COMMUNITY COLLEGE        ,LA,71111-0000,Public       ,1408,2327,3735,2237,3774,6011
02055500,DELTA SCH OF BUSINESS & TECHNOLOGY      ,LA,70601-0000,Proprietary  ,51,176,227,86,268,354
02117800,AVEDA INSTITUTE LAFAYETTE               ,LA,70503-3246,Proprietary  ,91,85,176,142,179,321
02166100,NUNEZ COMMUNITY COLLEGE                 ,LA,70043-0000,Public       ,271,639,910,448,1078,1526
02166200,ITI TECHNICAL COLLEGE                   ,LA,70817-0000,Proprietary  ,223,355,578,354,551,905
02197500,BATON ROUGE SCHOOL OF COMPUTERS         ,LA,70809-8188,Proprietary  ,31,68,99,59,115,174
02234000,CAMERON COLLEGE                         ,LA,70119-0000,Proprietary  ,19,93,112,39,181,220
02258400,AVEDA INSTITUTE BATON ROUGE             ,LA,70816-2246,Proprietary  ,104,107,211,162,174,336
02260200,DIESEL DRIVING ACADEMY                  ,LA,71109-5617,Proprietary  ,26,191,217,38,264,302
02265600,JOHN JAY KENNER ACADEMY                 ,LA,70062-0000,Proprietary  ,14,44,58,22,67,89
02269300,STEVENSON'S ACADEMY OF HAIR DESIGN      ,LA,70116-0000,Proprietary  ,13,71,84,28,116,144
02327800,PINEVILLE BEAUTY SCHOOL                 ,LA,71360-0000,Proprietary  ,29,28,57,48,44,92
02335700,BATON ROUGE GENERAL MEDICAL CENTER      ,LA,70806-3889,Private      ,40,45,85,77,104,181
02335701,BATON ROUGE GEN MED CTR SCH NSG         ,LA,70821-0000,Private      ,54,124,178,91,228,319
02335702,BATON ROUGE GEN MED CTR-RAD TECH        ,LA,70806-0000,Private      ,39,44,83,64,96,160
02338000,"CLOYD'S BEAUTY SCHOOL #2, INC           ",LA,71202-3539,Proprietary  ,19,46,65,27,67,94
02352500,"CLOYD'S BEAUTY SCHOOL #3, INC           ",LA,71201-3211,Proprietary  ,19,46,65,27,71,98
02358600,"STAGE ONE THE HAIR SCHOOL, INC.         ",LA,70605-0000,Proprietary  ,38,53,91,62,104,166
02518300,SOUTH LOUISIANA BEAUTY COLLEGE          ,LA,70363-0000,Proprietary  ,15,15,30,24,30,54
02536400,LOUISIANA ACADEMY OF BEAUTY             ,LA,70535-0000,Proprietary  ,22,16,38,27,30,57
02538300,DELTA COLLEGE OF ARTS & TECH INC        ,LA,70806-1529,Proprietary  ,84,220,304,149,426,575
02538301,DELTA COLLEGE OF ARTS & TECHNOLOGY - LAF,LA,70508-6831,Proprietary  ,58,153,211,100,268,368
02548500,COSMETOLOGY TRAINING CENTER             ,LA,70503-0000,Proprietary  ,35,40,75,63,89,152
02554800,VANGUARD COLLEGE OF COSMETOLOGY         ,LA,70458-8823,Proprietary  ,96,115,211,129,174,303
02582200,"GUY'S ACADEMY HAIR, SKIN & NAILS        ",LA,71105-2404,Proprietary  ,24,53,77,35,83,118
02600900,AVEDA INSTITUTE                         ,LA,70433-2922,Proprietary  ,446,602,1048,703,976,1679
02601000,AMERICAN SCHOOL OF BUSINESS             ,LA,71105-5646,Proprietary  ,10,42,52,22,82,104
02601100,OPELOUSAS SCHOOL OF COSMETOLOGY         ,LA,70570-6156,Proprietary  ,18,18,36,23,45,68
02619200,DENHAM SPRINGS BEAUTY COLLEGE           ,LA,70726-3829,Proprietary  ,31,30,61,46,61,107
03010400,CRESCENT CITY SCH GAMING & BARTENDG     ,LA,70119-5507,Proprietary  ,36,221,257,66,355,421
03010624,VIRGINIA COLLEGE - BATON ROUGE          ,LA,70815-8604,Proprietary  ,68,225,293,113,397,510
03023500,CAMELOT CAREER COLLEGE                  ,LA,70805-7539,Proprietary  ,34,66,100,58,118,176
03026514,REMINGTON COLLEGE - LAFAYETTE           ,LA,70508-5760,Private      ,62,121,183,122,234,356
03026515,REMINGTON COLLEGE - BATON ROUGE         ,LA,70816-4040,Private      ,40,93,133,82,177,259
03027300,BLALOCK'S PROFESSIONAL BEAUTY COLLEGE   ,LA,71108-3246,Proprietary  ,11,23,34,20,36,56
03030900,DIESEL DRIVING ACADEMY                  ,LA,70815-8109,Proprietary  ,27,189,216,40,268,308
03106200,OUR LADY OF THE LAKE COLLEGE            ,LA,70808-4345,Private      ,425,700,1125,838,1265,2103
03294300,BLUE CLIFF SCH THERAPEUTIC MASSAGE      ,LA,70002-3458,Proprietary  ,230,1082,1312,309,1419,1728
03294303,BLUE CLIFF COLLEGE - LAFAYETTE          ,LA,70508-3256,Proprietary  ,47,128,175,95,233,328
03294306,BLUE CLIFF COLLEGE - SHREVEPORT         ,LA,71105-6520,Proprietary  ,46,220,266,64,305,369
03332600,DELTA COLLEGE                           ,LA,70433-9042,Proprietary  ,52,157,209,101,245,346
03332601,DELTA COLLEGE - SLIDELL                 ,LA,70460-2624,Proprietary  ,53,168,221,89,319,408
03356300,MEDICAL TRAINING COLLEGE                ,LA,70816-5820,Proprietary  ,60,141,201,105,218,323
03480300,FORTIS COLLEGE - BATON ROUGE            ,LA,70809-1908,Proprietary  ,85,284,369,105,383,488
03498400,OMEGA INSTITUTE OF COSMETOLOGY          ,LA,70360-0000,Proprietary  ,28,16,44,40,34,74
03727500,MOORE CAREER COLLEGE                    ,LA,70808-4191,Proprietary  ,15,54,69,24,70,94
03730300,BATON ROUGE COMMUNITY COLLEGE           ,LA,78806-4129,Public       ,2561,2701,5262,4404,4858,9262
03789300,UNITECH TRAINING ACADEMY                ,LA,70503-5132,Proprietary  ,147,410,557,193,524,717
03789301,UNITECH TRAINING ACADEMY - WEST MONROE  ,LA,71291-2913,Proprietary  ,55,231,286,77,333,410
03789302,UNITECH TRAINING ACADEMY - HOUMA        ,LA,70363-5556,Proprietary  ,41,91,132,55,131,186
03789303,UNITECH TRAINING ACADEMY -  ALEXANDRIA  ,LA,71303-3625,Proprietary  ,69,177,246,89,221,310
03789304,UNITECH TRAINING ACADEMY - LAKE CHARLES ,LA,70601-7887,Proprietary  ,76,193,269,98,246,344
03789400,RIVER PARISHES COMMUNITY COLLEGE        ,LA,70778-0310,Public       ,405,390,795,694,657,1351
03795300,CASSIA BEAUTY COLLEGE                   ,LA,70126-0000,Proprietary  ,7,26,33,20,52,72
03810500,COURT REPORTING INSTITUTE OF LOUISI     ,LA,70816-0000,Proprietary  ,3,20,23,9,43,52
03956300,SOUTH LOUISIANA COMMUNITY COLLEGE       ,LA,70506-0000,Public       ,1738,1672,3410,2911,3270,6181
04040300,COMPASS CAREER COLLEGE                  ,LA,70403-0653,Proprietary  ,77,145,222,115,233,348
04112300,LOUISIANA CULINARY INSTITUTE            ,LA,70816-4109,Proprietary  ,98,113,211,189,227,416
04130100,LOUISIANA DELTA COMMUNITY COLLEGE       ,LA,71203-3618,Public       ,863,1256,2119,1432,2299,3731
04149500,A & W HEALTHCARE EDUCATORS              ,LA,70122-3146,Proprietary  ,21,119,140,31,231,262
04151600,MY-LE'S BEAUTY COLLEGE                  ,LA,70056-3150,Proprietary  ,10,35,45,17,48,65
04217000,HEALTHCARE TRAINING INSTITUTE           ,LA,70062-7630,Proprietary  ,8,78,86,17,117,134
04225900,SETTING THE STANDARD BARBERING AND NATUR,LA,71109-4124,Proprietary  ,2,9,11,3,20,23
04226000,BOS-MAN'S BARBER COLLEGE                ,LA,71106-2653,Proprietary  ,13,30,43,19,56,75
04234600,PARK PLACE PREMIER BARBER SCHOOL        ,LA,70122-3808,Proprietary  ,5,32,37,14,61,75
04245400,INFINITY COLLEGE                        ,LA,70501-8833,Proprietary  ,6,10,16,6,10,16
00143600,CAPITOL COLLEGE                         ,MD,20708-9759,Private      ,57,153,210,443,437,880
00205700,ALLEGANY COLLEGE OF MARYLAND            ,MD,21502-2596,Public       ,460,532,992,2289,1445,3734
00205800,ANNE ARUNDEL COMMUNITY COLLEGE          ,MD,21012-1895,Public       ,894,1841,2735,3831,5531,9362
00206100,BALTIMORE CITY COMMUNITY COLLEGE        ,MD,21215-7893,Public       ,612,2039,2651,2856,6672,9528
00206200,BOWIE STATE UNIVERSITY                  ,MD,20715-9465,Public       ,976,1325,2301,6465,4636,11101
00206300,COMMUNITY COLLEGE OF BALTIMORE COUNTY   ,MD,21228-5381,Public       ,1606,3671,5277,7450,11670,19120
00206400,COLLEGE OF SOUTHERN MARYLAND            ,MD,20646-0910,Public       ,763,1191,1954,2986,3366,6352
00206500,NOTRE DAME OF MARYLAND UNIVERSITY       ,MD,21210-2476,Private      ,61,366,427,971,1574,2545
00206700,WASHINGTON ADVENTIST UNIVERSITY         ,MD,20912-7796,Private      ,131,221,352,578,617,1195
00206800,COPPIN STATE UNIVERSITY                 ,MD,21216-3698,Public       ,431,1166,1597,3216,4357,7573
00207100,FREDERICK COMMUNITY COLLEGE             ,MD,21702-9745,Public       ,436,789,1225,1749,2017,3766
00207200,FROSTBURG STATE UNIVERSITY              ,MD,21532-1099,Public       ,512,434,946,6323,1670,7993
00207300,GOUCHER COLLEGE                         ,MD,21204-2794,Private      ,302,160,462,3038,691,3729
00207400,HAGERSTOWN COMMUNITY COLLEGE            ,MD,21742-6514,Public       ,437,729,1166,1607,1956,3563
00207500,HARFORD COMMUNITY COLLEGE               ,MD,21015-1696,Public       ,644,857,1501,2152,2180,4332
00207600,HOOD COLLEGE                            ,MD,21701-8575,Private      ,172,177,349,2062,654,2716
00207700,JOHNS HOPKINS UNIVERSITY                ,MD,21218-2693,Private      ,463,576,1039,9709,1991,11700
00207702,JOHNS HOPKINS UNIV SCH ARTS/SCI/ENG     ,MD,21218-0000,Private      ,735,719,1454,5243,1784,7027
00207703,JOHNS HOPKINS UNIV SCH OF BUS/ED        ,MD,21046-0000,Private      ,16,496,512,71,1100,1171
00207705,JOHNS HOPKINS BLOOMBERG SCH OF PH       ,MD,21205-0000,Private      ,12,319,331,75,1510,1585
00207706,JOHNS HOPKINS UNIV SCH OF MEDICINE      ,MD,21205-0000,Private      ,51,141,192,298,923,1221
00207707,JOHNS HOPKINS UNIV SCH OF NURSING       ,MD,21205-0000,Private      ,36,267,303,286,1466,1752
00207708,JOHNS HOPKINS UNIV PEABODY CONSERV      ,MD,21202-2397,Private      ,50,65,115,492,382,874
00207764,JOHNS HOPKINS UNIVERSITY - CAREY BUSINES,MD,21202-4649,Private      ,5,302,307,49,685,734
00207800,LOYOLA UNIVERSITY MARYLAND              ,MD,21210-2699,Private      ,706,648,1354,9464,2275,11739
00208000,MARYLAND INST COLLEGE OF ART            ,MD,21217-4191,Private      ,208,179,387,2458,850,3308
00208300,MORGAN STATE UNIVERSITY                 ,MD,21251-0002,Public       ,1367,1450,2817,9825,5548,15373
00208600,MOUNT SAINT MARY'S UNIVERSITY           ,MD,21727-7799,Private      ,200,104,304,3848,438,4286
00208700,NER ISRAEL RABBINICAL COLLEGE           ,MD,21208-1198,Private      ,12,7,19,69,32,101
00208900,PRINCE GEORGES COMMUNITY COLLEGE        ,MD,20774-2199,Public       ,1366,2932,4298,5413,8364,13777
00209100,SALISBURY UNIVERSITY                    ,MD,21801-6862,Public       ,897,461,1358,10657,2276,12933
00209200,ST JOHN'S COLLEGE                       ,MD,21404-0000,Private      ,33,38,71,487,131,618
00209500,ST. MARY'S COLLEGE OF MARYLAND          ,MD,20686-3001,Public       ,168,69,237,2384,300,2684
00209600,ST MARY'S SEMINARY & UNIV               ,MD,21210-1994,Private      ,6,12,18,24,54,78
00209900,TOWSON UNIVERSITY                       ,MD,21252-0002,Public       ,1649,1531,3180,21960,7686,29646
00210200,UNIVERSITY OF BALTIMORE                 ,MD,21201-5779,Public       ,321,1605,1926,2129,6187,8316
00210300,"UNIVERSITY OF MARYLAND, COLLEGE PARK    ",MD,20742-5145,Public       ,2076,2763,4839,33406,11276,44682
00210400,"UNIVERSITY OF MARYLAND, BALTIMORE       ",MD,21201-1691,Public       ,438,1853,2291,4592,9381,13973
00210500,UMBC                                    ,MD,21250-0002,Public       ,866,1188,2054,10526,5105,15631
00210600,UNIVERSITY MARYLAND EASTERN SHORE       ,MD,21853-4053,Public       ,769,414,1183,5386,2060,7446
00210700,STEVENSON UNIVERSITY                    ,MD,21153-0641,Private      ,365,391,756,6433,1722,8155
00210800,WASHINGTON COLLEGE                      ,MD,21620-1197,Private      ,153,16,169,2965,112,3077
00210900,MCDANIEL COLLEGE                        ,MD,21157-4390,Private      ,143,137,280,3117,637,3754
00458612,KAPLAN COLLEGE                          ,MD,21742-2797,Proprietary  ,54,435,489,140,1268,1408
00465000,CHESAPEAKE COLLEGE                      ,MD,21679-0008,Public       ,264,398,662,1091,1124,2215
00691100,MONTGOMERY COLLEGE                      ,MD,20850-1195,Public       ,2780,3492,6272,10412,9620,20032
00734100,INTERNATIONAL BEAUTY SCHOOL             ,MD,21502-2370,Proprietary  ,0,1,1,4,12,16
00744700,DEL-MAR-VA BEAUTY ACADEMY               ,MD,21804-0000,Proprietary  ,12,34,46,32,82,114
00749100,TESST COLLEGE OF TECHNOLOGY             ,MD,21227-1063,Proprietary  ,67,278,345,205,781,986
00793600,LINCOLN TECHNICAL INSTITUTE             ,MD,21046-1544,Proprietary  ,180,284,464,337,502,839
00817500,HOWARD COMMUNITY COLLEGE                ,MD,21044-3197,Public       ,718,1252,1970,3451,3818,7269
00826300,AWARD BEAUTY SCHOOL                     ,MD,21740-5624,Proprietary  ,13,53,66,26,77,103
00830800,CECIL COLLEGE                           ,MD,21901-1999,Public       ,263,379,642,1008,1045,2053
00907906,EVEREST COLLEGE- EVEREST INSTITUTE      ,MD,20910-3737,Proprietary  ,0,0,0,38,159,197
01001400,GARRETT COMMUNITY COLLEGE               ,MD,21541-1265,Public       ,142,73,215,771,248,1019
01031900,FORTIS INSTITUTE                        ,MD,21204-2538,Proprietary  ,235,816,1051,423,1725,2148
01041000,TESST COLLEGE OF TECHNOLOGY             ,MD,21286-2201,Proprietary  ,32,139,171,87,337,424
01164400,UNIV OF MARYLAND UNIVERSITY COLLEGE     ,MD,20783-8078,Public       ,555,10614,11169,2147,27176,29323
01164402,U OF MD UNIVERSITY COLLEGE - EUROPE     ,MD,20832-0000,Public       ,38,252,290,341,659,1000
01164404,U OF MD UNIVERSITY COLLEGE - ASIA       ,MD,31207-0000,Public       ,24,266,290,90,673,763
02073900,WOR-WIC COMMUNITY COLLEGE               ,MD,21804-0000,Public       ,241,531,772,1234,1683,2917
02083600,TESST COLLEGE OF TECHNOLOGY             ,MD,20705-2698,Proprietary  ,48,170,218,91,291,382
02127900,SOJOURNER DOUGLASS COLLEGE              ,MD,21205-0000,Private      ,9,118,127,53,659,712
02155100,MARYLAND COLLEGE OF ART AND DESIGN      ,MD,20902-0000,Private      ,24,35,59,98,105,203
02269700,"COLORLAB ACADEMY OF HAIR, THE           ",MD,21014-3639,Proprietary  ,8,15,23,20,45,65
02331000,MARYLAND BEAUTY ACADEMY OF ESSEX        ,MD,21221-0000,Proprietary  ,14,58,72,49,121,170
02333000,HAIR ACADEMY                            ,MD,20784-0000,Proprietary  ,25,202,227,54,249,303
02343800,MONTGOMERY BEAUTY SCHOOL                ,MD,20901-0000,Proprietary  ,23,49,72,68,121,189
02494700,BALTIMORE STUDIO OF HAIR DESIGN         ,MD,21201-0000,Proprietary  ,15,72,87,66,167,233
02495000,ROBERT PAUL ACAD COSMTGY ARTS & SCI     ,MD,21093-0000,Proprietary  ,13,25,38,26,46,72
02495100,MARYLAND BEAUTY ACADEMY                 ,MD,21136-0000,Proprietary  ,4,19,23,14,37,51
02545400,NORTH AMERICAN TRADE SCHOOLS            ,MD,21244-0069,Proprietary  ,55,267,322,108,501,609
02573800,"L' ACADEMIE DE CUISINE, INC.            ",MD,20877-0000,Proprietary  ,19,73,92,52,172,224
02578400,MARYLAND UNIVERSITY OF INTEGRATIVE HEALT,MD,20723-6010,Private      ,5,206,211,27,551,578
03027200,BLADES SCHOOL OF HAIR DESIGN            ,MD,20619-0226,Proprietary  ,15,26,41,31,65,96
03064900,AARON'S ACADEMY OF BEAUTY               ,MD,20602-2715,Proprietary  ,4,39,43,27,88,115
03097200,AESTHETICS INSTITUTE OF COSMETOLOGY     ,MD,20877-1305,Proprietary  ,4,22,26,13,56,69
03100700,CARROLL COMMUNITY COLLEGE               ,MD,21157-6913,Public       ,189,355,544,1014,989,2003
03148300,AMERICAN BEAUTY ACADEMY                 ,MD,20902-1911,Proprietary  ,49,183,232,84,243,327
03296300,BALTIMORE SCHOOL OF MASSAGE             ,MD,21090-2261,Proprietary  ,29,137,166,62,255,317
03327300,NEW CREATIONS ACADEMY OF HAIR DSN       ,MD,20746-0000,Proprietary  ,14,103,117,34,123,157
03493300,ALL-STATE CAREER SCHOOL                 ,MD,21224-6658,Proprietary  ,132,572,704,262,1035,1297
03667300,FAITH THEOLOGICAL SEMINARY              ,MD,21212-2624,Private      ,0,49,49,3,120,123
03822400,MAPLE SPRINGS BAPTIST BIBLE COLLEGE & SE,MD,20743-5711,Private      ,2,11,13,5,33,38
03937300,YESHIVA COLLEGE OF THE NATION'S CAPITAL ,MD,20902-1700,Private      ,7,10,17,8,22,30
03965500,HAIR EXPRESSIONS ACADEMY                ,MD,20852-1729,Proprietary  ,49,84,133,74,152,226
04139700,FREDERICK SCHOOL OF COSMETOLOGY         ,MD,21701-0000,Proprietary  ,6,20,26,17,45,62
04141600,OMEGA STUDIOS' SCHOOL OF APPLIED RECORDI,MD,20852-1731,Proprietary  ,19,39,58,35,82,117
04151800,TEMPLE (THE): A PAUL MITCHELL PARTNER SC,MD,21701-5409,Proprietary  ,47,77,124,107,142,249
04167602,FINGER LAKES SCHOOL OF MASSAGE (THE)    ,MD,21701-3030,Proprietary  ,5,33,38,14,64,78
04168900,HOLISTIC MASSAGE TRAINING INSTITUTE     ,MD,21218-2407,Proprietary  ,6,41,47,14,109,123
04171501,COSMOPOLITAN BEAUTY & TECH SCHOOL -     ,MD,20143-3370,Proprietary  ,3,23,26,16,48,64
04188400,BAIS HAMEDRASH AND MESIVTA OF BALTIMORE ,MD,21209-1613,Private      ,4,3,7,34,10,44
04204000,ASPEN BEAUTY ACADEMY - LAUREL           ,MD,20724-2013,Proprietary  ,7,30,37,24,75,99
04209600,INSTITUTE OF HEALTH SCIENCES            ,MD,21031-1408,Proprietary  ,5,57,62,19,127,146
04211700,HARMON'S BEAUTY SCHOOL                  ,MD,20785-2135,Proprietary  ,8,28,36,19,51,70
00211400,AMERICAN INTERNATIONAL COLLEGE          ,MA,01109-3189,Private      ,438,975,1413,2017,2160,4177
00211500,AMHERST COLLEGE                         ,MA,01002-5000,Private      ,436,71,507,4449,266,4715
00211600,ANDOVER NEWTON THEOLOGICAL SCHOOL       ,MA,02459-0000,Private      ,0,85,85,0,149,149
00211700,ANNA MARIA COLLEGE                      ,MA,01612-1198,Private      ,266,208,474,1568,479,2047
00211800,ASSUMPTION COLLEGE                      ,MA,01615-1294,Private      ,405,240,645,4566,716,5282
00212000,MERRIMACK COLLEGE                       ,MA,01845-5800,Private      ,638,233,871,6582,615,7197
00212100,BABSON COLLEGE                          ,MA,02457-0310,Private      ,325,147,472,2990,403,3393
00212200,BAY PATH COLLEGE                        ,MA,01106-2212,Private      ,205,1100,1305,1107,2322,3429
00212300,BECKER COLLEGE-WORCESTER                ,MA,01615-0071,Private      ,417,365,782,2789,879,3668
00212400,BENTLEY UNIVERSITY                      ,MA,02452-4705,Private      ,576,189,765,6290,551,6841
00212600,BERKLEE COLLEGE OF MUSIC                ,MA,02215-3693,Private      ,772,556,1328,3823,1420,5243
00212800,BOSTON COLLEGE                          ,MA,02467-3800,Private      ,1354,913,2267,17463,4787,22250
00212900,BOSTON CONSERVATORY OF MUSIC            ,MA,02215-9830,Private      ,113,73,186,1056,332,1388
00213000,BOSTON UNIVERSITY                       ,MA,02215-1789,Private      ,2897,3668,6565,36105,13671,49776
00213300,BRANDEIS UNIVERSITY                     ,MA,02453-2728,Private      ,810,311,1121,6142,1146,7288
00213900,CLARK UNIVERSITY                        ,MA,01610-1473,Private      ,441,172,613,4738,628,5366
00214000,ELMS COLLEGE                            ,MA,01013-2839,Private      ,158,326,484,1256,1018,2274
00214100,COLLEGE OF THE HOLY CROSS               ,MA,01610-2395,Private      ,511,33,544,5236,155,5391
00214300,CURRY COLLEGE                           ,MA,02186-2395,Private      ,638,422,1060,4962,1014,5976
00214400,DEAN COLLEGE                            ,MA,02038-1994,Private      ,322,96,418,1628,255,1883
00214500,EASTERN NAZARENE COLLEGE                ,MA,02170-2999,Private      ,192,193,385,759,457,1216
00214507,EASTERN NAZARENE COLLEGE - OLD COLONY CA,MA,02170-3831,Private      ,0,0,0,3,5,8
00214600,EMERSON COLLEGE                         ,MA,02116-4624,Private      ,811,260,1071,7224,1162,8386
00214700,EMMANUEL COLLEGE                        ,MA,02115-5798,Private      ,253,107,360,5054,371,5425
00214800,ENDICOTT COLLEGE                        ,MA,01915-2098,Private      ,355,345,700,5093,681,5774
00214900,EPISCOPAL DIVINITY SCHOOL               ,MA,02138-0000,Private      ,0,23,23,0,44,44
00215000,FISHER COLLEGE                          ,MA,02116-1500,Private      ,364,467,831,1428,1052,2480
00215100,BENJAMIN FRANKLIN INSTITUTE OF TECH     ,MA,02116-6296,Public       ,203,173,376,561,309,870
00215300,GORDON COLLEGE                          ,MA,01984-1899,Private      ,433,65,498,2167,151,2318
00215400,HELLENIC COLLEGE                        ,MA,02445-7496,Private      ,27,59,86,68,104,172
00215500,HARVARD UNIVERSITY                      ,MA,02138-3800,Private      ,149,142,291,3418,615,4033
00215501,AMRCN REPERTORY THTR INST ADV THTR      ,MA,02138-0000,Private      ,0,13,13,1,89,90
00215502,HARVARD BUSINESS SCHOOL                 ,MA,02163-0000,Private      ,30,497,527,216,1361,1577
00215503,HARVARD EXTENSION SCHOOL                ,MA,02138-0000,Private      ,68,612,680,177,1407,1584
00215504,HARVARD SCH OF DENTAL MEDICINE          ,MA,02115-0000,Private      ,2,53,55,14,152,166
00215505,HARVARD UNIV GRAD SCH DESIGN            ,MA,02138-0000,Private      ,3,170,173,11,839,850
00215506,HARVARD DIVINITY SCHOOL                 ,MA,02138-0000,Private      ,3,97,100,18,461,479
00215507,HARVARD UNIV GRAD SCH ED                ,MA,02138-0000,Private      ,3,112,115,11,1088,1099
00215508,HARVARD UNIV GRAD S OF ARTS & SCIEN     ,MA,02138-0000,Private      ,4,65,69,58,558,616
00215509,HARVARD KENNEDY SCHOOL                  ,MA,02138-0000,Private      ,6,130,136,15,1173,1188
00215510,HARVARD LAW SCHOOL                      ,MA,02138-0000,Private      ,18,890,908,100,2720,2820
00215511,HARVARD UNIV MEDICAL SCHOOL             ,MA,02115-0000,Private      ,28,302,330,133,924,1057
00215512,HARVARD UNIV SCH PUBLIC HEALTH          ,MA,02115-0000,Private      ,11,102,113,28,854,882
00215513,HARVARD UNIVERSITY-HARVARD COLLEGE      ,MA,02138-0000,Private      ,1632,285,1917,20446,1318,21764
00215700,HEBREW COLLEGE                          ,MA,02459-2237,Private      ,0,29,29,1,106,107
00215800,LASELL COLLEGE                          ,MA,02466-2716,Private      ,383,166,549,3048,447,3495
00216000,LESLEY UNIVERSITY                       ,MA,02138-2790,Private      ,391,1168,1559,2861,2542,5403
00216100,UMASS LOWELL                            ,MA,01854-3089,Public       ,1926,1850,3776,14634,4869,19503
00216400,NEW ENGLAND COLLEGE OF OPTOMETRY        ,MA,02115-1129,Private      ,1,112,113,9,444,453
00216500,MASS. COLLEGE OF PHARMACY  & HEALTH SCIE,MA,02115-5804,Private      ,314,838,1152,5366,3876,9242
00216700,BERKSHIRE COMMUNITY COLLEGE             ,MA,01201-5786,Public       ,453,641,1094,824,1025,1849
00216800,CAPE COD COMMUNITY COLLEGE              ,MA,02668-1599,Public       ,441,735,1176,1059,1359,2418
00216900,GREENFIELD COMMUNITY COLLEGE            ,MA,01301-9739,Public       ,256,477,733,642,993,1635
00217000,HOLYOKE COMMUNITY COLLEGE               ,MA,01040-1099,Public       ,1314,1605,2919,3016,3125,6141
00217100,MASSACHUSETTS BAY COMMUNITY COLLEGE     ,MA,02181-0000,Public       ,685,956,1641,1612,1820,3432
00217200,MOUNT WACHUSETT COMMUNITY COLLEGE       ,MA,01440-1000,Public       ,685,1126,1811,1591,2382,3973
00217300,NORTH SHORE COMMUNITY COLLEGE           ,MA,01923-4093,Public       ,1216,1723,2939,2520,3017,5537
00217400,NORTHERN ESSEX COMMUNITY COLLEGE        ,MA,01830-2399,Public       ,1157,1448,2605,2457,2788,5245
00217500,QUINSIGAMOND COMMUNITY COLLEGE          ,MA,01606-2092,Public       ,1220,1950,3170,3364,4258,7622
00217600,BRISTOL COMMUNITY COLLEGE               ,MA,02720-7399,Public       ,1488,2025,3513,3570,4239,7809
00217700,MASSASOIT COMMUNITY COLLEGE             ,MA,02302-3996,Public       ,1126,1573,2699,2716,3088,5804
00217800,MASSACHUSETTS INST OF TECHNOLOGY        ,MA,02139-4307,Private      ,932,531,1463,11760,2222,13982
00218000,MASSACHUSETTS COLLEGE OF ART AND DESIGN ,MA,02115-5803,Public       ,331,178,509,2216,623,2839
00218100,MASSACHUSETTS MARITIME ACADEMY          ,MA,02532-3400,Public       ,525,59,584,1700,141,1841
00218300,BRIDGEWATER STATE UNIVERSITY            ,MA,02325-0001,Public       ,1565,1085,2650,11070,3288,14358
00218400,FITCHBURG STATE UNIVERSITY              ,MA,01420-2697,Public       ,629,429,1058,6249,1421,7670
00218500,FRAMINGHAM STATE COLLEGE                ,MA,01702-2471,Public       ,714,463,1177,6521,1383,7904
00218700,MASSACHUSETTS CLG OF LIBERAL ARTS       ,MA,01247-4100,Public       ,245,148,393,2417,467,2884
00218800,SALEM STATE UNIVERSITY                  ,MA,01970-5353,Public       ,1266,1207,2473,8769,3405,12174
00218900,WESTFIELD STATE UNIVERSITY              ,MA,01086-1630,Public       ,934,531,1465,7809,1693,9502
00219000,WORCESTER STATE COLLEGE                 ,MA,01602-2597,Public       ,652,603,1255,6188,2173,8361
00219200,MOUNT HOLYOKE COLLEGE                   ,MA,01075-1492,Private      ,457,98,555,2686,352,3038
00219300,MOUNT IDA COLLEGE                       ,MA,02459-3323,Private      ,303,109,412,1833,368,2201
00219400,NEW ENGLAND CONSERVATORY OF MUSIC       ,MA,02115-5018,Private      ,31,39,70,680,551,1231
00219700,NICHOLS COLLEGE                         ,MA,01571-6346,Private      ,323,84,407,2096,274,2370
00219900,NORTHEASTERN UNIVERSITY                 ,MA,02115-5000,Private      ,2619,3228,5847,30693,9753,40446
00220100,PINE MANOR COLLEGE                      ,MA,02167-0000,Private      ,110,44,154,420,116,536
00220500,QUINCY COLLEGE                          ,MA,02169-4324,Public       ,626,1468,2094,1411,2861,4272
00220600,REGIS COLLEGE                           ,MA,02193-0000,Private      ,275,314,589,2008,736,2744
00220800,SIMMONS COLLEGE                         ,MA,02115-5898,Private      ,243,1439,1682,3454,4660,8114
00220900,SMITH COLLEGE                           ,MA,01063-2936,Private      ,248,77,325,3769,452,4221
00220901,"SMITH COLLEGE, SCH FOR SOCIAL WORK      ",MA,01063-0000,Private      ,0,27,27,13,465,478
00221000,UNIV OF MASSACHUSETTS-DARTMOUTH         ,MA,02747-2300,Public       ,888,747,1635,11454,3139,14593
00221100,SPRINGFIELD COLLEGE                     ,MA,01109-3797,Private      ,543,1197,1740,4565,3051,7616
00221400,ST JOHN'S SEMINARY                      ,MA,02135-8839,Private      ,1,17,18,1,26,27
00221700,STONEHILL COLLEGE                       ,MA,02357-6110,Private      ,271,36,307,5561,186,5747
00221800,SUFFOLK UNIVERSITY                      ,MA,02108-2770,Private      ,1175,1092,2267,7403,3521,10924
00221900,TUFTS UNIVERSITY                        ,MA,02155-5808,Private      ,955,433,1388,10642,2016,12658
00221901,TUFTS UNIV SCH OF DENTAL MEDICINE       ,MA,02111-0000,Private      ,2,368,370,19,854,873
00221902,TUFTS UNIVERSITY - CUMMINGS SCHOOL OF VE,MA,01536-0000,Private      ,0,107,107,27,479,506
00221904,TUFTS UNIV SCHOOL OF MEDICINE           ,MA,02111-0000,Private      ,15,325,340,74,1929,2003
00222100,UNIV OF MASSACHUSETTS-AMHERST           ,MA,01003-0000,Public       ,2898,1774,4672,39118,6263,45381
00222200,UNIV OF MASSACHUSETTS-BOSTON            ,MA,02125-3393,Public       ,2368,3497,5865,12558,8615,21173
00222400,WELLESLEY COLLEGE                       ,MA,02481-8203,Private      ,597,59,656,3366,207,3573
00222500,WENTWORTH INSTITUTE OF TECHNOLOGY       ,MA,02115-5998,Private      ,744,266,1010,6350,764,7114
00222600,WESTERN NEW ENGLAND UNIVERSITY          ,MA,01119-2654,Private      ,738,496,1234,5849,1444,7293
00222700,WHEATON COLLEGE                         ,MA,02766-2322,Private      ,338,24,362,2624,84,2708
00222800,WHEELOCK COLLEGE                        ,MA,02215-4176,Private      ,228,241,469,1461,656,2117
00222900,WILLIAMS COLLEGE                        ,MA,01267-2600,Private      ,509,17,526,3698,135,3833
00223300,WORCESTER POLYTECHNIC INSTITUTE         ,MA,01609-2280,Private      ,558,146,704,8012,552,8564
00267104,BARD COLLEGE - LONGY SCHOOL OF MUSIC    ,MA,02138-3599,Private      ,8,25,33,24,124,148
00396500,BAY STATE COLLEGE                       ,MA,02116-2901,Proprietary  ,192,359,551,876,1018,1894
00396600,BOSTON ARCHITECTURAL COLLEGE            ,MA,02115-2795,Private      ,51,241,292,206,471,677
00466100,HAMPSHIRE COLLEGE                       ,MA,01002-3359,Private      ,429,55,484,2076,172,2248
00466600,SALTER COLLEGE                          ,MA,01583-1700,Proprietary  ,188,839,1027,236,1160,1396
00466700,SCHOOL OF MUSEUM OF FINE ARTS           ,MA,02115-5534,Private      ,95,74,169,390,224,614
00466900,UPPER CAPE COD REGIONAL VOC TECH        ,MA,02532-3310,Public       ,14,57,71,18,124,142
00527900,GREATER LOWELL REGNL VOC TECH SCH       ,MA,01879-0000,Public       ,11,54,65,22,105,127
00551900,DIMAN REGIONAL VOC TECH INST            ,MA,02723-3519,Public       ,16,64,80,37,133,170
00552300,BLUE HILLS REGIONAL VOC TECH            ,MA,02021-1398,Public       ,11,75,86,20,126,146
00555700,MCCANN TECHNICAL SCHOOL                 ,MA,01247-0000,Public       ,16,24,40,23,40,63
00613600,NATIONAL AVIATION ACADEMY - NEW ENGLAND ,MA,01730-2620,Proprietary  ,35,62,97,69,163,232
00632200,BROCKTON HOSPITAL SCH OF NURSING        ,MA,02302-0000,Private      ,32,196,228,119,468,587
00632400,LABOURE COLLEGE                         ,MA,02124-0000,Private      ,68,432,500,197,872,1069
00633100,LAWRENCE MEM HOSPITAL SCH OF NRSNG      ,MA,02155-1643,Private      ,28,135,163,58,291,349
00635200,BAYSTATE MEDICAL CENTER                 ,MA,01199-0001,Private      ,8,28,36,31,68,99
00687300,MARIAN COURT COLLEGE                    ,MA,01907-2896,Private      ,23,38,61,65,82,147
00748400,NEWBURY COLLEGE                         ,MA,02445-5796,Private      ,266,80,346,1680,260,1940
00748600,THE NEW ENGLAND INSTITUTE OF ART        ,MA,02445-7295,Proprietary  ,136,97,233,422,217,639
00807800,SPRINGFIELD TECHNICAL COMMUNITY CLG     ,MA,01105-0000,Public       ,1307,1812,3119,2822,3552,6374
00809002,EVEREST COLLEGE - EVEREST INSTITUTE     ,MA,02150-2333,Proprietary  ,1,20,21,8,40,48
00891600,NEW ENGLAND SCHOOL OF LAW               ,MA,02116-0000,Private      ,5,357,362,14,1135,1149
00964500,BARD COLLEGE AT SIMON'S ROCK            ,MA,01230-9702,Private      ,104,4,108,312,9,321
00974700,GORDON-CONWELL THEOLOGICAL SEMINARY     ,MA,01982-0000,Private      ,0,179,179,5,375,380
00975600,UNIVERSITY OF MASS MEDICAL CENTER       ,MA,01655-0000,Public       ,7,281,288,39,734,773
00987700,HENRI'S SCHOOL OF HAIR DESIGN           ,MA,01420-5675,Proprietary  ,3,2,5,7,8,15
00989900,LOWELL ACADEMY HAIRSTYLING INST         ,MA,01852-1909,Proprietary  ,16,24,40,24,47,71
00993600,MIDDLESEX COMMUNITY COLLEGE             ,MA,01730-1197,Public       ,551,599,1150,1380,1181,2561
00993602,"MIDDLESEX COMMUNITY COLLEGE, LOWELL     ",MA,01852-0000,Public       ,928,1042,1970,2227,2076,4303
01121000,BUNKER HILL COMMUNITY COLLEGE           ,MA,02129-2991,Public       ,2568,4381,6949,5245,7721,12966
01193000,ROXBURY COMMUNITY COLLEGE               ,MA,02120-3400,Public       ,341,1135,1476,693,2033,2726
01204200,MANSFIELD BEAUTY SCHOOLS                ,MA,02169-5061,Proprietary  ,8,19,27,14,47,61
01206800,MANSFIELD BEAUTY SCHOOL                 ,MA,01103-1410,Proprietary  ,6,18,24,8,29,37
01218700,BLACKSTONE VALLEY VOCATIONAL REGIONAL SC,MA,01568-1499,Public       ,4,26,30,12,45,57
01238600,SOUTHEASTERN TECHNICAL INSTITUTE        ,MA,02375-1780,Public       ,24,78,102,45,130,175
01246108,LINCOLN TECHNICAL INSTITUTE - BROCKTON  ,MA,02401-1818,Proprietary  ,44,112,156,85,220,305
01246114,LINCOLN TECHNICAL INSTITUTE - LOWELL    ,MA,01852-5119,Proprietary  ,45,93,138,95,231,326
01246115,LINCOLN TECHNICAL INSTITUTE - SOMERVILLE,MA,02145-1102,Proprietary  ,34,102,136,89,217,306
01288100,MONTACHUSETT REG VOC TECH SCH           ,MA,01420-4649,Public       ,10,33,43,21,72,93
01294800,ROB ROY ACADEMY                         ,MA,02721-5330,Proprietary  ,9,18,27,19,34,53
02063000,MONTSERRAT COLLEGE OF ART               ,MA,01915-0000,Private      ,139,21,160,627,55,682
02079400,EMPIRE BEAUTY SCHOOL                    ,MA,01702-5232,Proprietary  ,223,552,775,407,970,1377
02092100,MASSACHUSETTS SCHOOL OF BARBERING       ,MA,02169-5058,Proprietary  ,4,28,32,7,60,67
02122000,NEW ENGLAND HAIR ACADEMY                ,MA,02148-0000,Proprietary  ,17,34,51,24,71,95
02137000,ROB ROY ACADEMY                         ,MA,02780-0000,Proprietary  ,11,3,14,14,14,28
02137200,MASS GEN HOSP DIETETIC INTERNSHIP       ,MA,02114-0000,Private      ,5,10,15,11,30,41
02163500,NEW ENGLAND SCHOOL OF PHOTOGRAPHY       ,MA,02215-0000,Proprietary  ,19,31,50,67,58,125
02163600,MASS SCH OF PROFESSIONAL PSYCHOLOGY     ,MA,02132-0000,Private      ,6,216,222,18,723,741
02169900,ASSABET VALLEY REGIONAL VOC SCHOOL      ,MA,01752-0000,Public       ,8,48,56,16,81,97
02181600,ROB ROY ACADEMY                         ,MA,01609-0000,Proprietary  ,18,30,48,28,45,73
02182900,CAMBRIDGE COLLEGE                       ,MA,02138-5304,Private      ,115,769,884,249,1444,1693
02197900,NORTH BENNET STREET SCHOOL              ,MA,02113-0000,Private      ,11,49,60,36,132,168
02215100,HALLMARK INSTITUTE OF PHOTOGRAPHY       ,MA,01376-0000,Proprietary  ,33,34,67,81,63,144
02219501,MILDRED ELLEY - PITTSFIELD              ,MA,01201-5300,Proprietary  ,9,27,36,15,53,68
02220400,CATHERINE HINDS INST OF ESTHETICS       ,MA,01801-0000,Proprietary  ,22,63,85,35,100,135
02231600,MGH INSTITUTE OF HEALTH PROFESSION      ,MA,02129-0000,Private      ,17,362,379,83,1286,1369
02274300,CONWAY SCHOOL OF LANDSCAPE DESIGN       ,MA,01341-0179,Private      ,0,6,6,0,23,23
02325700,LABARON HAIRDRESSING ACADEMY            ,MA,02740-0000,Proprietary  ,4,11,15,7,18,25
02325800,LABARON HAIRDRESSING ACAD-BROCKTON      ,MA,02301-0000,Proprietary  ,1,9,10,5,23,28
02337400,BANCROFT SCHOOL OF MASSAGE THERAPY      ,MA,01604-4614,Proprietary  ,9,16,25,15,37,52
02338200,BAY STATE SCHOOL OF TECHNOLOGY          ,MA,02021-0000,Proprietary  ,3,37,40,17,58,75
02339400,ROB ROY ACADEMY                         ,MA,02746-0000,Proprietary  ,1,5,6,5,11,16
02491700,CORTIVA INSTITUTE -  BOSTON             ,MA,02472-2577,Proprietary  ,2,29,31,7,38,45
02523900,ELIZABETH GRADY SCHOOL OF ESTHETICS     ,MA,02155-0000,Proprietary  ,10,41,51,27,73,100
02579800,NEW ENGLAND SCHOOL OF ACUPUNCTURE       ,MA,02458-0000,Private      ,0,55,55,0,100,100
02616704,LE CORDON BLEU COLLEGE OF CULINARY ARTS ,MA,02142-1221,Proprietary  ,28,49,77,83,128,211
03066700,AILANO SCHOOL OF COSMETOLOGY            ,MA,02303-4740,Proprietary  ,0,19,19,7,32,39
03104000,SHAWSHEEN ADULT TECHNICAL INSTITUTE     ,MA,01821-5499,Public       ,4,29,33,10,43,53
03115200,MOTORING TECHNICAL TRAINING INST        ,MA,02771-5933,Proprietary  ,30,77,107,87,151,238
03120800,KAY HARVEY HAIRDRESSING ACADEMY         ,MA,01089-2701,Proprietary  ,6,6,12,8,10,18
03130500,URBAN COLLEGE OF BOSTON                 ,MA,02111-1093,Private      ,17,337,354,41,513,554
03194300,BOSTON GRAD SCH OF PSYCHOANALYSIS       ,MA,02446-4602,Private      ,0,20,20,0,42,42
03205400,JOLIE HAIR & BEAUTY ACADEMY             ,MA,01056-2769,Proprietary  ,8,28,36,12,36,48
03235300,MASSACHUSETTS SCHOOL OF LAW             ,MA,01810-1094,Private      ,4,159,163,9,292,301
03240300,TONI & GUY HAIRDRESSING ACADEMY         ,MA,01605-2213,Proprietary  ,35,33,68,53,55,108
03240301,TONI & GUY HAIRDRESSING ACADEMY - BRAINT,MA,02184-2807,Proprietary  ,30,26,56,49,44,93
03248300,BOSTON BAPTIST COLLEGE                  ,MA,02136-4030,Private      ,28,16,44,62,34,96
03316400,FUNERAL INSTITUTE OF THE NORTHEAST      ,MA,02062-4766,Proprietary  ,12,41,53,21,77,98
03504300,NATL GRAD SCH OF QUALITY SYSTM MGMT     ,MA,02540-0000,Private      ,0,12,12,0,19,19
03570500,NORTHPOINT BIBLE COLLEGE                ,MA,01835-0000,Private      ,73,56,129,163,105,268
03763300,MEDICAL PROFESSIONAL INSTITUTE          ,MA,02148-8143,Proprietary  ,18,134,152,25,233,258
03859300,E.I.N.E.                                ,MA,01876-4709,Proprietary  ,1,15,16,2,29,31
03927303,MARINELLO SCHOOL OF BEAUTY - NORTHAMPTON,MA,01060-3947,Proprietary  ,16,25,41,28,39,67
03946300,FRANKLIN W. OLIN COLLEGE OF ENGINEERING ,MA,02492-1200,Private      ,50,5,55,641,19,660
03965300,NEW ENGLAND COLLEGE OF FINANCE          ,MA,02110-1605,Proprietary  ,19,241,260,74,719,793
04116900,DIGRIGOLI SCHOOL OF COSMETOLOGY         ,MA,01089-4623,Proprietary  ,26,22,48,43,42,85
04122000,TRI COUNTY REGIONAL VOCATIONAL TECHNICAL,MA,02038-0000,Public       ,10,27,37,20,49,69
04128000,MILLENNIUM TRAINING INSTITUTE           ,MA,01801-6386,Proprietary  ,3,36,39,4,42,46
04143200,HULT INTERNATIONAL BUSINESS SCHOOL      ,MA,02141-1805,Private      ,8,89,97,95,198,293
04153200,SOUTHERN WORCESTER COUNTY REGIONAL VOC S,MA,01507-1331,Public       ,7,19,26,12,32,44
04193100,ALEXANDER ACADEMY                       ,MA,01420-0000,Proprietary  ,11,18,29,17,31,48
04229200,JUPITER BEAUTY ACADEMY                  ,MA,02122-2834,Proprietary  ,5,11,16,10,20,30
00401200,HEBREW UNIVERSITY OF JERUSALEM (THE)    ,FC,00000-0000,Public       ,9,28,37,16,55,71
00403000,UNIVERSITY OF CAMBRIDGE                 ,FC,00000-0000,Public       ,4,42,46,7,88,95
00503400,AMERICAN UNIVERSITY OF CAIRO            ,FC,00000-0000,Private      ,11,37,48,29,77,106
00669000,UNIVERSITY OF COPENHAGEN                ,FC,00000-0000,Public       ,2,11,13,3,60,63
00669100,UNIVERSITY OF CAMBRIDGE - PEMBROKE      ,FC,00000-0000,Public       ,0,4,4,1,8,9
00669200,UNIVERSITY OF LEEDS                     ,FC,00000-0000,Public       ,2,33,35,23,94,117
00669300,UNIV OF LONDON-LONDON SCHOOL ECON       ,FC,00000-0000,Public       ,1,119,120,14,325,339
00669400,UNIVERSITY OF LONDON - SCHOOL OF ORIENTA,FC,00000-0000,Public       ,3,57,60,11,143,154
00669500,UNIV OF LONDON-UNIVERSITY COLLEGE       ,FC,00000-0000,Public       ,6,129,135,40,340,380
00669600,UNIV OF LONDON-SCH ADVANCED STUDY       ,FC,00000-0000,Public       ,0,2,2,0,9,9
00669700,"QUEEN MARY, UNIVERSITY OF LONDON        ",FC,00000-0000,Public       ,6,52,58,33,135,168
00669900,UNIVERSITY OF SUSSEX                    ,FC,00000-0000,Public       ,5,18,23,13,62,75
00670000,"UNIVERSITY OF YORK, THE                 ",FC,00000-0000,Public       ,7,42,49,23,113,136
00670400,UNIVERSITY COLLEGE CORK                 ,FC,00000-0000,Public       ,7,25,32,20,62,82
00671300,UPPSALA UNIVERSITY                      ,FC,00000-0000,Public       ,0,20,20,1,42,43
00671500,UNIVERSITY OF GENEVA                    ,FC,00000-0000,Public       ,3,27,30,5,78,83
00683900,UNIVERSITY OF EDINBURGH                 ,FC,00000-0000,Public       ,41,264,305,221,663,884
00684200,UNIVERSITY OF DUBLIN TRINITY COLLEG     ,FC,00000-0000,Public       ,14,103,117,51,211,262
00685000,UNIVERSITY OF CAMBRIDGE - DOWNING C     ,FC,00000-0000,Public       ,0,2,2,1,4,5
00763200,UNIVERSITY OF BRISTOL                   ,FC,00000-0000,Public       ,2,26,28,20,69,89
00770500,ROYAL COLLEGE OF SURGEONS IN IRELAN     ,FC,00000-0000,Private      ,2,30,32,4,51,55
00788100,AMERICAN UNIVERSITY OF PARIS            ,FC,00000-0000,Private      ,109,76,185,527,262,789
00837100,AMERICAN UNIVERSITY OF BEIRUT           ,FC,00000-0000,Private      ,16,27,43,56,54,110
00837300,TEL-AVIV UNIVERSITY                     ,FC,00000-0000,Public       ,7,30,37,26,74,100
00837600,VRIJE UNIVERSITEIT AMSTERDAM            ,FC,00000-0000,Public       ,2,16,18,6,44,50
00837700,UNIVERSITEIT VAN AMSTERDAM(UNIVERSI     ,FC,00000-0000,Public       ,5,57,62,17,136,153
00838000,UNIVERSITY OF WARWICK                   ,FC,00000-0000,Public       ,1,16,17,9,51,60
00838300,UNIVERSITY OF GLASGOW                   ,FC,00000-0000,Public       ,11,157,168,72,388,460
00839400,UNIVERSITY OF OXFORD                    ,FC,00000-0000,Public       ,5,121,126,18,232,250
00839800,UNIVERSITY OF SHEFFIELD (THE)           ,FC,00000-0000,Public       ,4,28,32,15,84,99
00839900,UNIVERSITY OF SOUTHAMPTON               ,FC,00000-0000,Public       ,4,15,19,14,50,64
00845200,ABERYSTWYTH UNIVERSITY                  ,FC,00000-0000,Public       ,7,12,19,16,33,49
00845800,LOUGHBOROUGH UNIVERSITY                 ,FC,00000-0000,Public       ,3,5,8,4,14,18
00846000,UNIVERSITY OF NEWCASTLE UPON TYNE       ,FC,00000-0000,Public       ,4,29,33,24,80,104
00846100,UNIVERSITY OF SAINT ANDREWS             ,FC,00000-0000,Private      ,67,52,119,270,130,400
00850500,UNIVERSITY OF MELBOURNE                 ,FC,00000-0000,Public       ,4,26,30,14,107,121
00858600,SWANSEA UNIVERSITY                      ,FC,00000-0000,Public       ,2,10,12,22,40,62
00858700,UNIVERSITY OF DURHAM                    ,FC,00000-0000,Public       ,5,61,66,27,147,174
00866500,UNIVERSITY OF KENT AT CANTERBURY (THE)  ,FC,00000-0000,Public       ,3,50,53,28,131,159
00867000,UNIVERSITY OF NEW SOUTH WALES           ,FC,00000-0000,Public       ,5,20,25,19,59,78
00868700,UNIVERSITY OF ESSEX                     ,FC,00000-0000,Public       ,7,42,49,30,110,140
00869300,CITY UNIVERSITY                         ,FC,00000-0000,Public       ,3,84,87,21,191,212
00890800,THE UNIVERSITY OF BIRMINGHAM            ,FC,00000-0000,Public       ,1,44,45,16,95,111
00891000,UNIVERSITY OF HULL                      ,FC,00000-0000,Public       ,0,3,3,4,8,12
00892000,UNIVERSITY OF NOTTINGHAM                ,FC,00000-0000,Public       ,3,39,42,19,91,110
00900600,UNIVERSITY OF SALFORD (THE)             ,FC,00000-0000,Public       ,0,6,6,3,18,21
00908400,"UNIV OF LONDON, BIRKBECK                ",FC,00000-0000,Public       ,1,27,28,8,75,83
00908500,UNIV OF LONDON KING'S COLLEGE           ,FC,00000-0000,Public       ,10,167,177,105,395,500
00908600,UNIVERSITY OF LONDON - ROYAL HOLLOWAY   ,FC,00000-0000,Public       ,6,18,24,33,65,98
00914300,BAR-ILAN UNIVERSITY                     ,FC,00000-0000,Private      ,4,9,13,14,18,32
00924900,UNIVERSITY OF LIVERPOOL                 ,FC,00000-0000,Public       ,4,21,25,16,65,81
00936800,UNIVERSITY OF ABERDEEN                  ,FC,00000-0000,Public       ,4,53,57,48,125,173
00942300,ROYAL COLLEGE OF ART                    ,FC,00000-0000,Public       ,1,12,13,5,44,49
00942800,TECHNION-ISRAEL INST OF TECHLGY         ,FC,00000-0000,Public       ,0,20,20,5,43,48
00944200,UNIVERSITY OF EXETER                    ,FC,00000-0000,Public       ,4,25,29,20,60,80
00944400,UNIVERSITY OF LANCASTER                 ,FC,00000-0000,Public       ,2,9,11,8,30,38
00963400,UNIVERSITY OF OXFORD ST CATHERINE'S     ,FC,00000-0000,Public       ,0,2,2,1,3,4
00980800,UNIVERSITY OF STRATHCLYDE               ,FC,00000-0000,Public       ,2,19,21,8,50,58
00986000,UNIVERSITY OF SURREY                    ,FC,00000-0000,Public       ,2,12,14,16,37,53
00992700,UNIVERSITY OF CAMBRIDGE - FITZWILLI     ,FC,00000-0000,Public       ,0,2,2,1,7,8
01006700,LUND UNIVERSITY                         ,FC,00000-0000,Public       ,3,30,33,6,88,94
01008400,UNIVERSITY OF CAPE TOWN                 ,FC,00000-0000,Public       ,2,11,13,9,42,51
01008700,UNIVERSITY OF OXFORD ST PETER'S COL     ,FC,00000-0000,Public       ,0,1,1,0,2,2
01008800,UNIVERSITY OF OXFORD - CORPUS CHRIS     ,FC,00000-0000,Public       ,0,0,0,0,2,2
01008900,CENTRAL SCHOOL OF SPEECH AND DRAMA      ,FC,00000-0000,Private      ,2,15,17,10,37,47
01009000,UNIVERSITY OF OXFORD - BALLIOL COLL     ,FC,00000-0000,Public       ,0,2,2,0,7,7
01014300,UNIVERSITY OF READING                   ,FC,00000-0000,Public       ,2,26,28,11,57,68
01015700,CARDIFF UNIVERSITY                      ,FC,00000-0000,Public       ,3,24,27,20,60,80
01016000,CG JUNG INST                            ,FC,00000-0000,Private      ,0,0,0,0,1,1
01018800,UNIVERSITY COLLEGE DUBLIN               ,FC,00000-0000,Public       ,18,104,122,77,249,326
01019000,UNIVERSITY OF CAMBRIDGE CHURCHILL C     ,FC,00000-0000,Public       ,0,0,0,1,5,6
01022800,UNIVERSITY OF STIRLING                  ,FC,00000-0000,Public       ,1,21,22,19,41,60
01033200,UNIVERSITY OF CAMBRIDGE - CLARE COL     ,FC,00000-0000,Public       ,1,2,3,2,5,7
01045600,UNIVERSITY OF HAIFA                     ,FC,00000-0000,Public       ,1,14,15,2,37,39
01047200,INST EUROPEEN OPEEN D'ADMINISTRATIO     ,FC,00000-0000,Private      ,0,19,19,0,34,34
01049300,CRANFIELD UNIVERSITY                    ,FC,00000-0000,Public       ,0,1,1,0,8,8
01052000,TRINITY LABAN CONSERVATOIRE OF MUSIC AND,FC,00000-0000,Public       ,2,8,10,7,17,24
01052500,UNIVERSITY OF HERTFORDSHIRE             ,FC,00000-0000,Public       ,3,8,11,24,26,50
01057400,LONDON INTRNTL FILM SCHOOL              ,FC,00000-0000,Private      ,0,5,5,2,12,14
01058800,AUSTRALIAN NATIONAL UNIVERSITY          ,FC,00000-0000,Public       ,2,11,13,11,32,43
01058900,BANGOR UNIVERSITY                       ,FC,00000-0000,Public       ,8,9,17,24,25,49
01059400,"RICHMOND, THE AMERICAN INT UNI IN LONDON",FC,00000-0000,Private      ,69,15,84,300,46,346
01059900,INST D'ETUDES POLITIQUES DE PARIS       ,FC,00000-0000,Public       ,1,36,37,9,101,110
01068100,MACQUARIE UNIVERSITY                    ,FC,00000-0000,Public       ,1,7,8,6,26,32
01069200,UNIVERSITY OF QUEENSLAND (THE)          ,FC,00000-0000,Public       ,4,52,56,18,145,163
01078900,UNIVERSITY OF OXFORD - WORCESTER CO     ,FC,00000-0000,Public       ,0,4,4,0,4,4
01079700,"NATIONAL UNIVERSITY OF IRELAND, MAY     ",FC,00000-0000,Public       ,2,9,11,12,23,35
01081600,KINGSTON UNIVERSITY                     ,FC,00000-0000,Public       ,15,67,82,60,171,231
01086400,UNIV OF DUNDEE                          ,FC,00000-0000,Public       ,2,6,8,6,25,31
01086600,UNIVERSITY OF OXFORD - MAGDALEN COLLEGE ,FC,00000-0000,Public       ,0,0,0,1,5,6
01086700,UNIVERSITY OF OXFORD ST JOHN'S COLL     ,FC,00000-0000,Public       ,0,1,1,0,2,2
01091400,MONASH UNIVERSITY                       ,FC,00000-0000,Public       ,1,9,10,6,25,31
01091500,UNIV OF EAST ANGLIA                     ,FC,00000-0000,Public       ,7,25,32,27,60,87
01094200,UNIVERSITY OF OXFORD - ST HUGH'S CO     ,FC,00000-0000,Public       ,1,3,4,1,6,7
01097700,UNIVERSIDAD CENTRAL DEL ESTE            ,FC,00000-0000,Private      ,6,22,28,12,72,84
01098000,SOMERVILLE COLLEGE                      ,FC,00000-0000,Public       ,0,2,2,1,3,4
01099900,UNIV OF OXFORD - WADHAM COLLEGE         ,FC,00000-0000,Public       ,0,1,1,0,4,4
01105300,UNIVERSITY OF OXFORD - ST HILDA'S C     ,FC,00000-0000,Public       ,0,4,4,0,4,4
01105400,UNIVERSITY OF OXFORD - ST ANNE'S CO     ,FC,00000-0000,Public       ,0,8,8,0,9,9
01105500,UNIV OF OXFORD - LADY MARGARET HALL     ,FC,00000-0000,Public       ,0,4,4,0,4,4
01105600,UNIVERSITY OF OXFORD - UNIVERSITY C     ,FC,00000-0000,Public       ,5,11,16,15,48,63
01105700,UNIVERSITY OF OXFORD - TRINITY COLL     ,FC,00000-0000,Public       ,1,1,2,1,2,3
01105800,UNIVERSITY OF OXFORD-ST EDMUND HALL     ,FC,00000-0000,Public       ,0,2,2,1,3,4
01105900,UNIVERSITY OF OXFORD ST ANTONY'S CO     ,FC,00000-0000,Public       ,0,13,13,0,16,16
01106000,UNIVERSITY OF OXFORD - QUEEN'S COLL     ,FC,00000-0000,Public       ,1,0,1,2,1,3
01106100,UNIVERSITY OF OXFORD - PEMBROKE COL     ,FC,00000-0000,Public       ,0,2,2,0,2,2
01106200,UNIVERSITY OF OXFORD - ORIEL COLLEG     ,FC,00000-0000,Public       ,0,1,1,1,3,4
01106300,UNIVERSITY OF OXFORD - NUFFIELD COL     ,FC,00000-0000,Public       ,0,1,1,0,3,3
01106400,UNIVERSITY OF OXFORD - NEW COLLEGE      ,FC,00000-0000,Public       ,1,2,3,3,4,7
01106500,UNIVERSITY OF OXFORD MERTON COLLEGE     ,FC,00000-0000,Public       ,2,2,4,2,7,9
01106600,UNIVERSITY OF OXFORD - LINCOLN COLL     ,FC,00000-0000,Public       ,0,4,4,0,6,6
01106700,UNIVERSITY OF OXFORD - KEBLE COLLEG     ,FC,00000-0000,Public       ,0,4,4,0,4,4
01106800,UNIVERSITY OF OXFORD - JESUS COLLEG     ,FC,00000-0000,Public       ,1,2,3,2,4,6
01106900,UNIVERSITY OF OXFORD - HERTFORD COL     ,FC,00000-0000,Public       ,0,2,2,1,6,7
01107000,UNIVERSITY OF OXFORD EXETER COLLEGE     ,FC,00000-0000,Public       ,0,2,2,0,3,3
01107100,UNIV OF OXFORD - CHRIST CHURCH          ,FC,00000-0000,Public       ,0,6,6,0,12,12
01107200,UNIVERSITY OF OXFORD - BRASENOSE CO     ,FC,00000-0000,Public       ,0,1,1,1,3,4
01109100,FLINDERS UNIVERSITY OF S AUSTRALIA      ,FC,00000-0000,Public       ,1,4,5,5,15,20
01109400,UNIVERSITY OF WESTERN AUSTRALIA (THE)   ,FC,00000-0000,Public       ,0,4,4,2,16,18
01121400,UNIVERSITY OF THE WITWATERSRAND         ,FC,00000-0000,Public       ,1,6,7,2,18,20
01122600,AARHUS UNIVERSITY                       ,FC,00000-0000,Public       ,0,11,11,2,29,31
01156700,"IMPERIAL COLLEGE OF SCIENCE, TECHNOLOGY ",FC,00000-0000,Public       ,2,28,30,14,58,72
01167900,UNIVERSITY OF BATH                      ,FC,00000-0000,Public       ,1,10,11,9,33,42
01168300,FRANKLIN COLLEGE  SWITZERLAND           ,FC,00000-0000,Private      ,25,7,32,236,32,268
01175800,UNIV OF CAMBRIDGE - PETERHOUSE          ,FC,00000-0000,Public       ,0,2,2,0,4,4
01176400,ROYAL ACADEMY OF MUSIC                  ,FC,00000-0000,Public       ,3,9,12,6,17,23
01176500,GOLDSMITHS' COLLEGE-UNIV OF LONDON      ,FC,00000-0000,Public       ,14,53,67,44,146,190
01176600,UNIV OF LONDON - INST OF EDUC           ,FC,00000-0000,Public       ,0,10,10,1,35,36
01178000,BRUNEL UNIVERSITY                       ,FC,00000-0000,Public       ,0,16,16,11,53,64
01183800,UNIVERSITY OF OXFORD - MANSFIELD CO     ,FC,00000-0000,Public       ,0,2,2,0,4,4
01207500,UNIVERSITY CAMBRIDGE - TRINITY COLL     ,FC,00000-0000,Public       ,0,0,0,1,4,5
01207800,VICTORIA UNIV OF WELLINGTON             ,FC,00000-0000,Public       ,1,14,15,6,37,43
01209600,ECOLE HÔTELIERE DE LAUSANNE             ,FC,00000-0000,Private      ,1,3,4,4,8,12
01210100,UNIVERSITY OF CAMBRIDGE - GIRTON CO     ,FC,00000-0000,Public       ,0,4,4,1,6,7
01213600,VICTORIA UNIV OF MANCHESTER (THE)       ,FC,00000-0000,Public       ,6,60,66,26,121,147
01219800,UNIVERSITY OF BRADFORD                  ,FC,00000-0000,Public       ,0,8,8,3,21,24
01220100,UNIVERSITY OF OXFORD - REGENT'S PAR     ,FC,00000-0000,Public       ,0,2,2,0,2,2
01220600,JAMES COOK UNIVERSITY                   ,FC,00000-0000,Public       ,3,20,23,11,39,50
01221500,BIRMINGHAM CITY UNIVERSITY              ,FC,00000-0000,Public       ,3,13,16,6,37,43
01222300,JAGIELLONIAN UNIVERSITY COLLEGIUM M     ,FC,00000-0000,Public       ,0,10,10,1,19,20
01225800,ASTON UNIVERSITY                        ,FC,00000-0000,Public       ,0,6,6,4,9,13
01227500,UNIVERSITY OF OXFORD - WOLFSON COLL     ,FC,00000-0000,Public       ,0,8,8,0,12,12
01230200,GONVILLE & CAIUS COLLEGE                ,FC,00000-0000,Public       ,0,1,1,0,2,2
01233500,ROYAL COLLEGE OF MUSIC                  ,FC,00000-0000,Public       ,0,7,7,3,16,19
01234100,UNIVERSITY OF WALES - ST DAVID'S UN     ,FC,00000-0000,Public       ,2,5,7,3,8,11
01242100,UNIV OF AUCKLAND                        ,FC,00000-0000,Public       ,4,22,26,19,69,88
01254000,UNIVERSIDAD DE NAVARRA                  ,FC,00000-0000,Private      ,3,13,16,9,23,32
01276500,UNIVERSITY OF OXFORD - LINACRE COLL     ,FC,00000-0000,Public       ,0,7,7,0,10,10
01276600,"NATIONAL UNIVERSITY IRELAND, GALWAY     ",FC,00000-0000,Public       ,12,49,61,26,105,131
01280200,PONTIFICIA UNIV CATOLICA MAD Y MAES     ,FC,00000-0000,Private      ,25,32,57,46,57,103
01281100,INST TECNOLOGICO DE SANTO DOMINGO       ,FC,00000-0000,Private      ,4,16,20,15,35,50
01283900,UNIVERSITY OF CAMBRIDGE - SAINT JOH     ,FC,00000-0000,Public       ,0,4,4,0,8,8
01297800,UNIVERSITY OF HUDDERSFIELD (THE)        ,FC,00000-0000,Public       ,0,6,6,5,12,17
01315300,MASSEY UNIVERSITY                       ,FC,00000-0000,Public       ,1,7,8,4,37,41
02052400,DARWIN COLLEGE                          ,FC,00000-0000,Public       ,1,2,3,1,5,6
02082400,UNIVERSITY OF CAMBRIDGE - QUEEN'S C     ,FC,00000-0000,Public       ,0,2,2,1,7,8
02083400,UNIVERSITY OF CAMBRIDGE - WOLFSON C     ,FC,00000-0000,Public       ,0,10,10,0,16,16
02087400,UNIVERSITY OF CAMBRIDGE - NEWNHAM C     ,FC,00000-0000,Public       ,0,4,4,0,4,4
02087900,OXFORD BROOKES UNIVERSITY               ,FC,00000-0000,Public       ,3,27,30,18,75,93
02094100,BEN-GURION UNIV                         ,FC,00000-0000,Public       ,0,35,35,1,85,86
02094400,UNIV OF CAMBRIDGE - ST EDMUND'S HOU     ,FC,00000-0000,Public       ,0,1,1,0,5,5
02095500,LONDON BUS SCHOOL                       ,FC,00000-0000,Public       ,1,32,33,2,68,70
02101900,ROEHAMPTON UNIVERSITY                   ,FC,00000-0000,Public       ,12,34,46,37,85,122
02108600,LONDON ACADEMY OF MUSIC & DRAMATIC      ,FC,00000-0000,Private      ,3,18,21,25,51,76
02115900,UNIVERSITY OF PORTSMOUTH                ,FC,00000-0000,Public       ,1,7,8,14,11,25
02116700,UNIVERSITY OF CAMBRIDGE - LUCY CAVE     ,FC,00000-0000,Public       ,1,4,5,1,6,7
02120000,UNIV OF LONDON - COURTALD INST OF A     ,FC,00000-0000,Public       ,0,12,12,0,28,28
02133400,UNIVERSITY OF CAMBRIDGE - SIDNEY SU     ,FC,00000-0000,Public       ,0,5,5,2,8,10
02142000,UNIVERSITY OF CAMBRIDGE - HOMERTON      ,FC,00000-0000,Public       ,0,0,0,0,1,1
02149700,UNIVERSITY OF WINCHESTER (THE)          ,FC,00000-0000,Public       ,3,0,3,12,8,20
02156800,UNIV OF OTAGO                           ,FC,00000-0000,Public       ,4,11,15,8,34,42
02162300,"IESE BUSINESS SCH, UNIV OF NAVARRA      ",FC,00000-0000,Private      ,0,23,23,2,41,43
02167400,UNIVERSITY OF CAMBRIDGE - CORPUS CH     ,FC,00000-0000,Public       ,0,2,2,0,4,4
02177700,KING'S COLLEGE- UNIV OF CAMBRIDGE       ,FC,00000-0000,Public       ,2,12,14,11,28,39
02180500,MIDDLESEX UNIVERSITY                    ,FC,00000-0000,Public       ,9,31,40,40,69,109
02183500,UNIV OF OXFORD - WYCLIFFE HALL          ,FC,00000-0000,Public       ,2,5,7,2,11,13
02186000,UNIVERSITY OF CAMBRIDGE - MAGDALENE     ,FC,00000-0000,Public       ,0,1,1,3,2,5
02186100,UNIVERSITY OF CAMBRIDGE - EMMANUEL      ,FC,00000-0000,Public       ,0,0,0,0,4,4
02194800,UNIVERSITY OF THE WEST OF ENGLAND -     ,FC,00000-0000,Public       ,2,13,15,6,23,29
02195100,UNIV OF WESTMINSTER                     ,FC,00000-0000,Public       ,12,57,69,57,131,188
02196700,GUILDHALL SCHOOL OF MUSIC & DRAMA       ,FC,00000-0000,Public       ,6,8,14,13,19,32
02207300,UNIVERSITY OF CAMBRIDGE - CHRIST'S      ,FC,00000-0000,Public       ,0,2,2,0,7,7
02207400,CHINESE UNIVERSITY OF HONG KONG (THE)   ,FC,00000-0000,Public       ,0,7,7,8,21,29
02209500,UNIVERSITEIT UTRECHT                    ,FC,00000-0000,Public       ,1,14,15,11,47,58
02210000,UNIV OF LONDON - LONDON SCHOOL OF H     ,FC,00000-0000,Public       ,0,40,40,0,81,81
02225300,UNIVERSITY OF CANTERBURY                ,FC,00000-0000,Public       ,1,4,5,3,14,17
02229100,UNIVERSITY OF LEICESTER                 ,FC,00000-0000,Public       ,4,25,29,15,85,100
02229600,SACKLER SCHOOL OF MEDICINE              ,FC,00000-0000,Public       ,0,105,105,0,141,141
02232100,UNIVERSITY OF CAMBRIDGE                 ,FC,00000-0000,Public       ,0,8,8,2,27,29
02233300,"ST GEORGE'S UNIVERSITY, SCHOOL OF MEDICI",FC,00000-0000,Proprietary  ,3,2103,2106,21,3445,3466
02235300,LONDON METROPOLITAN UNIVERSITY          ,FC,00000-0000,Public       ,5,29,34,36,57,93
02244400,AMERICAN UNIV OF THE CARIBBEAN          ,FC,00000-0000,Proprietary  ,0,288,288,7,978,985
02266600,UNIVERSITY OF LONDON - SAINT GEORGE     ,FC,00000-0000,Public       ,1,18,19,1,41,42
02271700,UNIVERSITY OF CAMBRIDGE - CLARE HAL     ,FC,00000-0000,Public       ,0,1,1,0,4,4
02271900,UNIVERSITY OF OXFORD - BLACKFRIARS      ,FC,00000-0000,Public       ,0,0,0,0,1,1
02273600,QUEEN'S UNIV OF BELFAST (THE)           ,FC,00000-0000,Public       ,2,25,27,15,62,77
02273900,HERIOT WATT UNIVERSITY                  ,FC,00000-0000,Public       ,1,10,11,6,26,32
02293400,ECOLE DES HAUTES ETUDES COMERCIALS      ,FC,00000-0000,Public       ,0,15,15,0,26,26
02296300,UNIVERSITY OF CAMBRIDGE - JESUS COL     ,FC,00000-0000,Public       ,0,3,3,0,7,7
02310500,DE MONTFORT UNIVERSITY                  ,FC,00000-0000,Public       ,0,2,2,5,7,12
02320500,ROYAL NORTHERN COLLEGE OF MUSIC         ,FC,00000-0000,Public       ,1,3,4,2,8,10
02335100,UNIV OF CAMBRIDGE - TRINITY HALL        ,FC,00000-0000,Public       ,1,3,4,2,9,11
02338900,UNIVERSITY  FOR THE CREATIVE ARTS       ,FC,00000-0000,Public       ,3,1,4,9,6,15
02351800,UNIVERSIDAD IBEROAMERICANA (UNIBE       ,FC,00000-0000,Private      ,30,172,202,64,283,347
02352100,UNIVERSITY OF PLYMOUTH                  ,FC,00000-0000,Public       ,2,6,8,14,13,27
02496700,NATIONAL FILM & TV SCHOOL               ,FC,00000-0000,Public       ,0,3,3,1,6,7
02545700,GLASGOW SCHOOL OF ART                   ,FC,00000-0000,Public       ,0,10,10,4,20,24
02561600,SOUTHAMPTON SOLENT UNIVERSITY           ,FC,00000-0000,Public       ,5,1,6,8,3,11
02579600,MURDOCH UNIVERSITY                      ,FC,00000-0000,Public       ,0,5,5,2,20,22
02588000,UNIVERSITY OF ULSTER                    ,FC,00000-0000,Public       ,1,10,11,4,19,23
02611700,DUBLIN CITY UNIVERSITY                  ,FC,00000-0000,Public       ,5,17,22,10,35,45
03012700,UNIVERSITY OF BUCKINGHAM                ,FC,00000-0000,Private      ,1,2,3,5,5,10
03029400,KEELE UNIVERSITY                        ,FC,00000-0000,Public       ,0,2,2,12,10,22
03029500,NORTHUMBRIA UNIVERSITY                  ,FC,00000-0000,Public       ,2,14,16,8,35,43
03033300,MANCHESTER METROPOLITAN UNIV            ,FC,00000-0000,Public       ,8,20,28,30,54,84
03045000,UNIVERSITY OF EAST LONDON               ,FC,00000-0000,Public       ,10,17,27,29,39,68
03050100,STUDIO ART CENTERS INTERNATIONAL        ,FC,00000-0000,Private      ,2,5,7,15,48,63
03067200,UNIVERSITY OF SYDNEY                    ,FC,00000-0000,Public       ,1,44,45,19,113,132
03073800,UNIV OF DEBRECEN MED & HEALTH SCI       ,FC,00000-0000,Public       ,0,4,4,3,10,13
03078700,UNIVERSITA COMMERCIALE L BOCCONI        ,FC,00000-0000,Private      ,2,13,15,9,27,36
03080300,SHEFFIELD HALLAM UNIVERSITY             ,FC,00000-0000,Public       ,1,2,3,7,6,13
03084300,UNIVERSITY OF LIMERICK                  ,FC,00000-0000,Public       ,4,29,33,15,60,75
03088700,ROYAL SCOTTISH ACAD MUSIC & DRAMA       ,FC,00000-0000,Public       ,7,6,13,17,21,38
03091400,UNIVERSITY OF WOLLONGONG                ,FC,00000-0000,Public       ,0,5,5,6,14,20
03091500,UNIVERSITY OF CANBERRA                  ,FC,00000-0000,Public       ,0,1,1,1,4,5
03091700,POZNAN UNIVERSITY OF MEDICAL SCIENCES   ,FC,00000-0000,Public       ,1,15,16,5,31,36
03092500,NOTTINGHAM TRENT UNIVERSITY             ,FC,00000-0000,Public       ,5,10,15,15,23,38
03095000,RMIT UNIVERSITY                         ,FC,00000-0000,Public       ,2,8,10,6,27,33
03095400,BOND UNIVERSITY                         ,FC,00000-0000,Private      ,10,11,21,19,26,45
03095900,ESSEC BUSINESS SCHOOL                   ,FC,00000-0000,Private      ,1,7,8,3,13,16
03096100,LA TROBE UNIVERSITY                     ,FC,00000-0000,Public       ,2,4,6,6,16,22
03100000,UNIVERSITY OF ADELAIDE (THE)            ,FC,00000-0000,Public       ,1,5,6,5,11,16
03101600,ASIAN INSTITUTE OF MANAGEMENT           ,FC,00000-0000,Private      ,2,5,7,3,18,21
03102500,AMERICAN UNIVERSITY OF ROME             ,FC,00000-0000,Private      ,17,25,42,104,77,181
03102800,ROBERT GORDON UNIVERSITY (THE)          ,FC,00000-0000,Public       ,0,8,8,1,26,27
03104800,GRIFFITH UNIVERSITY                     ,FC,00000-0000,Public       ,5,8,13,11,23,34
03140600,SOUTHERN CROSS UNIVERSITY               ,FC,00000-0000,Public       ,0,2,2,0,4,4
03150400,"UNIVERSITY OF TECHNOLOGY, SYDNEY        ",FC,00000-0000,Public       ,1,10,11,2,21,23
03287300,LIVERPOOL INSTITUTE FOR PERFORMING ARTS ,FC,00000-0000,Public       ,8,0,8,23,3,26
03300300,"2ND SCHOOL OF MEDICINE, CHARLES UNI     ",FC,00000-0000,Public       ,1,9,10,3,16,19
03300400,"FIRST FACULTY OF MEDICINE, CHARLES UNIV.",FC,00000-0000,Public       ,2,7,9,5,17,22
03329300,JOHN CABOT UNIVERSITY                   ,FC,00000-0000,Private      ,30,13,43,172,38,210
03333300,MEDICAL UNIVERSITY SCHOOL OF LUBLIN     ,FC,00000-0000,Public       ,1,35,36,5,88,93
03334300,UNIVERSIDAD NORDESTANA                  ,FC,00000-0000,Private      ,5,17,22,5,37,42
03335300,MEDICAL UNIVERSITY OF SILESIA           ,FC,00000-0000,Public       ,0,8,8,5,29,34
03342300,GLASGOW CALEDONIAN UNIVERSITY           ,FC,00000-0000,Public       ,1,14,15,5,33,38
03349400,"QUEEN MARGARET UNIVERSITY, EDINBURGH    ",FC,00000-0000,Public       ,0,6,6,2,25,27
03350300,BOURNEMOUTH UNIVERSITY                  ,FC,00000-0000,Public       ,0,6,6,13,22,35
03352300,LONDON SOUTH BANK UNIVERSITY            ,FC,00000-0000,Private      ,4,14,18,16,32,48
03378300,"THE 3RD FACULTY OF MEDICINE, CHARLE     ",FC,00000-0000,Public       ,0,0,0,1,3,4
03418400,NAPIER UNIVERSITY                       ,FC,00000-0000,Public       ,2,14,16,7,43,50
03435300,ANGLIA  RUSKIN UNIVERSITY               ,FC,00000-0000,Private      ,2,5,7,11,18,29
03460300,INTERNATIONALES THEOLOGISCHES INSTI     ,FC,00000-0000,Private      ,2,3,5,5,8,13
03473300,UNIVERSITY OF THE ARTS LONDON           ,FC,00000-0000,Public       ,34,52,86,95,101,196
03478300,ROYAL WELSH COLLEGE OF MUSIC AND DRAMA  ,FC,00000-0000,Public       ,1,4,5,14,19,33
03492300,UNIVERSITY OF OXFORD - GREEN TEMPLETON C,FC,00000-0000,Public       ,0,13,13,0,18,18
03492400,UNIV OF CAMBRIDGE-ST CATHERINE'S CG     ,FC,00000-0000,Public       ,0,2,2,0,3,3
03494400,UNIV OF CAMBRIDGE-SELWYN COLLEGE        ,FC,00000-0000,Public       ,0,2,2,0,3,3
03494600,UNIV OF OXFORD-HARRIS MANCHESTER        ,FC,00000-0000,Public       ,1,4,5,1,6,7
03501400,LEEDS METROPOLITAN UNIVERSITY           ,FC,00000-0000,Public       ,2,20,22,7,39,46
03507300,UNIVERSITY OF SUNDERLAND                ,FC,00000-0000,Public       ,4,1,5,6,6,12
03515300,UNIVERSITY OF CENTRAL LANCASHIRE        ,FC,00000-0000,Public       ,3,7,10,11,23,34
03517300,UNIVERSITY OF BRIGHTON                  ,FC,00000-0000,Public       ,0,6,6,17,29,46
03518300,EUROPEAN GRADUATE SCHOOL (EGS)          ,FC,00000-0000,Private      ,1,21,22,1,67,68
03527300,SOFIA UNIVERSITY ST. KLIMENT OHRIDSKI   ,FC,00000-0000,Public       ,0,3,3,1,9,10
03533300,BATH SPA UNIVERSITY                     ,FC,00000-0000,Public       ,2,9,11,8,24,32
03547300,UNIVERSITY OF SOUTH WALES               ,FC,00000-0000,Public       ,1,5,6,8,12,20
03547303,"UNIVERSITY OF SOUTH WALES - NEWPORT, CAE",FC,00000-0000,Public       ,0,0,0,0,1,1
03565300,MASARYKOVA UNIVERZITA                   ,FC,00000-0000,Public       ,1,2,3,1,4,5
03580300,LIVERPOOL JOHN MOORES UNIVERSITY        ,FC,00000-0000,Public       ,1,3,4,1,8,9
03589400,ARTS INSTITUTE AT BOURNEMOUTH (THE)     ,FC,00000-0000,Public       ,7,3,10,16,9,25
03594300,GROUP ESC GRENOBLE GRAD SCH OF BUS.     ,FC,00000-0000,Private      ,2,16,18,2,32,34
03597300,JAGIELLONIAN UNIVERSITY                 ,FC,00000-0000,Public       ,1,7,8,2,15,17
03619300,UNIVERSITY OF GREENWICH                 ,FC,00000-0000,Public       ,13,12,25,43,36,79
03653400,UNIVERSIDAD DE IBEROAMERICA - UNIBE     ,FC,00000-0000,Private      ,1,6,7,3,15,18
03674300,UNIVERSITY OF ABERTAY DUNDEE            ,FC,00000-0000,Public       ,0,1,1,3,5,8
03684400,UNIVERSITY OF LINCOLN                   ,FC,00000-0000,Public       ,1,6,7,9,14,23
03684500,MEDICAL UNIVERSITY OF GDANSK            ,FC,00000-0000,Public       ,1,2,3,4,5,9
03694300,UNIVERSITY OF CHICHESTER                ,FC,00000-0000,Public       ,0,1,1,1,4,5
03728300,UNIVERSITY OF DERBY                     ,FC,00000-0000,Public       ,1,2,3,2,5,7
03738300,LONDON SCHOOL OF THEOLOGY               ,FC,00000-0000,Private      ,0,3,3,0,4,4
03770300,NAZARENE THEOLOGICAL COLLEGE            ,FC,00000-0000,Private      ,0,0,0,0,2,2
03780300,SABA UNIVERSITY SCHOOL OF MEDICINE      ,FC,00000-0000,Proprietary  ,2,98,100,3,304,307
03784300,MEDICAL UNIVERSITY OF BIALYSTOK         ,FC,00000-0000,Public       ,1,2,3,3,6,9
03794400,ANGLO EUROPEAN COLLEGE OF CHIROPRACTIC  ,FC,00000-0000,Private      ,0,0,0,0,1,1
03807300,ROSE BRUFORD COLLEGE                    ,FC,00000-0000,Public       ,1,3,4,6,7,13
03816400,AMERICAN GRAD SCH OF INTERNTL REL & DIPL,FC,00000-0000,Private      ,2,13,15,3,35,38
03818300,LEIPZIG GRADUATE SCHOOL OF MANAGEMENT   ,FC,00000-0000,Private      ,0,5,5,0,9,9
03824300,"ROYAL VETERINARY COLLEGE (THE), UNIVERSI",FC,00000-0000,Public       ,0,29,29,1,73,74
03829300,INTERNATIONAL CHRISTIAN COLLEGE         ,FC,00000-0000,Private      ,0,1,1,0,1,1
03859400,UNIVERSITY COLLEGE FALMOUTH             ,FC,00000-0000,Public       ,3,3,6,19,10,29
03873300,COPENHAGEN BUSINESS SCHOOL              ,FC,00000-0000,Public       ,1,3,4,4,13,17
03880300,UNIVERSITY OF GLOUCESTERSHIRE (THE)     ,FC,00000-0000,Public       ,0,2,2,6,5,11
03897400,INTERNATIONAL SPACE UNIVERSITY          ,FC,00000-0000,Private      ,0,3,3,0,6,6
03900300,MEDICAL UNIVERSITY OF THE AMERICAS      ,FC,00000-0000,Proprietary  ,0,99,99,0,194,194
03945300,UNIVERSITY OF WEST LONDON               ,FC,00000-0000,Public       ,5,8,13,14,18,32
03974300,"ST. GEORGE'S UNIVERSITY, SCHOOL OF VETER",FC,00000-0000,Proprietary  ,0,310,310,2,635,637
04015300,FRANKFURT SCHOOL OF FINANCE & MANAGEMENT,FC,00000-0000,Private      ,3,5,8,5,18,23
04021400,"AMERICAN COLLEGE, DUBLIN LIMITED (THE)  ",FC,00000-0000,Private      ,10,11,21,21,28,49
04021500,CENTRAL EUROPEAN UNIVERSITY             ,FC,00000-0000,Private      ,0,34,34,0,74,74
04032300,YORK ST JOHN UNIVERSITY                 ,FC,00000-0000,Public       ,1,1,2,5,4,9
04046300,HK UNIVERSITY OF SCI & TECH (HKUST)     ,FC,00000-0000,Public       ,0,1,1,3,10,13
04070300,"RAPHAEL RECANATI INTERNATIONAL SCHOOL, T",FC,00000-0000,Private      ,16,25,41,34,41,75
04076300,NEWCASTLE COLLEGE                       ,FC,00000-0000,Public       ,1,2,3,1,6,7
04085400,NEW ZEALAND COLLEGE OF CHIROPRACTIC     ,FC,00000-0000,Private      ,1,0,1,1,2,3
04113300,LEBANESE AMERICAN UNIVERSITY            ,FC,00000-0000,Private      ,18,5,23,42,13,55
04115900,LIVERPOOL HOPE UNIVERSITY               ,FC,00000-0000,Public       ,0,2,2,2,7,9
04116300,EDHEC BUSINESS SCHOOL                   ,FC,00000-0000,Private      ,0,9,9,1,16,17
04128600,UNIVERSITY OF WORCESTER                 ,FC,00000-0000,Public       ,3,0,3,9,3,12
04128700,HERTIE SCHOOL OF GOVERNANCE             ,FC,00000-0000,Private      ,1,17,18,5,37,42
04134200,LONDON CONTEMPORARY DANCE SCHOOL        ,FC,00000-0000,Private      ,3,2,5,9,3,12
04139100,UNIVERSITA DEGLI STUDI DI SCIENZE GASTRO,FC,00000-0000,Private      ,1,4,5,1,9,10
04143700,ST MARY'S UNIVERSITY COLLEGE TWICKENHAM ,FC,00000-0000,Public       ,5,2,7,14,9,23
04160800,CORK INSTITUTE OF TECHNOLOGY            ,FC,00000-0000,Public       ,0,1,1,0,4,4
04168200,EUROPEAN UNIVERSITY AT ST. PETERSBURG   ,FC,00000-0000,Private      ,1,6,7,2,9,11
04170900,UNIVERSITY OF CHESTER                   ,FC,00000-0000,Public       ,4,6,10,5,6,11
04176500,ESMT EUROPEAN SCHOOL OF MANAGEMENT AND T,FC,00000-0000,Private      ,3,9,12,6,22,28
04180700,"HEYTHROP COLLEGE, UNIVERSITY OF LONDON  ",FC,00000-0000,Public       ,0,0,0,2,2,4
04212900,UNIVERSITY COLLEGE BIRMINGHAM           ,FC,00000-0000,Public       ,0,1,1,0,1,1
04218800,REGENT'S UNIVERSITY LONDON              ,FC,00000-0000,Private      ,11,5,16,66,28,94
04219400,UNIVERSIDAD TORCUATO DI TELLA           ,FC,00000-0000,Private      ,0,1,1,3,3,6
04227300,UNIVERSITY OF OXFORD-ST. STEPHEN'S HOUSE,FC,00000-0000,Public       ,0,1,1,0,2,2
04244500,NORWICH UNIVERSITY OF THE ARTS          ,FC,00000-0000,Public       ,2,1,3,2,1,3
00380600,ALDERSON BROADDUS UNIVERSITY            ,WV,26416-1051,Private      ,159,69,228,1816,334,2150
00380700,MOUNTAIN STATE UNIVERSITY               ,WV,25801-5624,Private      ,16,52,68,65,115,180
00380800,BETHANY COLLEGE                         ,WV,26032-0417,Private      ,279,39,318,1017,115,1132
00380900,BLUEFIELD STATE COLLEGE                 ,WV,24701-2198,Public       ,314,484,798,1207,1150,2357
00381000,CONCORD UNIVERSITY                      ,WV,24712-0000,Public       ,342,326,668,2263,1041,3304
00381100,DAVIS & ELKINS COLLEGE                  ,WV,26241-3996,Private      ,131,72,203,1006,233,1239
00381200,FAIRMONT STATE UNIVERSITY               ,WV,26554-2470,Public       ,618,655,1273,4174,1994,6168
00381300,GLENVILLE STATE COLLEGE                 ,WV,26351-1292,Public       ,276,167,443,1401,465,1866
00381500,MARSHALL UNIVERSITY                     ,WV,25755-3300,Public       ,1621,2152,3773,9551,5705,15256
00381600,SOUTHERN WV COMMUNITY COLLEGE           ,WV,25637-2900,Public       ,214,390,604,1043,1057,2100
00381800,UNIVERSITY OF CHARLESTON                ,WV,25304-1099,Private      ,282,543,825,1600,1427,3027
00381900,OHIO VALLEY COLLEGE                     ,WV,26105-8000,Private      ,133,33,166,426,97,523
00382000,SALEM INTERNATIONAL UNIVERSITY          ,WV,26426-0500,Proprietary  ,96,155,251,265,300,565
00382200,SHEPHERD UNIVERSITY                     ,WV,25443-5000,Public       ,343,344,687,3496,1196,4692
00382300,WEST LIBERTY UNIVERSITY                 ,WV,26074-0295,Public       ,469,236,705,2315,637,2952
00382600,WEST VIRGINIA STATE UNIVERSITY          ,WV,25112-0000,Public       ,467,590,1057,2331,1488,3819
00382700,WEST VIRGINIA UNIVERSITY                ,WV,26506-6201,Public       ,2174,1691,3865,24212,8117,32329
00382711,WEST VIRGINIA UNIVERSITY - POTOMAC STATE,WV,26726-3000,Public       ,251,137,388,1621,460,2081
00382721,WEST VIRGINIA UNIV INST OF TECH         ,WV,25136-2436,Public       ,204,154,358,1319,505,1824
00382800,WEST VIRGINIA UNIV AT PARKERSBURG       ,WV,26101-9577,Public       ,316,618,934,1262,1528,2790
00383000,WEST VIRGINIA WESLEYAN COLLEGE          ,WV,26201-2600,Private      ,173,66,239,1928,248,2176
00383100,WHEELING JESUIT UNIVERSITY              ,WV,26003-6243,Private      ,238,270,508,1022,615,1637
00500700,WEST VIRGINIA JUNIOR COLLEGE            ,WV,26505-5596,Proprietary  ,74,166,240,233,446,679
00500800,MOUNTAIN STATE COLLEGE                  ,WV,26101-3993,Proprietary  ,13,94,107,43,213,256
00754400,APPALACHIAN BIBLE COLLEGE               ,WV,25818-1353,Private      ,76,21,97,208,44,252
00760000,INTERNATIONAL BEAUTY SCHOOL             ,WV,25401-3231,Proprietary  ,6,33,39,17,56,73
00835500,JAMES RUMSEY TECHNICAL INSTITUTE        ,WV,25403-0259,Public       ,32,105,137,103,243,346
00895900,CLARKSBURG BEAUTY ACADEMY               ,WV,26301-2903,Proprietary  ,10,30,40,31,65,96
00904700,HUNTINGTON JUNIOR COLLEGE               ,WV,25701-2004,Proprietary  ,62,323,385,147,686,833
00905400,WEST VIRGINIA NORTHERN CMTY COLLEGE     ,WV,26003-0000,Public       ,262,495,757,817,1014,1831
01014000,MINERAL COUNTY VOCATIONAL TECH CTR      ,WV,26726-0000,Public       ,5,13,18,25,41,66
01057300,WEST VIRGINIA JUNIOR COLLEGE            ,WV,25322-0000,Proprietary  ,50,109,159,167,295,462
01057302,WEST VIRGINIA JUNIOR COLLEGE            ,WV,26330-0000,Proprietary  ,21,74,95,141,211,352
01086100,WEST VIRGINIA BUSINESS COLLEGE          ,WV,26301-0000,Proprietary  ,4,36,40,14,100,114
01124500,WEST VIRGINIA SCH OSTEOPATHIC MED       ,WV,24901-1128,Public       ,2,307,309,13,867,880
01174900,WOOD COUNTY SCH OF PRAC NURSING         ,WV,26101-6424,Public       ,8,51,59,34,103,137
01235900,B M SPURR SCHOOL OF PRAC NURSING        ,WV,26038-1660,Private      ,0,21,21,8,41,49
01257300,WEST VIRGINIA UNIV-HOSP-RAD TECH        ,WV,26506-8062,Private      ,15,19,34,118,92,210
01274300,BENJAMIN FRANKLIN CAREER&TECH           ,WV,25064-0000,Public       ,25,55,80,59,111,170
01290400,MONONGALIA CNTY TECH ED CTR             ,WV,26501-6841,Public       ,15,54,69,61,116,177
01290500,ACADEMY OF CAREERS AND TECHNOLOGY       ,WV,25801-0000,Public       ,44,107,151,138,265,403
02057400,ROANE-JACKSON TECHNICAL CENTER          ,WV,25252-0000,Public       ,6,12,18,27,36,63
02068000,UNITED TECHNICAL CENTER                 ,WV,26301-0000,Public       ,6,30,36,37,74,111
02073400,CARVER CAREER TECH ED CTR               ,WV,25306-6397,Public       ,75,138,213,194,281,475
02145100,SCOTT COLLEGE OF COSMETOLOGY            ,WV,26003-0000,Proprietary  ,8,18,26,35,57,92
02178200,CHARLESTON SCHOOL OF BEAUTY CULTURE     ,WV,25301-0000,Proprietary  ,24,65,89,60,121,181
02218200,GARNET CAREER CENTER                    ,WV,25301-0000,Public       ,31,103,134,91,261,352
02275300,CABELL COUNTY CAREER TECHNOLOGY CTR     ,WV,25705-0000,Public       ,52,116,168,136,227,363
02524500,RALPH R WILLIS VOCATIONAL CENTER        ,WV,25601-0000,Public       ,15,34,49,31,66,97
02534800,FRED W EBERLE TECHNICAL CENTER          ,WV,26201-0000,Public       ,15,39,54,49,67,116
02535500,MERCER COUNTY TECH EDUC CNTR            ,WV,24740-0000,Public       ,24,86,110,77,181,258
02579900,NORTH CENTRAL OPPORTUNITIES INDUSTRIALIZ,WV,26554-2936,Private      ,6,31,37,17,52,69
02609400,VALLEY COLLEGE                          ,WV,25404-5711,Proprietary  ,31,108,139,65,221,286
03052000,MEREDITH MANOR EQUESTRIAN CENTRE        ,WV,26184-9707,Proprietary  ,36,30,66,129,72,201
03076500,FAYETTE INSTITUTE OF TECHNOLOGY         ,WV,25901-2174,Public       ,4,17,21,22,55,77
03084200,VALLEY COLLEGE                          ,WV,24740-3141,Proprietary  ,22,86,108,49,154,203
03084400,VALLEY COLLEGE                          ,WV,25801-2643,Proprietary  ,28,181,209,83,362,445
03098300,PUTNAM CAREER & TECHNICAL CENTER        ,WV,25070-0000,Public       ,18,41,59,51,73,124
03102100,MORGANTOWN BEAUTY COLLEGE               ,WV,26505-5430,Proprietary  ,20,48,68,68,97,165
03734300,JOHN D. ROCKEFELLER IV CAREER CENTER    ,WV,26047-9424,Public       ,5,12,17,9,25,34
03819300,AMERICAN PUBLIC UNIVERSITY SYSTEM       ,WV,25414-1621,Proprietary  ,562,15323,15885,1171,33052,34223
03957300,BLUE RIDGE COMMUNITY AND TECHNICAL COLLE,WV,25401-3244,Public       ,251,561,812,837,1429,2266
03960300,NEW RIVER COMMUNITY AND TECHNICAL COLLEG,WV,25801-2636,Public       ,259,626,885,943,1452,2395
04028300,MOUNTAIN STATE SCHOOL OF MASSAGE        ,WV,25304-2025,Proprietary  ,5,18,23,23,42,65
04038500,PIERPONT COMMUNITY & TECHNICAL COLLEGE  ,WV,26554-2451,Public       ,246,376,622,1164,1031,2195
04038600,BRIDGEVALLEY COMMUNITY AND TECHNICAL COL,WV,25303-2735,Public       ,344,694,1038,964,1397,2361
04038601,BRIDGEVALLEY COMMUNITY AND TECHNICAL COL,WV,25136-2435,Public       ,0,0,0,61,48,109
04041400,MOUNTWEST COMMUNITY AND TECHNICAL COLLEG,WV,25755-3300,Public       ,282,592,874,895,1290,2185
04119000,EASTERN WEST VIRGINIA COMMUNITY & TECHNI,WV,26836-0000,Public       ,58,177,235,193,396,589
04212400,MINGO EXTENDED LEARNING CENTER          ,WV,25670-9797,Public       ,4,22,26,8,37,45
04234800,RANDOLPH TECHNICAL CENTER               ,WV,26241-9527,Public       ,3,12,15,11,20,31
00106100,ALASKA PACIFIC UNIVERSITY               ,AK,99508-4672,Private      ,105,219,324,482,569,1051
00106300,UNIVERSITY OF ALASKA FAIRBANKS          ,AK,99775-7500,Public       ,741,1147,1888,3053,2877,5930
00106500,UNIVERSITY OF ALASKA SOUTHEAST          ,AK,99801-8680,Public       ,170,380,550,678,928,1606
00884300,ALASKA BIBLE COLLEGE                    ,AK,99588-0000,Private      ,8,13,21,22,37,59
01146200,UNIVERSITY OF ALASKA ANCHORAGE          ,AK,99514-1608,Public       ,1779,2448,4227,5456,5786,11242
02541000,ALASKA CAREER COLLEGE                   ,AK,99507-1033,Proprietary  ,81,261,342,180,565,745
02576900,CHARTER COLLEGE                         ,AK,99508-0000,Proprietary  ,416,1481,1897,550,2268,2818
03160300,AVTEC - ALASKA'S INSTITUTE OF TECHNOLOGY,AK,99664-0889,Public       ,77,115,192,185,238,423
03461300,ILISAGVIK COLLEGE                       ,AK,99723-0749,Public       ,6,17,23,15,33,48
04138600,ALASKA CHRISTIAN COLLEGE                ,AK,99669-9755,Private      ,15,47,62,33,64,97
00108500,UNIV ARKANSAS MONTICELLO                ,AR,71656-0000,Public       ,932,714,1646,1796,1149,2945
00108600,UNIV OF ARKANSAS AT PINE BLUFF          ,AR,71601-2790,Public       ,1031,602,1633,2720,1151,3871
00108700,ARKANSAS BAPTIST COLLEGE                ,AR,72202-6099,Private      ,389,418,807,753,694,1447
00108800,LYON COLLEGE                            ,AR,72501-3699,Private      ,322,43,365,1016,112,1128
00108900,ARKANSAS TECH UNIVERSITY                ,AR,72801-2222,Public       ,2893,2270,5163,6338,3771,10109
00109000,ARKANSAS STATE UNIVERSITY               ,AR,72467-0000,Public       ,3701,4132,7833,8075,6961,15036
00109100,ARKANSAS STATE UNIVERSITY - BEEBE       ,AR,72012-1000,Public       ,981,973,1954,1822,1773,3595
00109200,UNIVERSITY OF CENTRAL ARKANSAS          ,AR,72035-0001,Public       ,3925,2055,5980,9041,3622,12663
00109300,CENTRAL BAPTIST COLLEGE                 ,AR,72034-6470,Private      ,255,241,496,496,428,924
00109400,UNIVERSITY OF THE OZARKS                ,AR,72830-2880,Private      ,246,49,295,748,107,855
00109500,CROWLEYS RIDGE COLLEGE                  ,AR,72450-9775,Private      ,93,49,142,175,86,261
00109700,HARDING UNIVERSITY                      ,AR,72149-0001,Private      ,1419,806,2225,3438,1297,4735
00109800,HENDERSON STATE UNIVERSITY              ,AR,71999-0001,Public       ,1413,756,2169,3184,1267,4451
00109900,HENDRIX COLLEGE                         ,AR,72032-3080,Private      ,170,71,241,2024,217,2241
00110000,JOHN BROWN UNIVERSITY                   ,AR,72761-2747,Private      ,334,485,819,1501,904,2405
00110100,UNIV ARKANSAS LITTLE ROCK               ,AR,72204-1099,Public       ,2071,3774,5845,4548,6737,11285
00110200,OUACHITA BAPTIST UNIVERSITY             ,AR,71998-0001,Private      ,575,73,648,1576,158,1734
00110300,PHILANDER SMITH COLLEGE                 ,AR,72202-3718,Private      ,239,261,500,816,493,1309
00110400,PHILLIPS COUNTY COMMUNITY COLLEGE       ,AR,72342-0000,Public       ,177,216,393,298,371,669
00110500,SHORTER COLLEGE                         ,AR,72114-4885,Private      ,26,195,221,47,393,440
00110600,WILLIAMS BAPTIST COLLEGE                ,AR,72476-4661,Private      ,256,62,318,532,116,648
00110700,SOUTHERN ARKANSAS UNIVERSITY            ,AR,71754-0000,Public       ,1212,787,1999,2703,1297,4000
00110800,UNIV ARKANSAS FAYETTEVILLE              ,AR,72701-0000,Public       ,5424,2549,7973,16006,5158,21164
00110900,UNIVERSITY OF ARKANSAS FOR MEDICAL SCIEN,AR,72205-7102,Public       ,272,1479,1751,523,2657,3180
00111000,UNIVERSITY OF ARKANSAS-FORT SMITH       ,AR,72904-7397,Public       ,1796,1588,3384,3756,2812,6568
00524500,U OF A COMM COLLEGE AT MORRILTON        ,AR,72110-9601,Public       ,715,864,1579,1128,1273,2401
00570700,SEARK COLLEGE                           ,AR,71603-0000,Public       ,290,719,1009,501,1104,1605
00573200,UNIV AR COMMUNITY COLLEGE AT HOPE       ,AR,71801-0000,Public       ,282,402,684,465,636,1101
00704400,CROWLEYS RIDGE TECHNICAL INSTITUTE      ,AR,72336-0000,Public       ,47,123,170,78,168,246
00732967,ITT TECHNICAL INSTITUTE                 ,AR,72204-7739,Proprietary  ,80,291,371,136,441,577
00773800,SOUTHERN ARKANSAS UNIVERSITY TECH       ,AR,71701-1900,Public       ,238,318,556,416,548,964
00792100,PAUL MITCHELL THE SCHOOL ARKANSAS       ,AR,72701-0000,Proprietary  ,30,54,84,57,90,147
00997600,COLLEGE OF THE OUACHITAS                ,AR,72104-0816,Public       ,186,386,572,309,650,959
01074100,MELLIE'S BEAUTY COLLEGE                 ,AR,72901-3833,Proprietary  ,22,74,96,35,116,151
01210500,NATIONAL PARK COMMUNITY COLLEGE         ,AR,71913-9174,Public       ,443,771,1214,763,1198,1961
01226000,EAST ARKANSAS COMMUNITY COLLEGE         ,AR,72335-2204,Public       ,180,229,409,315,370,685
01226100,NORTH ARKANSAS COLLEGE                  ,AR,72601-5508,Public       ,395,615,1010,783,1015,1798
01286000,ARKANSAS NORTHEASTERN COLLEGE           ,AR,72316-1109,Public       ,298,352,650,542,611,1153
02052200,BLACK RIVER TECHNICAL COLLEGE           ,AR,72455-0000,Public       ,333,529,862,545,843,1388
02073500,UNIVERSITY OF ARKANSAS COMMUNITY COLLEGE,AR,72503-0000,Public       ,253,327,580,465,600,1065
02073700,NORTHWEST TECHNICAL INSTITUTE           ,AR,72765-0000,Public       ,106,167,273,192,330,522
02074600,SOUTH ARKANSAS COMMUNITY COLLEGE        ,AR,71731-0000,Public       ,283,657,940,482,1096,1578
02075300,PULASKI TECHNICAL COLLEGE               ,AR,72118-0000,Public       ,1608,4103,5711,2644,6634,9278
02087000,OZARKA COLLEGE                          ,AR,72556-0000,Public       ,161,354,515,291,585,876
02111100,RICH MOUNTAIN COMMUNITY COLLEGE         ,AR,71953-0000,Public       ,144,165,309,287,238,525
02202400,PROFESSIONAL COSMETOLOGY EDUC CTR       ,AR,71730-5828,Proprietary  ,19,35,54,28,65,93
02220900,COSSATOT COMMUNITY COLLEGE              ,AR,71832-0000,Public       ,229,288,517,450,529,979
02272400,EASTERN COLLEGE OF HEALTH VOCATIONS     ,AR,72205-3535,Proprietary  ,63,207,270,92,330,422
02284200,NEW TYLER BARBER COLLEGE INC            ,AR,72114-0000,Proprietary  ,19,52,71,22,76,98
02330800,JEFFERSON SCHOOL OF NURSING             ,AR,71603-0000,Private      ,40,95,135,68,148,216
02339800,SOUTHERN INSTITUTE OF COSMETOLOGY       ,AR,72301-0000,Proprietary  ,2,19,21,6,26,32
02341700,CAREER ACADEMY OF HAIR DESIGN           ,AR,72764-4304,Proprietary  ,13,42,55,21,63,84
02341701,CAREER ACADEMY OF HAIR DESIGN - ROGERS  ,AR,72756-2102,Proprietary  ,18,36,54,22,49,71
02341702,CAREER ACADEMY OF HAIR DESIGN - SILOAM  ,AR,72761-4217,Proprietary  ,8,19,27,9,29,38
02341703,CAREER ACADEMY OF HAIR DESIGN - FAYETTEV,AR,72701-7731,Proprietary  ,14,32,46,20,50,70
02348200,MID-SOUTH COMMUNITY COLLEGE             ,AR,72301-0000,Public       ,202,435,637,412,779,1191
02363500,ARTHUR'S BEAUTY COLLEGE                 ,AR,72901-0000,Proprietary  ,26,82,108,41,141,182
02525800,LEE'S SCHOOL OF COSMETOLOGY             ,AR,72114-0000,Proprietary  ,13,27,40,23,57,80
02538500,ARTHUR'S BEAUTY COLLEGE                 ,AR,72076-0000,Proprietary  ,30,93,123,49,146,195
02569600,SEARCY BEAUTY COLLEGE                   ,AR,72143-0000,Proprietary  ,11,44,55,16,67,83
03005100,ARKANSAS BEAUTY SCHOOL                  ,AR,72209-5116,Proprietary  ,27,104,131,44,160,204
03007100,HOT SPRINGS BEAUTY COLLEGE              ,AR,71901-5432,Proprietary  ,20,47,67,29,75,104
03007600,ARKANSAS BEAUTY SCHOOL-CONWAY           ,AR,72032-4354,Proprietary  ,0,1,1,15,31,46
03023400,ARKANSAS COLLEGE OF BARBERING           ,AR,72114-5615,Proprietary  ,25,90,115,36,145,181
03063300,NORTHWEST ARKANSAS COMMUNITY COLLEG     ,AR,72712-5190,Public       ,1558,1897,3455,2764,3222,5986
03065100,ABC BEAUTY COLLEGE                      ,AR,71923-4206,Proprietary  ,6,24,30,14,44,58
03066302,BRYAN UNIVERSITY - ROGERS               ,AR,72756-1825,Proprietary  ,33,133,166,46,194,240
03105200,BAPTIST HEALTH SCHOOLS LITTLE ROCK      ,AR,72210-2820,Private      ,251,731,982,418,1202,1620
03115102,HERITAGE COLLEGE - LITTLE ROCK          ,AR,72227-5544,Proprietary  ,75,303,378,115,503,618
03124900,IMAGINE -  PAUL MITCHELL PARTNER SCHOOL ,AR,72117-2516,Proprietary  ,80,153,233,128,250,378
03214300,VELVATEX COLLEGE OF BEAUTY CULTURE      ,AR,72202-5452,Proprietary  ,3,18,21,8,32,40
03254300,MARGARET'S HAIR ACADEMY                 ,AR,71655-4905,Proprietary  ,7,37,44,12,61,73
03855300,ECCLESIA COLLEGE                        ,AR,72762-8159,Private      ,55,56,111,119,89,208
03912300,CROSSETT SCHOOL OF COSMETOLOGY          ,AR,71635-0000,Proprietary  ,4,9,13,7,16,23
03997300,ARKANSAS BEAUTY COLLEGE                 ,AR,72801-3741,Proprietary  ,14,22,36,19,40,59
04183100,WASHINGTON BARBER COLLEGE               ,AR,72209-3820,Proprietary  ,18,52,70,22,77,99
04183400,SALON PROFESSIONAL ACADEMY (THE)        ,AR,72116-7310,Proprietary  ,26,53,79,42,82,124
04203400,ARKANSAS STATE UNIVERSITY - NEWPORT     ,AR,72112-9073,Public       ,474,601,1075,788,1039,1827
04220000,DESIGNER BARBER & STYLIST SCHOOL        ,AR,72903-3753,Proprietary  ,9,31,40,14,53,67
04238900,"BEAUTY SCHOOL, (THE)                    ",AR,72653-3275,Proprietary  ,4,9,13,4,9,13
04241800,ACADEMY OF PROFESSIONAL COSMETOLOGY     ,AR,72756-2028,Proprietary  ,14,23,37,24,43,67
04247600,NEW BEGINNINGS BEAUTY ACADEMY           ,AR,71601-5257,Proprietary  ,1,11,12,1,11,12
00133900,CORBAN UNIVERSITY                       ,OR,97301-9392,Private      ,155,160,315,1980,559,2539
00318600,BLUE MOUNTAIN COMMUNITY COLLEGE         ,OR,97801-0000,Public       ,150,306,456,997,1059,2056
00318800,CENTRAL OREGON COMMUNITY COLLEGE        ,OR,97701-5998,Public       ,502,1058,1560,2578,3653,6231
00318900,CLATSOP COMMUNITY COLLEGE               ,OR,97103-3698,Public       ,59,176,235,380,560,940
00319100,CONCORDIA UNIVERSITY                    ,OR,97211-6099,Private      ,228,3350,3578,1969,6500,8469
00319300,EASTERN OREGON UNIVERSITY               ,OR,97850-2899,Public       ,220,516,736,2658,2274,4932
00319400,GEORGE FOX UNIVERSITY                   ,OR,97132-2697,Private      ,304,485,789,4032,1715,5747
00319600,LANE COMMUNITY COLLEGE                  ,OR,97405-0640,Public       ,784,1638,2422,4833,6825,11658
00319700,LEWIS & CLARK COLLEGE                   ,OR,97219-7899,Private      ,212,465,677,5792,2852,8644
00319800,LINFIELD COLLEGE                        ,OR,97128-6894,Private      ,201,194,395,3450,816,4266
00319801,LINFIELD COLLEGE - PORTLAND CAMPUS      ,OR,97210-0000,Private      ,59,175,234,692,873,1565
00319900,MARYLHURST UNIVERSITY                   ,OR,97036-7036,Private      ,31,254,285,124,902,1026
00320300,MOUNT ANGEL SEMINARY                    ,OR,97373-9700,Private      ,0,4,4,11,13,24
00320400,MOUNT HOOD COMMUNITY COLLEGE            ,OR,97030-3300,Public       ,803,1663,2466,4241,5756,9997
00320600,MULTNOMAH UNIVERSITY                    ,OR,97220-5898,Private      ,89,234,323,476,619,1095
00320700,PACIFIC NORTHWEST COLLEGE OF ART        ,OR,97209-3023,Private      ,75,126,201,679,542,1221
00320800,NORTHWEST CHRISTIAN UNIVERSITY          ,OR,97401-3727,Private      ,79,197,276,642,647,1289
00320900,WESTERN OREGON UNIVERSITY               ,OR,97361-1394,Public       ,535,471,1006,7061,2580,9641
00321000,OREGON STATE UNIVERSITY                 ,OR,97331-8507,Public       ,1998,3010,5008,25523,12752,38275
00321100,OREGON INSTITUTE OF TECHNOLOGY          ,OR,97601-8801,Public       ,315,515,830,2859,2184,5043
00321200,PACIFIC UNIVERSITY                      ,OR,97116-1797,Private      ,234,423,657,4102,3079,7181
00321300,PORTLAND COMMUNITY COLLEGE              ,OR,97219-7198,Public       ,2317,6447,8764,12103,23013,35116
00321600,PORTLAND STATE UNIVERSITY               ,OR,97207-0000,Public       ,1699,3864,5563,16548,19721,36269
00321700,REED COLLEGE                            ,OR,97202-8199,Private      ,272,132,404,3991,582,4573
00321800,CHEMEKETA COMMUNITY COLLEGE             ,OR,97309-1500,Public       ,867,2016,2883,5611,7969,13580
00321900,SOUTHERN OREGON UNIVERSITY              ,OR,97520-5010,Public       ,463,647,1110,5473,2875,8348
00322000,SOUTHWESTERN OREGON COMMUNITY CLG       ,OR,97420-2956,Public       ,245,287,532,1479,1109,2588
00322100,TREASURE VALLEY COMMUNITY COLLEGE       ,OR,97914-3423,Public       ,185,404,589,1106,1214,2320
00322200,UMPQUA COMMUNITY COLLEGE                ,OR,97470-0226,Public       ,117,396,513,978,1512,2490
00322300,UNIVERSITY OF OREGON                    ,OR,97403-1226,Public       ,1702,1536,3238,25101,8624,33725
00322400,UNIVERSITY OF PORTLAND                  ,OR,97203-5798,Private      ,599,543,1142,10911,2488,13399
00322500,WARNER PACIFIC COLLEGE                  ,OR,97215-4099,Private      ,150,347,497,1212,1287,2499
00322700,WILLAMETTE UNIVERSITY                   ,OR,97301-3930,Private      ,199,218,417,4967,1188,6155
00487800,CLACKAMAS COMMUNITY COLLEGE             ,OR,97045-7998,Public       ,638,1114,1752,3326,4012,7338
00488200,OREGON HEALTH & SCIENCE UNIVERSITY      ,OR,97239-0000,Public       ,125,683,808,1016,4048,5064
00693800,LINN BENTON COMMUNITY COLLEGE           ,OR,97321-3774,Public       ,567,1030,1597,3196,3516,6712
00717800,WESTERN SEMINARY                        ,OR,97215-0000,Private      ,1,175,176,12,408,420
00723402,HEALD COLLEGE - PORTLAND                ,OR,97205-3432,Proprietary  ,24,89,113,113,412,525
00732969,ITT TECHNICAL INSTITUTE                 ,OR,97220-6819,Proprietary  ,102,639,741,328,1290,1618
00781900,ART INSTITUTE OF PORTLAND (THE)         ,OR,97209-2911,Proprietary  ,272,423,695,1228,1181,2409
00888700,CONCORDE CAREER INSTITUTE               ,OR,97232-2242,Proprietary  ,64,236,300,232,615,847
00907900,EVEREST COLLEGE                         ,OR,97204-2296,Proprietary  ,40,174,214,134,448,582
00958100,SPRINGFIELD COLLEGE OF BEAUTY           ,OR,97477-5474,Proprietary  ,11,47,58,43,121,164
01012200,PHAGANS' MEDFORD BEAUTY SCHOOL          ,OR,97504-5297,Proprietary  ,11,38,49,32,107,139
01018200,ROGUE COMMUNITY COLLEGE                 ,OR,97527-0000,Public       ,365,1101,1466,2208,4247,6455
01050700,ACADEMY OF HAIR DESIGN                  ,OR,97301-3526,Proprietary  ,14,53,67,50,138,188
01230900,UNIVERSITY OF WESTERN STATES            ,OR,97230-3099,Private      ,35,312,347,134,671,805
01234700,PHAGANS CENTRAL OREGON BEAUTY CLG       ,OR,97701-5175,Proprietary  ,15,61,76,59,137,196
01234800,PHAGANS BEAUTY COLLEGE                  ,OR,97333-4716,Proprietary  ,22,35,57,65,73,138
01235000,PHAGANS SCHOOL OF HAIR DESIGN           ,OR,97086-7721,Proprietary  ,39,56,95,76,138,214
01235100,PHAGANS SCHOOL OF BEAUTY                ,OR,97301-4732,Proprietary  ,20,53,73,63,153,216
01300800,PHAGANS TIGARD BEAUTY SCHOOL            ,OR,97223-0000,Proprietary  ,6,22,28,18,50,68
02101000,NORTHWEST COLLEGE OF HAIR DESIGN        ,OR,97086-7702,Proprietary  ,70,166,236,149,363,512
02101002,NORTHWEST COLLEGE                       ,OR,97007-3954,Proprietary  ,7,13,20,27,51,78
02104900,SUMNER COLLEGE                          ,OR,97219-4063,Proprietary  ,15,166,181,56,389,445
02106100,COLLEGE OF COSMETOLOGY                  ,OR,97601-0000,Proprietary  ,12,33,45,32,70,102
02154400,BEAU MONDE CLG OF HAIR DESIGN           ,OR,97205-0000,Proprietary  ,23,67,90,76,172,248
02154401,BEAU MONDE COLLEGE OF HAIR DESIGN - BEAU,OR,97232-1315,Proprietary  ,17,32,49,67,110,177
02159700,NEW HOPE CHRISTIAN COLLEGE              ,OR,97405-1194,Private      ,47,64,111,179,190,369
02201900,PHAGANS' SCHOOL OF HAIR DESIGN          ,OR,97232-0000,Proprietary  ,32,88,120,88,222,310
02311000,PAUL MITCHELL THE SCHOOL                ,OR,97205-3724,Proprietary  ,46,71,117,174,221,395
02330100,PIONEER PACIFIC COLLEGE                 ,OR,97070-0000,Proprietary  ,87,317,404,233,669,902
02330102,PIONEER PACIFIC COLLEGE                 ,OR,97403-0000,Proprietary  ,45,239,284,170,651,821
02337900,COLLEGE OF HAIR DESIGN CAREERS          ,OR,97301-0000,Proprietary  ,16,45,61,52,124,176
02344100,ROSEBURG BEAUTY COLLEGE                 ,OR,97470-0000,Proprietary  ,4,28,32,28,69,97
02534000,NATIONAL COLLEGE OF NATURAL MEDICINE    ,OR,97201-0000,Private      ,13,206,219,58,989,1047
02578800,NORTHWEST NANNIES INSTITUTE             ,OR,97035-0000,Proprietary  ,0,2,2,9,11,20
02603700,OREGON COL OF ORIENTAL MEDICINE         ,OR,97216-0000,Private      ,8,169,177,34,387,421
02617506,EVEREST COLLEGE - EVEREST INSTITUTE     ,OR,97223-6581,Proprietary  ,30,85,115,66,185,251
03007300,OREGON COLLEGE OF ART & CRAFT           ,OR,97225-6399,Private      ,46,105,151,261,377,638
03022600,LE CORDON BLEU COLLEGE OF CULINARY ARTS ,OR,97205-2793,Proprietary  ,146,308,454,422,772,1194
03042500,CARRINGTON COLLEGE                      ,OR,97232-1302,Proprietary  ,79,248,327,169,537,706
03074400,PHAGANS NEWPORT ACAD CSMTLGY CAREER     ,OR,97365-4963,Proprietary  ,6,12,18,16,28,44
03074500,EAST-WEST COLLEGE OF THE HEALING ARTS   ,OR,97232-2765,Proprietary  ,15,92,107,52,258,310
03185300,PHAGANS GRANTS PASS COLLEGE OF BTY      ,OR,97527-0000,Proprietary  ,10,24,34,36,60,96
03428300,KLAMATH COMMUNITY COLLEGE               ,OR,97603-7121,Public       ,129,304,433,542,985,1527
03642300,INSTITUTE OF TECHNOLOGY                 ,OR,97305-1373,Proprietary  ,32,157,189,147,374,521
03668300,BIRTHINGWAY COLLEGE OF MIDWIFERY        ,OR,97266-4042,Private      ,14,68,82,37,204,241
03783400,ABDILL CAREER COLLEGE                   ,OR,97504-7137,Proprietary  ,14,82,96,47,207,254
04146500,PORTLAND ACTORS CONSERVATORY            ,OR,97201-2557,Private      ,15,39,54,41,112,153
04151900,COLUMBIA GORGE COMMUNITY COLLEGE        ,OR,97058-3434,Public       ,64,167,231,448,589,1037
04167400,SAGE SCHOOL OF MASSAGE & HEALING ARTS   ,OR,97701-4082,Proprietary  ,4,27,31,22,83,105
04171400,AVEDA INSTITUTE PORTLAND                ,OR,97209-3144,Proprietary  ,94,152,246,275,377,652
04194400,AMERICAN COLLEGE OF HEALTHCARE SCIENCES ,OR,97239-3719,Proprietary  ,43,413,456,169,957,1126
04194900,TILLAMOOK BAY COMMUNITY COLLEGE         ,OR,97141-2807,Public       ,31,66,97,159,258,417
00137400,ALBERTUS MAGNUS COLLEGE                 ,CT,06511-1189,Private      ,184,585,769,887,1470,2357
00137800,CENTRAL CONNECTICUT STATE UNIV          ,CT,06050-2490,Public       ,1778,1691,3469,11247,4203,15450
00137900,CONNECTICUT COLLEGE                     ,CT,06320-4196,Private      ,354,37,391,3137,162,3299
00138000,WESTERN CONNECTICUT STATE UNIV          ,CT,06810-6826,Public       ,763,577,1340,6340,1721,8061
00138500,FAIRFIELD UNIVERSITY                    ,CT,06430-0000,Private      ,812,296,1108,7869,873,8742
00138700,HARTFORD SEMINARY                       ,CT,06105-0000,Private      ,5,31,36,27,75,102
00138900,HOLY APOSTLES COLLEGE & SEMINARY        ,CT,06416-2027,Private      ,4,25,29,22,67,89
00139200,MANCHESTER COMMUNITY COLLEGE            ,CT,06045-1046,Public       ,1214,1422,2636,3077,2728,5805
00139300,MITCHELL COLLEGE                        ,CT,06320-4498,Private      ,198,77,275,766,210,976
00139700,UNIVERSITY OF NEW HAVEN                 ,CT,06516-1999,Private      ,620,500,1120,10231,1849,12080
00139728,LYME ACADEMY COLLEGE OF FINE ARTS       ,CT,06371-2333,Private      ,5,3,8,78,24,102
00139800,NORTHWESTERN CT COMMUNITY COLLEGE       ,CT,06098-1747,Public       ,176,250,426,446,477,923
00139900,NORWALK COMMUNITY TECHNICAL COLLEGE     ,CT,06854-1655,Public       ,789,1062,1851,1849,2087,3936
00140100,POST UNIVERSITY                         ,CT,06723-3240,Proprietary  ,494,3682,4176,1418,7466,8884
00140200,QUINNIPIAC UNIVERSITY                   ,CT,06518-1908,Private      ,933,790,1723,17058,3142,20200
00140300,SACRED HEART UNIVERSITY                 ,CT,06825-1000,Private      ,750,1050,1800,8732,2537,11269
00140600,SOUTHERN CONNECTICUT STATE UNIV         ,CT,06515-1355,Public       ,1066,1177,2243,10880,4664,15544
00140900,UNIVERSITY OF SAINT JOSEPH              ,CT,06117-2791,Private      ,186,600,786,1076,1538,2614
00141400,TRINITY COLLEGE                         ,CT,06106-3100,Private      ,304,105,409,3418,326,3744
00141600,UNIVERSITY OF BRIDGEPORT                ,CT,06601-5650,Private      ,495,962,1457,3223,2853,6076
00141700,UNIVERSITY OF CONNECTICUT-STORRS        ,CT,06269-2151,Public       ,1373,984,2357,33469,5261,38730
00141702,UNIV CONN STAMFORD                      ,CT,06901-0000,Public       ,125,175,300,990,536,1526
00141703,UNIV OF CONNECTICUT - TORINGTON         ,CT,06790-0000,Public       ,40,31,71,334,114,448
00141706,UNIV OF CONNECTICUT SCH LAW             ,CT,06105-0000,Public       ,14,210,224,62,800,862
00141707,UNIV OF CT - SCH OF SOCIAL WORK         ,CT,06117-0000,Public       ,21,74,95,141,487,628
00141708,UNIVERSITY OF CONNECTICUT - SCHOOL OF ME,CT,06030-1920,Public       ,30,202,232,164,525,689
00141709,UNIVERSITY OF CONNECTICUT - SCHOOL OF DE,CT,06030-1920,Public       ,38,111,149,285,274,559
00142200,UNIVERSITY OF HARTFORD                  ,CT,06117-1599,Private      ,941,579,1520,10319,1975,12294
00142400,WESLEYAN UNIVERSITY                     ,CT,06459-3208,Private      ,578,67,645,5122,274,5396
00142500,EASTERN CONNECTICUT STATE UNIV          ,CT,06226-2295,Public       ,567,282,849,6829,1166,7995
00142600,YALE UNIVERSITY                         ,CT,06520-8288,Private      ,911,1131,2042,17282,7252,24534
00280301,RENSSELAER POLYTECHNIC INSTITUTE-RENSSEL,CT,06120-2991,Private      ,4,4,8,27,17,44
00451300,HOUSATONIC COMMUNITY COLLEGE            ,CT,06604-4704,Public       ,927,1650,2577,2114,3058,5172
00618100,BRIDGEPORT HOSP SCHL OF NURSING         ,CT,06610-2896,Private      ,42,196,238,153,453,606
00619100,ST. VINCENT'S COLLEGE                   ,CT,06606-9966,Private      ,63,292,355,222,636,858
00698200,NAUGATUCK VALLEY COMM-TECH COLG         ,CT,06708-3089,Public       ,1051,1388,2439,2539,2850,5389
00730000,ELI WHITNEY TECHNICAL HIGH SCHOOL       ,CT,06514-0000,Public       ,3,35,38,13,54,67
00730300,LINCOLN TECHNICAL INSTITUTE             ,CT,06051-0000,Proprietary  ,165,392,557,276,662,938
00730306,LINCOLN TECHNICAL INSTITUTE - EAST WINDS,CT,06088-9631,Proprietary  ,365,228,593,596,350,946
00730500,PORTER AND CHESTER INSTITUTE OF BRANFORD,CT,06405-4022,Proprietary  ,99,177,276,161,263,424
00731100,WINDHAM TECHNICAL HIGH SCHOOL           ,CT,06226-2100,Public       ,1,3,4,2,6,8
00745900,PAIER COLLEGE OF ART                    ,CT,06514-3902,Proprietary  ,18,16,34,88,39,127
00763500,CAPITAL COMMUNITY COLLEGE               ,CT,06103-1207,Public       ,498,1437,1935,1263,2728,3991
00803700,GATEWAY COMMUNITY-TECHNICAL COLLEGE     ,CT,06511-0000,Public       ,1058,1922,2980,2858,4102,6960
00803800,MIDDLESEX COMMUNITY CLG                 ,CT,06457-4889,Public       ,382,631,1013,959,1213,2172
00887300,PAUL MITCHELL THE SCHOOL                ,CT,06810-6716,Proprietary  ,43,34,77,84,55,139
00887400,MARINELLO SCHOOL OF BEAUTY              ,CT,06450-4836,Proprietary  ,14,55,69,21,66,87
00887401,MARINELLO SCHOOL OF BEAUTY - HAMDEN     ,CT,06514-4132,Proprietary  ,2,22,24,10,34,44
00887402,MARINELLO SCHOOL OF BEAUTY - FAIRFIELD  ,CT,06825-4847,Proprietary  ,13,58,71,34,82,116
00887403,MARINELLO SCHOOL OF BEAUTY - WILLIMANTIC,CT,06226-1940,Proprietary  ,8,27,35,14,33,47
00927700,E C GOODWIN TECHNICAL HIGH SCHOOL       ,CT,06053-0000,Public       ,14,24,38,28,39,67
00940700,LINCOLN COLLEGE OF NEW ENGLAND          ,CT,06489-1057,Proprietary  ,171,261,432,415,469,884
00976400,TUNXIS COMMUNITY COLLEGE                ,CT,06032-3187,Public       ,613,695,1308,1727,1498,3225
00976500,THREE RIVERS COMMUNITY COLLEGE          ,CT,06360-6598,Public       ,517,888,1405,1510,1958,3468
00982200,ALBERT I PRINCE TECHNICAL HIGH SCHOOL   ,CT,06106-3799,Public       ,11,53,64,19,79,98
01041700,MARINELLO SCHOOL OF BEAUTY              ,CT,06108-2220,Proprietary  ,37,120,157,64,147,211
01053000,QUINEBAUG VALLEY COMMUNITY COLLEGE      ,CT,06239-1440,Public       ,289,367,656,679,766,1445
01077900,PORTER AND CHESTER INSTITUTE-ALLCAMPUSES,CT,06615-7158,Proprietary  ,588,956,1544,939,1816,2755
01115000,ASNUNTUCK COMMUNITY COLLEGE             ,CT,06082-3800,Public       ,163,277,440,395,509,904
01149600,BULLARD HAVENS VOC TECH SCHOOL          ,CT,06610-3499,Public       ,6,57,63,18,105,123
01169700,VINAL REGIONAL VOC TECH SCHOOL          ,CT,06457-4918,Public       ,2,21,23,4,28,32
01184300,NORWICH TECHNICAL HIGH SCHOOL           ,CT,06360-7097,Public       ,4,29,33,13,59,72
01242500,STONE ACADEMY                           ,CT,06516-4049,Proprietary  ,64,343,407,108,561,669
01242503,STONE ACADEMY -WATERBURY                ,CT,06705-3823,Proprietary  ,8,36,44,23,77,100
01242504,STONE ACADEMY -  EAST HARTFORD          ,CT,06118-0000,Proprietary  ,15,57,72,38,127,165
02074000,BRANFORD HALL CAREER INSTITUTE          ,CT,06405-0000,Proprietary  ,235,1092,1327,305,1344,1649
02106600,AMERICAN INSTITUTE                      ,CT,06110-1922,Proprietary  ,30,155,185,57,235,292
02112300,RIDLEY LOWELL BUSINESS & TECH INST      ,CT,06320-0000,Proprietary  ,33,139,172,83,355,438
02112700,NORTH HAVEN ACADEMY                     ,CT,06473-3108,Proprietary  ,27,18,45,61,53,114
02148700,CONNECTICUT INST OF HAIR DESIGN         ,CT,06716-0000,Proprietary  ,2,34,36,4,43,47
02202500,NEW ENGLAND TRACTOR TRAILER SCH         ,CT,06071-2036,Proprietary  ,35,376,411,39,404,443
02244900,GOODWIN COLLEGE                         ,CT,06118-9980,Private      ,307,1230,1537,831,3072,3903
02245300,HOWELL CHENEY TECHNICAL HIGH SCHOOL     ,CT,06040-0000,Public       ,1,4,5,10,15,25
02265900,WINDHAM COMMUNITY MEM HOSP-RAD TECH     ,CT,06226-0000,Private      ,4,10,14,9,20,29
02296100,YALE-NEW HAVEN HOSP DIETETIC INTERN     ,CT,06510-8900,Private      ,1,14,15,8,44,52
02300000,W F KAYNOR TECHNICAL HIGH SCHOOL        ,CT,06708-0000,Public       ,4,33,37,10,58,68
02316600,CONNECTICUT CTR FOR MASSAGE THERAPY     ,CT,06111-3975,Proprietary  ,18,53,71,30,84,114
02316601,CONNECTICUT CENTER FOR MASSAGE THERAPY -,CT,06880-4619,Proprietary  ,6,22,28,11,40,51
02316603,CONNECTICUT CENTER FOR MASSAGE THERAPY -,CT,06340-4619,Proprietary  ,8,17,25,14,41,55
02565000,PLATT TECHNICAL HIGH SCHOOL             ,CT,06460-2105,Public       ,3,10,13,9,16,25
03094800,INDUSTRIAL MANAGEMENT & TRAINING        ,CT,06706-1211,Proprietary  ,4,33,37,11,67,78
03234300,CHARTER OAK STATE COLLEGE               ,CT,06053-2150,Public       ,38,635,673,113,1479,1592
03316300,LINCOLN TECHNICAL INSTITUTE - HARTFORD  ,CT,06105-3630,Proprietary  ,97,119,216,222,224,446
03927300,MARINELLO SCHOOL OF BEAUTY              ,CT,06357-2447,Proprietary  ,8,15,23,11,26,37
03927301,MARINELLO SCHOOL OF BEAUTY  - TORRINGTON,CT,06790-5425,Proprietary  ,9,14,23,13,18,31
04104300,ACADEMY DI CAPELLI - SCHOOL OF COSMETOLO,CT,06492-0000,Proprietary  ,18,26,44,29,38,67
04128800,BRANFORD ACADEMY OF HAIR & COSMETOLOGY  ,CT,06405-0000,Proprietary  ,13,21,34,18,32,50
04145400,OXFORD ACADEMY OF HAIR DESIGN           ,CT,06483-2911,Proprietary  ,13,21,34,15,26,41
04148400,EUROPEAN ACADEMY OF COSMETOLOGY AND HAIR,CT,06437-0000,Proprietary  ,8,3,11,12,6,18
04152400,INTERNATIONAL INSTITUTE OF COSMETOLOGY  ,CT,06109-0000,Proprietary  ,29,21,50,56,39,95
04219200,ACE COSMETOLOGY & BARBERING TRAINING CEN,CT,06716-0000,Proprietary  ,6,16,22,9,23,32
04224200,BELLE ACADEMY OF COSMETOLOGY            ,CT,06704-0135,Proprietary  ,8,26,34,13,46,59
04230900,RICCI'S ACADEMY OF COSMETOLOGY          ,CT,06470-0000,Proprietary  ,6,17,23,22,23,45
00146600,BARRY UNIVERSITY                        ,FL,33161-6695,Private      ,1054,2724,3778,4108,5859,9967
00146601,BARRY UNIVERSITY - ORLANDO              ,FL,32807-3673,Private      ,97,578,675,326,1333,1659
00146700,BETHUNE COOKMAN UNIVERSITY              ,FL,32114-3099,Private      ,1947,652,2599,6956,1650,8606
00146800,ST THOMAS UNIVERSITY                    ,FL,33054-0000,Private      ,406,943,1349,1289,2014,3303
00146900,FLORIDA INSTITUTE OF TECHNOLOGY         ,FL,32901-6988,Private      ,924,3018,3942,4558,5643,10201
00147000,EASTERN FLORIDA STATE COLLEGE           ,FL,32922-6503,Public       ,2113,3461,5574,4140,6207,10347
00147100,COLLEGE OF CENTRAL FLORIDA              ,FL,34474-4415,Public       ,1477,2211,3688,3279,4663,7942
00147200,CHIPOLA  COLLEGE                        ,FL,32446-2053,Public       ,401,455,856,768,819,1587
00147300,CLEARWATER CHRISTIAN COLLEGE            ,FL,33759-0000,Private      ,126,63,189,486,134,620
00147500,DAYTONA STATE COLLEGE                   ,FL,32114-2800,Public       ,2446,3575,6021,5331,7349,12680
00147700,FLORIDA SOUTHWESTERN STATE COLLEGE      ,FL,33919-5566,Public       ,2953,3345,6298,6120,6099,12219
00147800,EDWARD WATERS COLLEGE                   ,FL,32209-6199,Private      ,438,353,791,1121,740,1861
00147900,EMBRY-RIDDLE AERONAUTICAL UNIV          ,FL,32114-3900,Private      ,1479,2935,4414,7261,6582,13843
00148000,FLORIDA A & M UNIVERSITY                ,FL,32307-3100,Public       ,3196,2158,5354,14077,6338,20415
00148100,FLORIDA ATLANTIC UNIVERSITY             ,FL,33431-6498,Public       ,6524,5784,12308,23893,13454,37347
00148101,FLORIDA ATLANTIC UNIVERSITY/DAVIE       ,FL,33314-0000,Public       ,973,1681,2654,2630,3911,6541
00148103,FLORIDA ATLANTIC UNIV-JUPITER/PSL       ,FL,33458-0000,Public       ,380,430,810,1385,1001,2386
00148200,FLORIDA COLLEGE                         ,FL,33617-5578,Private      ,197,26,223,468,56,524
00148400,FLORIDA STATE COLLEGE AT JACKSONVILLE   ,FL,32202-4030,Public       ,4405,8283,12688,9412,16915,26327
00148500,FLORIDA KEYS COMMUNITY COLLEGE          ,FL,33040-4397,Public       ,207,222,429,429,416,845
00148600,FLORIDA MEMORIAL UNIVERSITY             ,FL,33054-6199,Private      ,901,489,1390,2614,1117,3731
00148700,ECKERD COLLEGE                          ,FL,33711-4744,Private      ,459,272,731,3125,627,3752
00148800,FLORIDA SOUTHERN COLLEGE                ,FL,33801-5698,Private      ,975,472,1447,4269,980,5249
00148900,FLORIDA STATE UNIVERSITY                ,FL,32306-2430,Public       ,9123,4986,14109,43669,14650,58319
00149000,GULF COAST STATE COLLEGE                ,FL,32401-1058,Public       ,808,1510,2318,1879,3038,4917
00149300,INDIAN RIVER STATE COLLEGE              ,FL,34981-5596,Public       ,2729,3586,6315,5200,6817,12017
00149500,JACKSONVILLE UNIVERSITY                 ,FL,32211-3394,Private      ,923,1325,2248,3335,2989,6324
00149700,JONES COLLEGE                           ,FL,32205-5395,Private      ,32,253,285,74,548,622
00149900,EVEREST UNIVERSITY                      ,FL,32810-5601,Proprietary  ,109,854,963,276,2464,2740
00149901,EVEREST UNIVERSITY - ORLANDO SOUTH      ,FL,32819-7666,Proprietary  ,264,3527,3791,612,8613,9225
00149902,EVEREST UNIVERSITY - MELBOURNE          ,FL,32905-6609,Proprietary  ,23,253,276,59,511,570
00149904,EVEREST UNIVERSITY - TAMPA              ,FL,33614-5801,Proprietary  ,106,552,658,233,1405,1638
00149905,EVEREST UNIVERSITY - BRANDON            ,FL,33619-1354,Proprietary  ,94,849,943,180,1976,2156
00149906,EVEREST UNIVERSITY - ORANGE PARK        ,FL,32073-1111,Proprietary  ,28,228,256,61,534,595
00149907,EVEREST UNIVERSITY - LARGO              ,FL,33770-2556,Proprietary  ,33,179,212,45,389,434
00149908,EVEREST UNIVERSITY - LAKELAND           ,FL,33801-3801,Proprietary  ,51,279,330,92,527,619
00149909,EVEREST UNIVERSITY - JACKSONVILLE       ,FL,32256-0000,Proprietary  ,76,415,491,173,872,1045
00149910,EVEREST UNIVERSITY - POMPANO            ,FL,33062-2522,Proprietary  ,44,485,529,82,936,1018
00150000,BROWARD COLLEGE- DOWNTOWN CTR           ,FL,33301-2298,Public       ,8265,11016,19281,18118,23149,41267
00150100,FLORIDA GATEWAY COLLEGE                 ,FL,32025-2007,Public       ,369,810,1179,822,1460,2282
00150200,LAKE SUMTER COMMUNITY COLLEGE           ,FL,34788-8751,Public       ,858,942,1800,1983,2021,4004
00150400,"STATE COLLEGE OF FLORIDA, MANATEE-SARASO",FL,34207-3596,Public       ,1805,2391,4196,3850,4757,8607
00150500,LYNN UNIVERSITY                         ,FL,33431-5598,Private      ,527,421,948,2607,895,3502
00150600,MIAMI DADE COLLEGE ADMINISTRATION ONLY  ,FL,33176-3393,Public       ,186,295,481,414,609,1023
00150601,MIAMI DADE COLLEGE - NORTH CAMPUS       ,FL,33167-3495,Public       ,4644,5601,10245,10762,10713,21475
00150602,MIAMI DADE COLLEGE - KENDALL CAMPUS     ,FL,33176-3393,Public       ,7481,5700,13181,15350,10429,25779
00150603,MIAMI DADE COLLEGE - WOLFSON CAMPUS     ,FL,33132-2297,Public       ,3955,4083,8038,8981,7885,16866
00150604,MIAMI DADE COLLEGE - MEDICAL CAMPUS     ,FL,33127-4693,Public       ,1305,2657,3962,3011,4965,7976
00150605,MIAMI DADE COLLEGE - HOMESTEAD CAMPUS   ,FL,33030-6009,Public       ,1184,1421,2605,2505,2672,5177
00150606,MIAMI DADE COLLEGE -INTERAMERICAN CAMPUS,FL,33135-0000,Public       ,1686,2708,4394,3376,4853,8229
00150607,MIAMI DADE COLLEGE - HIALEAH CAMPUS     ,FL,33012-2918,Public       ,1887,1991,3878,3953,3456,7409
00150800,NORTH FLORIDA COMMUNITY COLLEGE         ,FL,32340-1699,Public       ,139,279,418,327,507,834
00150900,NOVA SOUTHEASTERN UNIVERSITY            ,FL,33314-7796,Private      ,1559,8244,9803,6408,20745,27153
00151000,NORTHWEST FLORIDA STATE COLLEGE         ,FL,32578-1295,Public       ,640,1341,1981,1428,2776,4204
00151200,PALM BEACH COMMUNITY COLLEGE            ,FL,33461-4796,Public       ,5663,5656,11319,10917,10267,21184
00151300,PENSACOLA STATE COLLEGE                 ,FL,32504-8998,Public       ,1437,2573,4010,3198,5198,8396
00151400,POLK STATE COLLEGE                      ,FL,33881-4256,Public       ,2025,3075,5100,3891,5783,9674
00151500,ROLLINS COLLEGE                         ,FL,32789-4499,Private      ,520,399,919,3083,987,4070
00151900,SANTA FE COLLEGE                        ,FL,32606-6200,Public       ,3094,2752,5846,7967,6063,14030
00152000,SEMINOLE STATE COLLEGE OF FLORIDA       ,FL,32773-6199,Public       ,3224,4176,7400,6647,8128,14775
00152100,SOUTHEASTERN UNIVERSITY                 ,FL,33801-6099,Private      ,1291,781,2072,4163,1532,5695
00152200,SOUTH FLORIDA COMMUNITY COLLEGE         ,FL,33825-9399,Public       ,517,650,1167,1071,1228,2299
00152300,SAINT JOHNS RIVER STATE COLLEGE         ,FL,32177-3897,Public       ,999,1514,2513,2117,3040,5157
00152600,SAINT LEO UNIVERSITY                    ,FL,33574-6665,Private      ,786,5474,6260,4333,12955,17288
00152800,ST. PETERSBURG COLLEGE                  ,FL,33760-3768,Public       ,3778,8244,12022,7533,16523,24056
00153100,STETSON UNIVERSITY                      ,FL,32723-3761,Private      ,634,246,880,6387,827,7214
00153101,STETSON UNIVERSITY - COLLEGE OF LAW     ,FL,33707-3299,Private      ,27,477,504,107,1426,1533
00153300,TALLAHASSEE COMMUNITY COLLEGE           ,FL,32304-2895,Public       ,3280,2834,6114,7917,5753,13670
00153500,UNIVERSITY OF FLORIDA                   ,FL,32611-3150,Public       ,7113,5521,12634,42682,17672,60354
00153600,UNIVERSITY OF MIAMI                     ,FL,33146-6531,Private      ,2092,1713,3805,20937,5338,26275
00153601,UNIV OF MIAMI SCHOOL OF LAW             ,FL,33124-0000,Private      ,24,415,439,146,1477,1623
00153602,UNIV OF MIAMI-SCH OF MEDICINE           ,FL,33136-0000,Private      ,187,529,716,764,1567,2331
00153700,UNIVERSITY OF SOUTH FLORIDA             ,FL,33620-6960,Public       ,7384,7251,14635,38176,20553,58729
00153701,UNIV OF SOUTH FLORIDA-ST PETERSBURG     ,FL,33701-0000,Public       ,987,1146,2133,4346,2869,7215
00153702,UNIV OF SOUTH FLORIDA-SARASOTA          ,FL,34243-2025,Public       ,312,533,845,1157,1371,2528
00153705,UNIV OF SOUTH FLORIDA                   ,FL,33803-0000,Public       ,247,305,552,874,708,1582
00153706,UNIV OF SOUTH FLORIDA- MEDICINE         ,FL,33612-0000,Public       ,296,550,846,1195,2033,3228
00153800,UNIVERSITY OF TAMPA                     ,FL,33606-1490,Private      ,2393,1253,3646,13730,2995,16725
00154000,WEBBER INTERNATIONAL UNIVERSITY         ,FL,33827-0096,Private      ,428,148,576,1250,301,1551
00173308,NATIONAL-LOUIS UNIVERSITY               ,FL,33609-0000,Private      ,4,37,41,20,68,88
00177201,TRINITY INTERNATIONAL UNIVERSITY - SOUTH,FL,33324-4611,Private      ,18,123,141,47,309,356
00395400,UNIV OF CENTRAL FLORIDA                 ,FL,32816-0001,Public       ,15096,10014,25110,61456,25739,87195
00395500,UNIVERSITY OF WEST FLORIDA              ,FL,32514-5750,Public       ,2137,2473,4610,8434,6325,14759
00407215,NORTHWOOD UNIVERSITY                    ,FL,33409-0000,Private      ,140,94,234,504,257,761
00491005,KAPLAN COLLEGE JACKSONVILLE             ,FL,32216-3216,Proprietary  ,50,737,787,127,1466,1593
00558500,LIVELY TECHNICAL CENTER                 ,FL,32304-0000,Public       ,166,539,705,334,1033,1367
00558600,LINDSEY HOPKINS TECHNICAL ED CENTER     ,FL,33127-4692,Public       ,110,349,459,185,568,753
00559400,D G ERWIN TECHNICAL CENTER              ,FL,33610-8255,Public       ,221,648,869,423,1231,1654
00560500,PINELLAS TECH ED CTR-CLEARWATER         ,FL,33760-2194,Public       ,118,436,554,212,775,987
00560700,SARASOTA COUNTY TECHNICAL INSTITUTE     ,FL,34233-0000,Public       ,143,303,446,260,548,808
00560800,MAYNARD A. TRAVISS CAREER CENTER        ,FL,33803-9709,Public       ,154,432,586,242,744,986
00561200,MANATEE TECHNICAL INSTITUTE             ,FL,34210-0000,Public       ,191,467,658,313,806,1119
00561201,MANATEE TECHNICAL INSTITUTE-EAST        ,FL,34211-0000,Public       ,98,227,325,188,469,657
00675000,VALENCIA COMMUNITY COLLEGE              ,FL,32802-3028,Public       ,10364,8814,19178,24725,18696,43421
00732910,ITT TECHNICAL INSTITUTE                 ,FL,33634-7515,Proprietary  ,301,1406,1707,493,2440,2933
00732947,ITT TECHNICAL INSTITUTE                 ,FL,32746-1607,Proprietary  ,133,597,730,212,1125,1337
00736206,MEDTECH COLLEGE - MEDTECH INSTITUTE - OR,FL,32826-4906,Proprietary  ,99,365,464,181,760,941
00752500,SUWANNEE-HAMILTON AREA VOC TECH CTR     ,FL,32060-0000,Public       ,19,74,93,37,156,193
00752600,WASHINGTON HOLMES TECHNICAL CENTER      ,FL,32428-1699,Public       ,75,177,252,113,271,384
00755800,LEE COUNTY HIGH TECH CENTER CENTRAL     ,FL,33916-2299,Public       ,164,337,501,293,575,868
00787000,HILLSBOROUGH COMMUNITY COLLEGE          ,FL,33606-3572,Public       ,6618,9148,15766,12608,16587,29195
00789300,FLAGLER COLLEGE                         ,FL,32085-1027,Private      ,977,276,1253,4014,585,4599
00789301,FLAGLER COLLEGE - TALLAHASSEE COMMUNITY ,FL,32304-2895,Private      ,176,348,524,412,656,1068
00807500,ST JOHN VIANNEY COLLEGE SEMINARY        ,FL,33165-3244,Private      ,8,13,21,21,22,43
00822300,ST VINCENT DE PAUL REGIONL SEMINARY     ,FL,33436-0000,Private      ,1,0,1,3,8,11
00841700,STENOTYPE INST OF JACKSONVILLE          ,FL,32207-0000,Proprietary  ,7,53,60,14,114,128
00869410,RASMUSSEN COLLEGE - OCALA               ,FL,34471-7051,Proprietary  ,291,2601,2892,574,4971,5545
00869411,RASMUSSEN COLLEGE - NEW PORT RICHEY     ,FL,34690-4554,Proprietary  ,79,472,551,112,866,978
00869413,RASMUSSEN COLLEGE - FORT MYERS          ,FL,33905-7805,Proprietary  ,111,552,663,219,1017,1236
00869420,RASMUSSEN COLLEGE - TAMPA               ,FL,33610-9558,Proprietary  ,63,503,566,153,933,1086
00869422,RASMUSSEN COLLEGE - PASCO               ,FL,33558-0000,Proprietary  ,30,171,201,51,294,345
00884800,WARNER UNIVERSITY                       ,FL,33859-8725,Private      ,337,265,602,857,500,1357
00884900,PALM BEACH ATLANTIC UNIVERSITY          ,FL,33401-6505,Private      ,1079,977,2056,3448,1914,5362
00887800,MIAMI INTERNATIONAL UNIV ART&DESIGN     ,FL,33132-1418,Proprietary  ,575,654,1229,1423,1368,2791
00910400,TONI & GUY HAIRDRESSING ACADEMY         ,FL,32256-3810,Proprietary  ,14,32,46,34,70,104
00963500,FLORIDA INTERNATIONAL UNIVERSITY        ,FL,33199-0001,Public       ,9890,10320,20210,38052,27820,65872
00984100,UNIVERSITY OF NORTH FLORIDA             ,FL,32224-2645,Public       ,3949,3290,7239,13754,7400,21154
00990200,SHERIDAN TECHNICAL CENTER               ,FL,33021-3399,Public       ,238,704,942,449,1285,1734
01016100,"LORAINE'S ACADEMY, INC                  ",FL,33710-0000,Proprietary  ,14,80,94,28,118,146
01019500,ART INSTITUTE OF FT LAUDERDALE          ,FL,33316-3000,Proprietary  ,484,576,1060,1126,1044,2170
01065200,PASCO-HERNANDO COMMUNITY CLG            ,FL,34654-5199,Public       ,2219,2660,4879,4189,4939,9128
01072401,CARLOS ALBIZU UNIVERSITY                ,FL,33172-0000,Private      ,37,361,398,87,657,744
01082600,TOM P. HANEY TECHNICAL CENTER           ,FL,32405-5099,Public       ,113,375,488,177,684,861
01112700,GOODING INST OF NUR ANES BAY MED CT     ,FL,32401-0000,Proprietary  ,9,30,39,15,78,93
01226300,ATLANTIC TECHNICAL CENTER               ,FL,33063-3902,Public       ,230,458,688,407,888,1295
01246117,LINCOLN COLLEGE OF TECHNOLOGY - WEST PAL,FL,33407-3105,Proprietary  ,213,314,527,364,488,852
01254400,FIRST COAST TECHNICAL COLLEGE           ,FL,32084-1921,Public       ,153,293,446,284,595,879
01257400,RINGLING SCHOOL OF ART AND DESIGN       ,FL,34234-5895,Private      ,325,94,419,1840,347,2187
01303904,SOUTH UNIVERSITY - WEST PALM BEACH CAMPU,FL,33409-5149,Proprietary  ,178,753,931,402,1357,1759
01323400,LORENZO WALKER INST OF TECHNOLOGY       ,FL,34104-4405,Public       ,143,249,392,258,436,694
02089600,CONCORDE CAREER INSTITUTE               ,FL,32211-0000,Proprietary  ,98,446,544,151,813,964
02113609,AMERICAN INTERCONTINENTAL UNIV - WESTON ,FL,33326-3233,Proprietary  ,5,62,67,14,133,147
02115300,PINELLAS TECHNICAL EDUCATION CENTERS - S,FL,33711-0000,Public       ,139,529,668,270,1054,1324
02116006,SANFORD-BROWN INSTITUTE - FT. LAUDERDALE,FL,33309-1906,Proprietary  ,63,212,275,129,396,525
02148200,FASHION FOCUS HAIR ACADEMY              ,FL,34231-0000,Proprietary  ,10,44,54,19,64,83
02148300,MANHATTAN BEAUTY SCHOOL                 ,FL,33611-0000,Proprietary  ,7,14,21,23,68,91
02149900,PAUL MITCHELL THE SCHOOL-JACKSONVILLE   ,FL,32205-0000,Proprietary  ,40,103,143,87,194,281
02151900,KEISER  UNIVERSITY                      ,FL,33309-0000,Private      ,1847,7601,9448,3408,12905,16313
02156300,MARGATE SCHOOL OF BEAUTY                ,FL,33063-0000,Proprietary  ,2,2,4,2,2,4
02159600,BAPTIST COLLEGE OF FLORIDA (THE)        ,FL,32440-0000,Private      ,86,117,203,156,184,340
02172700,CONCORDE CAREER INSTITUTE               ,FL,33607-0000,Proprietary  ,58,241,299,106,428,534
02188900,HOBE SOUND BIBLE COLLEGE                ,FL,33475-0000,Private      ,24,33,57,51,58,109
02200100,BRADENTON BEAUTY & BARBER ACADEMY       ,FL,34209-0000,Proprietary  ,15,64,79,17,97,114
02215900,ATI CAREER TRAINING CENTER              ,FL,33309-1785,Proprietary  ,11,47,58,26,99,125
02218700,FLORIDA TECHNICAL COLLEGE               ,FL,32826-2707,Proprietary  ,458,1456,1914,736,2262,2998
02218707,FLORIDA TECHNICAL COLLEGE - LAKELAND    ,FL,33813-2101,Proprietary  ,64,170,234,174,352,526
02218709,FLORIDA TECHNICAL COLLEGE - DELAND      ,FL,32720-7415,Proprietary  ,76,349,425,119,548,667
02228300,LAKE TECHNICAL CENTER                   ,FL,32726-0000,Public       ,169,414,583,337,792,1129
02245500,FORTIS COLLEGE                          ,FL,32789-4679,Proprietary  ,22,188,210,33,323,356
02257900,INTERNATIONAL ACADEMY                   ,FL,32119-3541,Proprietary  ,24,111,135,38,143,181
02275100,CONCORDE CAREER INSTITUTE               ,FL,33025-0000,Proprietary  ,44,168,212,78,289,367
02278800,SOUTHWEST FLORIDA COLLEGE               ,FL,33907-0000,Proprietary  ,361,672,1033,1091,1496,2587
02278801,SOUTHWEST FLORIDA COLLEGE - TAMPA       ,FL,33619-1344,Proprietary  ,124,363,487,301,630,931
02278802,SOUTHWEST FLORIDA COLLEGE - INSTITUTUE O,FL,33928-9469,Proprietary  ,29,53,82,62,96,158
02278803,SOUTHWEST FLORIDA COLLEGE - PORT CHARLOT,FL,33953-3100,Proprietary  ,82,169,251,170,413,583
02279600,CORTIVA INSTITUTE - FLORIDA             ,FL,33781-0000,Proprietary  ,37,92,129,48,148,196
02283800,BEAUTY SCHOOLS OF AMERICA               ,FL,33012-3322,Proprietary  ,99,487,586,146,642,788
02286502,ITT TECHNICAL INSTITUTE                 ,FL,32244-6630,Proprietary  ,0,0,0,0,1,1
02287100,LA BELLE BEAUTY SCHOOL                  ,FL,33012-3224,Proprietary  ,6,31,37,15,36,51
02293200,ATI CAREER TRAINING CENTER              ,FL,33309-5916,Proprietary  ,4,14,18,7,26,33
02293201,ATI CAREER TRAINING CENTER - MIAMI      ,FL,33122-1707,Proprietary  ,18,40,58,42,93,135
02293202,ATI CAREER TAINING CENTER - ATI COLLEGE ,FL,87109-2016,Proprietary  ,13,47,60,34,99,133
02293600,ADVANCED TECHNICAL CENTERS              ,FL,33266-1597,Private      ,10,34,44,41,74,115
02297000,CHARLOTTE TECHNICAL CENTER              ,FL,33948-0000,Public       ,77,126,203,132,249,381
02300900,WITHLACOOCHEE TECHNICAL INSTITUTE       ,FL,34450-0000,Public       ,81,217,298,128,362,490
02305800,FLORIDA CAREER COLLEGE                  ,FL,33012-7028,Proprietary  ,299,1611,1910,390,2172,2562
02305810,FLORIDA CAREER COLLEGE - CLEARWATER     ,FL,33759-3924,Proprietary  ,0,1,1,19,79,98
02307400,GEORGE STONE AREA VOCATIONAL TECHNICAL  ,FL,32526-0000,Public       ,91,340,431,184,689,873
02314100,SCHILLER INTERNATIONAL UNIVERSITY       ,FL,33770-0000,Proprietary  ,10,89,99,37,173,210
02316200,MIAMI LAKES TECHNICAL EDUCATION CTR     ,FL,33014-0000,Public       ,119,338,457,230,601,831
02321200,ORANGE TECH EDUC CTR- WESTSIDE TECH     ,FL,34787-0000,Public       ,104,226,330,178,385,563
02325100,KEY COLLEGE                             ,FL,33004-3046,Proprietary  ,5,34,39,8,50,58
02326303,MEDVANCE INSTITUTE - WEST PALM          ,FL,33461-2171,Proprietary  ,13,32,45,19,68,87
02326306,MEDVANCE INSTITUTE - MIAMI              ,FL,33173-3431,Proprietary  ,3,13,16,21,40,61
02326800,MERIDIAN COLLEGE                        ,FL,34240-8478,Proprietary  ,25,142,167,45,189,234
02326900,SUNSTATE ACADEMY OF HAIR DESIGN         ,FL,33907-1415,Proprietary  ,64,150,214,91,246,337
02329900,FLORIDA INSTITUTE OF ULTRASOUND         ,FL,32514-0000,Proprietary  ,35,101,136,72,206,278
02338400,FT PIERCE BEAUTY ACADEMY                ,FL,34982-0000,Proprietary  ,17,92,109,30,123,153
02346200,WYOTECH                                 ,FL,32174-1010,Proprietary  ,51,149,200,93,251,344
02362100,FULL SAIL UNIVERSITY                    ,FL,32792-0000,Proprietary  ,4227,7488,11715,10456,15621,26077
02499000,ACADEMY OF COSMETOLOGY                  ,FL,32953-3311,Proprietary  ,15,55,70,30,97,127
02501500,"O*TEC, MID-FLORIDA TECH                 ",FL,32809-0000,Public       ,148,424,572,281,803,1084
02504600,WINTER PARK TECH                        ,FL,32789-0000,Public       ,54,148,202,103,293,396
02508900,TALMUDIC COLLEGE OF FLORIDA             ,FL,33139-0000,Private      ,2,5,7,7,6,13
02511700,RIDGE TECHNICAL CENTER                  ,FL,33881-0000,Public       ,106,287,393,178,540,718
02513200,ORLANDO TECHNICAL CENTER                ,FL,32801-0000,Public       ,148,430,578,321,898,1219
02515400,CITY COLLEGE                            ,FL,33309-3073,Private      ,225,838,1063,340,1443,1783
02517100,SARASOTA SCHOOL OF MASSAGE THERAPY      ,FL,34243-6130,Proprietary  ,13,62,75,27,93,120
02524000,SUNSTATE ACADEMY OF HAIR DESIGN         ,FL,34624-0000,Proprietary  ,18,83,101,35,106,141
02524002,SUNSTATE ACADEMY - JONES TECHNICAL INSTI,FL,32256-0367,Proprietary  ,44,102,146,58,137,195
02524200,ROBERT MORGAN EDUCATIONAL CENTER        ,FL,33177-0000,Public       ,99,205,304,218,425,643
02531803,PAUL MITCHELL THE SCHOOL - ORLANDO      ,FL,32765-6444,Proprietary  ,53,90,143,115,170,285
02531805,PAUL MITCHELL THE SCHOOL -TAMPA         ,FL,33613-0000,Proprietary  ,68,102,170,126,209,335
02547600,FLORIDA NATIONAL COLLEGE                ,FL,33012-0000,Proprietary  ,215,700,915,292,1076,1368
02547601,FLORIDA NATIONAL UNIVERSITY - SOUTH CAMP,FL,33175-2478,Proprietary  ,284,650,934,543,1047,1590
02547602,FLORIDA NATIONAL UNIVERSITY - TRAINING A,FL,33012-4108,Proprietary  ,54,152,206,89,270,359
02554200,RADFORD LOCKLIN TECH CENTER             ,FL,32570-0000,Public       ,31,148,179,63,247,310
02573200,LA BELLE BEAUTY ACADEMY                 ,FL,33135-0000,Proprietary  ,36,133,169,63,189,252
02597100,HERITAGE INSTITUTE                      ,FL,33912-7132,Proprietary  ,150,309,459,275,525,800
02598200,SOUTHERN CAREER COLLEGE                 ,FL,32225-9828,Proprietary  ,35,228,263,54,339,393
02601600,HENRY W BREWSTER TECHNICAL CENTER       ,FL,33602-0000,Public       ,42,200,242,75,342,417
02612700,"SALON PROFESSIONAL ACADEMY - MELBOURNE, ",FL,32904-3919,Proprietary  ,27,65,92,49,117,166
02616400,SANFORD-BROWN INSTITUTE                 ,FL,32256-3520,Proprietary  ,44,184,228,112,434,546
02616705,LE CORDON BLEU COLLEGE OF CULINARY ARTS ,FL,33025-3929,Proprietary  ,95,146,241,254,351,605
03003600,MCFATTER TECHNICAL CENTER               ,FL,33317-7499,Public       ,198,391,589,374,734,1108
03008600,FLORIDA COLLEGE OF NATURAL HEALTH       ,FL,33064-1342,Proprietary  ,48,180,228,79,267,346
03010608,VIRGINIA COLLEGE - PENSACOLA            ,FL,32501-5650,Proprietary  ,43,187,230,108,488,596
03010612,VIRGINIA COLLEGE - GOLF ACADEMY OF AMERI,FL,32701-0000,Proprietary  ,7,20,27,14,46,60
03010618,VIRGINIA COLLEGE - JACKSONVILLE         ,FL,32207-5167,Proprietary  ,40,214,254,102,496,598
03012300,ASM BEAUTY WORLD ACADEMY                ,FL,33021-0000,Proprietary  ,9,53,62,16,66,82
03018500,BENE'S INTERNATIONAL SCHOOL OF BEAUTY   ,FL,34652-1636,Proprietary  ,44,117,161,61,217,278
03026508,REMINGTON COLLEGE - TAMPA               ,FL,33619-1177,Private      ,37,143,180,77,333,410
03028200,TRINITY COLLEGE OF FLORIDA              ,FL,34655-4401,Private      ,78,88,166,155,140,295
03031400,INTERNATIONAL ACADEMY OF DESIGN AND TECH,FL,33634-6313,Proprietary  ,237,779,1016,465,1598,2063
03031402,INTERNATIONAL ACADEMY OF DESIGN AND TECH,FL,32809-4613,Proprietary  ,79,124,203,142,234,376
03031403,IADT - ORLANDO CULINARY ACADEMY         ,FL,32819-0000,Proprietary  ,139,302,441,229,446,675
03035800,HERITAGE INSTITUTE                      ,FL,32216-0948,Proprietary  ,24,153,177,47,273,320
03035900,NATIONAL AVIATION ACADEMY               ,FL,33760-3931,Proprietary  ,133,291,424,260,552,812
03037500,HODGES UNIVERSITY                       ,FL,34119-7932,Private      ,214,985,1199,431,1793,2224
03071600,COLLEGE OF BUSINESS & TECHNOLOGY        ,FL,33176-0000,Proprietary  ,76,365,441,158,573,731
03078003,OHIO CENTER FOR BROADCASTING - MIAMI MED,FL,33130-3042,Proprietary  ,14,40,54,24,68,92
03079800,GEORGE T BAKER AVIATION                 ,FL,33142-5687,Public       ,144,171,315,238,296,534
03079900,CITY COLLEGE                            ,FL,32714-3129,Private      ,59,278,337,99,442,541
03089200,NOUVELLE INSTITUTE                      ,FL,33125-4141,Proprietary  ,8,95,103,12,104,116
03096300,FORTIS INSTITUTE                        ,FL,33860-0000,Proprietary  ,2,11,13,6,26,32
03099600,MERCY HOSPITAL SCHOOL OF PRACTICAL NSG  ,FL,33133-4237,Proprietary  ,27,76,103,69,167,236
03100800,TAYLOR TECHNICAL INSTITUTE              ,FL,32348-0894,Public       ,19,53,72,35,90,125
03101900,TRINITY BAPTIST COLLEGE                 ,FL,32221-1398,Private      ,173,123,296,331,218,549
03103900,MARION COUNTY COMMUNITY TECH & ADUL     ,FL,34474-3172,Public       ,137,483,620,281,964,1245
03108500,EVERGLADES UNIVERSITY                   ,FL,33431-0000,Private      ,80,619,699,139,1019,1158
03108600,COM-PU-MED VOCATIONAL CAREERS           ,FL,33012-4861,Proprietary  ,17,97,114,24,120,144
03113400,ACADEMY OF HEALING ARTS                 ,FL,33463-2113,Proprietary  ,12,56,68,22,114,136
03114700,PRAXIS INSTITUTE                        ,FL,33135-2657,Proprietary  ,11,80,91,12,92,104
03115500,ADVENTIST UNIVERSITY OF HEALTH SCIENCES ,FL,32803-1237,Private      ,415,839,1254,1086,1735,2821
03123900,SOUTHEASTERN COLLEGE                    ,FL,33413-0000,Proprietary  ,66,378,444,89,591,680
03125600,MIAMI AD SCHOOL                         ,FL,33139-5203,Proprietary  ,24,116,140,72,250,322
03127900,TECHNICAL EDUCATION CTR OSCEOLA         ,FL,34744-4459,Public       ,157,369,526,298,634,932
03158300,LEE COUNTY HIGH TECH CENTER NORTH       ,FL,33993-2479,Public       ,66,115,181,109,230,339
03171300,UNIVERSITY OF ST. AUGUSTINE FOR HEALTH S,FL,32084-4215,Proprietary  ,29,529,558,84,1287,1371
03224300,NEW PROFESSIONS TECHNICAL INSTITUTE     ,FL,33134-1640,Proprietary  ,12,157,169,35,247,282
03230300,CHOICE HIGH SCHOOL AND TECHNICAL CENTER ,FL,32547-1299,Public       ,36,128,164,66,270,336
03238300,FLORIDA COLLEGE OF INTEGRATIVE MED      ,FL,32809-5721,Proprietary  ,29,121,150,74,236,310
03255300,FLORIDA GULF COAST UNIVERSITY           ,FL,33965-6565,Public       ,3779,1791,5570,17811,4771,22582
03256300,YESHIVA GEDOLAH RABBINICAL COLLEGE      ,FL,33139-4708,Private      ,0,5,5,2,6,8
03264300,SOUTH FLORIDA BIBLE COLLEGE AND THEOLOGI,FL,33441-5768,Private      ,5,77,82,6,105,111
03346300,ACAD FOR PRAC NURSING & HEALTH OCCP     ,FL,33417-4574,Private      ,56,298,354,152,543,695
03348400,PROFESSIONAL TRAINING CENTERS           ,FL,33184-0000,Proprietary  ,58,278,336,85,407,492
03373300,BEACON COLLEGE                          ,FL,34748-5224,Private      ,85,34,119,230,80,310
03374300,FLORIDA COASTAL SCHOOL OF LAW           ,FL,32256-0000,Proprietary  ,21,598,619,65,1429,1494
03382300,BRADFORD-UNION AREA CAREERTECHNICAL CENT,FL,32091-2434,Public       ,21,81,102,41,173,214
03390300,LINCOLN TECHNICAL INSTITUTE             ,FL,32730-2351,Proprietary  ,11,28,39,36,119,155
03411400,INTERNATIONAL TRAINING CAREERS          ,FL,33155-1462,Private      ,7,108,115,16,134,150
03414500,ACUPUNCTURE AND MASSAGE COLLEGE         ,FL,33176-1509,Proprietary  ,22,102,124,53,172,225
03429600,ATLANTIC INST OF ORIENTAL MEDICINE      ,FL,33316-0000,Private      ,8,54,62,18,113,131
03429700,EAST WEST COLLG OF NATURAL MEDICINE     ,FL,34236-4959,Proprietary  ,11,78,89,19,142,161
03433400,NEW CONCEPT MASSAGE AND BEAUTY SCHO     ,FL,33135-0000,Proprietary  ,3,35,38,8,50,58
03434300,FORTIS COLLEGE                          ,FL,32073-2999,Proprietary  ,43,194,237,87,383,470
03480301,FORTIS COLLEGE - FORTIS INSTITUTE       ,FL,33313-7261,Proprietary  ,5,40,45,13,88,101
03480302,FORTIS COLLEGE - FORTIS INSTITUTE       ,FL,34952-0000,Proprietary  ,79,242,321,110,408,518
03491400,AMERICAN ADVANCED TECHNICIANS INST      ,FL,33014-4430,Proprietary  ,23,48,71,35,89,124
03549300,ULTIMATE MEDICAL ACADEMY                ,FL,33756-4917,Proprietary  ,744,8464,9208,1180,13464,14644
03553300,SOUTHEASTERN COLLEGE                    ,FL,32216-0000,Proprietary  ,36,176,212,100,340,440
03557300,NORTH FLORIDA COSMETOLOGY INSTITUTE     ,FL,32312-0000,Proprietary  ,29,140,169,67,252,319
03570400,ENGLISH CENTER (THE)                    ,FL,33133-2703,Public       ,7,48,55,13,83,96
03611400,FLORIDA BARBER ACADEMY                  ,FL,33441-0000,Proprietary  ,12,101,113,17,143,160
03618300,FLORIDA INSTITUTE OF ANIMAL ARTS        ,FL,32792-0000,Proprietary  ,59,83,142,108,139,247
03627400,JACKSONVILLE BEAUTY INSTITUTE           ,FL,32208-1885,Proprietary  ,19,71,90,45,148,193
03627600,FLORIDA EDUCATION INSTITUTE             ,FL,33144-5036,Proprietary  ,35,118,153,68,211,279
03661400,SOUTH FLORIDA INSTITUTE OF TECHNOLO     ,FL,33135-0000,Proprietary  ,59,368,427,130,619,749
03691400,AVE MARIA SCHOOL OF LAW                 ,FL,34119-1376,Private      ,25,197,222,65,416,481
03696400,SABER                                   ,FL,33134-1604,Private      ,40,285,325,54,457,511
03698308,WEST COAST UNIVERSITY - MIAMI           ,FL,33178-2431,Proprietary  ,45,80,125,120,172,292
03706300,AMERICAN INSTITUTE                      ,FL,33319-0000,Proprietary  ,19,78,97,31,114,145
03757300,ADVANCE SCIENCE INSTITUTE               ,FL,33012-0000,Proprietary  ,3,18,21,16,35,51
03801400,BEAUTY INSTITUTE (THE)                  ,FL,33409-2972,Proprietary  ,14,41,55,33,75,108
03801401,BEAUTY INSTITUTE (THE) - MARGATE        ,FL,33068-5704,Proprietary  ,6,11,17,13,26,39
03816300,ARTISTIC NAILS & BEAUTY ACADEMY         ,FL,33605-5919,Proprietary  ,31,123,154,59,203,262
03823300,FLORIDA ACADEMY OF HEALTH & BEAUTY      ,FL,33311-0000,Proprietary  ,5,6,11,8,14,22
03832300,DADE MEDICAL COLLEGE                    ,FL,33126-5534,Proprietary  ,337,1341,1678,655,2309,2964
03842500,CAMBRIDGE INSTITUTE OF ALLIED HEALTH    ,FL,32750-0000,Proprietary  ,7,110,117,24,194,218
03856300,UNIVERSAL BEAUTY SCHOOL                 ,FL,33174-4406,Proprietary  ,16,69,85,21,69,90
03856500,FLORIDA SCHOOL OF TRADITIONAL MIDWIFERY ,FL,32601-5507,Private      ,4,43,47,24,107,131
03875300,MCI INSTITUTE OF TECHNOLOGY             ,FL,33409-4937,Proprietary  ,17,49,66,31,87,118
03888300,DRAGON RISES COLLEGE OF ORIENTAL MEDICIN,FL,32601-5089,Private      ,0,30,30,7,74,81
03903500,SOUTHERN TECHNICAL COLLEGE              ,FL,32809-0000,Proprietary  ,135,862,997,226,1386,1612
03907301,PAUL MITCHELL THE SCHOOL FT MYERS       ,FL,33907-0000,Proprietary  ,44,61,105,80,100,180
03911300,TOTAL INTERNATIONAL CAREER INSTITUTE    ,FL,33012-0000,Proprietary  ,1,0,1,4,3,7
03939300,WOLFORD COLLEGE                         ,FL,34108-1931,Proprietary  ,17,36,53,31,84,115
03939400,CENTURA INSTITUTE                       ,FL,32807-3566,Proprietary  ,23,81,104,68,211,279
03939600,DAYTONA COLLEGE                         ,FL,32174-8445,Proprietary  ,33,149,182,81,269,350
03941300,AVE MARIA UNIVERSITY                    ,FL,34142-9505,Private      ,345,50,395,1338,125,1463
03957400,NEW COLLEGE OF FLORIDA                  ,FL,34243-2109,Public       ,209,109,318,1883,296,2179
03985300,COMMERCIAL DIVING ACADEMY               ,FL,32208-0000,Proprietary  ,123,281,404,226,519,745
03986300,AVIATOR COLLEGE OF AERONAUTICAL SCIENCE ,FL,34946-9022,Proprietary  ,28,77,105,60,150,210
04016500,AMERICAN INSTITUTE OF BEAUTY            ,FL,33773-0000,Proprietary  ,22,93,115,31,154,185
04029300,TRENDSETTERS OF FLORIDA SCHOOL OF BEAUTY,FL,32205-4737,Proprietary  ,8,50,58,16,81,97
04038302,ATA COLLEGE-ATA CAREER EDUCATION        ,FL,34606-4300,Proprietary  ,38,139,177,59,242,301
04039300,SULLIVAN AND COGLIANO TRAINING CENTERS  ,FL,33014-6427,Proprietary  ,6,287,293,14,414,428
04083400,CAMBRIDGE INSTITUTE OF ALLIED HEALTH & T,FL,33484-6543,Proprietary  ,53,240,293,88,380,468
04105400,PENSACOLA SCHOOL OF MASSAGE THERAPY & HE,FL,32504-7337,Proprietary  ,10,81,91,29,158,187
04106300,PALM BEACH ACADEMY OF HEALTH & BEAUTY   ,FL,33403-2130,Proprietary  ,17,52,69,23,79,102
04116400,FUTURE-TECH INSTITUTE                   ,FL,33135-4142,Proprietary  ,11,85,96,24,106,130
04116600,TAYLOR COLLEGE                          ,FL,34420-8714,Proprietary  ,26,216,242,53,383,436
04119400,AVEDA INSTITUTE - SAINT PETERSBURG      ,FL,33701-4242,Proprietary  ,139,241,380,292,421,713
04120400,HI-TECH SCHOOL OF COSMETOLOGY           ,FL,33174-0000,Proprietary  ,27,51,78,52,94,146
04126900,ACADEMY OF CAREER TRAINING              ,FL,34741-4644,Proprietary  ,33,136,169,71,229,300
04127400,DIGITAL MEDIA ARTS COLLEGE              ,FL,33431-5919,Proprietary  ,125,84,209,226,145,371
04128400,MANAGEMENT RESOURCES INSTITUTE          ,FL,33126-5473,Proprietary  ,17,288,305,30,430,460
04129900,FLORIDA SCHOOL OF MASSAGE               ,FL,32608-5419,Proprietary  ,23,69,92,42,152,194
04130400,SHEAR EXCELLENCE INTERNATIONAL HAIR ACAD,FL,33614-2783,Proprietary  ,12,57,69,22,100,122
04133500,ACADEMY FOR FIVE ELEMENT ACUPUNCTURE    ,FL,32601-6811,Private      ,0,44,44,8,103,111
04133900,FUTURA CAREER INSTITUTE                 ,FL,33012-3325,Proprietary  ,13,85,98,13,91,104
04134800,AVEDA INSTITUTE - TALLAHASSEE           ,FL,32304-3186,Proprietary  ,122,218,340,233,393,626
04135000,COZMO THE SCHOOL                        ,FL,34135-4810,Proprietary  ,13,35,48,13,42,55
04135900,ALLIED HEALTH INSTITUTE                 ,FL,33068-0000,Proprietary  ,11,193,204,30,437,467
04140800,NORTH FLORIDA ACADEMY                   ,FL,32065-7758,Proprietary  ,8,36,44,17,56,73
04143100,PROFESSIONAL HANDS INSTITUTE            ,FL,33135-1939,Proprietary  ,0,33,33,1,48,49
04145900,CELEBRITY SCHOOL OF BEAUTY              ,FL,33144-4153,Proprietary  ,22,72,94,57,109,166
04146200,WALTON CAREER DEVELOPMENT CENTER        ,FL,32433-1557,Public       ,21,77,98,42,140,182
04146300,MARCHMAN TECHNICAL EDUCATION CENTER     ,FL,34653-1211,Public       ,69,102,171,125,215,340
04148500,MEDICAL INSTITUTE OF PALM BEACH         ,FL,33463-3276,Proprietary  ,16,37,53,35,55,90
04150800,IMMOKALEE TECHNICAL CENTER              ,FL,34142-3146,Public       ,81,59,140,151,99,250
04151500,AMERICAN ACADEMY OF COSMETOLOGY         ,FL,32065-8026,Proprietary  ,17,49,66,30,85,115
04156300,UNIVERSITY OF FORT LAUDERDALE           ,FL,33313-5809,Private      ,13,35,48,43,67,110
04156400,AVIATION INSTITUTE OF MAINTENANCE       ,FL,32803-6487,Proprietary  ,67,137,204,143,278,421
04157100,AEROSIM FLIGHT ACADEMY                  ,FL,32773-9683,Proprietary  ,53,87,140,104,167,271
04158300,FLAGLER TECHNICAL INSTITUTE             ,FL,32137-4714,Public       ,33,55,88,69,132,201
04162000,JOSE MARIA VARGAS UNIVERSITY            ,FL,33025-4534,Proprietary  ,8,30,38,14,58,72
04162500,HOLLYWOOD INSTITUTE OF BEAUTY CAREERS   ,FL,33023-6720,Proprietary  ,28,168,196,52,251,303
04163000,SALON PROFESSIONAL ACADEMY (THE)        ,FL,33624-6321,Proprietary  ,29,60,89,51,109,160
04163100,SALON PROFESSIONAL ACADEMY (THE)        ,FL,32607-1672,Proprietary  ,13,49,62,30,103,133
04163200,SALON PROFESSIONAL ACADEMY (THE)        ,FL,32162-9311,Proprietary  ,30,63,93,41,104,145
04164500,EUREKA INSTITUTE OF HEALTH AND BEAUTY   ,FL,33174-4205,Proprietary  ,4,12,16,11,22,33
04164600,D. A. DORSEY EDUCATIONAL CENTER         ,FL,33147-6304,Public       ,8,64,72,20,118,138
04167300,SALON PROFESSIONAL ACADEMY (THE)        ,FL,33904-4824,Proprietary  ,17,25,42,25,50,75
04170300,BEAUTY ACADEMY OF SOUTH FLORIDA         ,FL,33012-3221,Proprietary  ,7,48,55,16,61,77
04172300,ETERNITY COSMETOLOGY SCHOOL             ,FL,33415-5719,Proprietary  ,9,47,56,20,67,87
04176900,AMERICAN HEALTH INSTITUTE               ,FL,34654-3743,Proprietary  ,8,36,44,17,86,103
04182500,MILLENNIA ATLANTIC UNIVERSITY           ,FL,33178-2369,Proprietary  ,3,14,17,4,22,26
04188300,FLORIDA ACADEMY                         ,FL,33966-1155,Proprietary  ,33,106,139,84,183,267
04192100,AMERICAN MEDICAL ACADEMY                ,FL,33186-4830,Proprietary  ,36,103,139,96,188,284
04194000,"SCHOOL DISTRICT OF INDIAN RIVER COUNTY, ",FL,32960-3527,Public       ,49,96,145,102,182,284
04194200,APARICIO-LEVY TECHNICAL CENTER          ,FL,33610-9666,Public       ,26,66,92,50,129,179
04195100,AMBIANCE BEAUTY & BARBER ACADEMY        ,FL,32935-8771,Proprietary  ,6,38,44,17,78,95
04197600,"FLORIDA INSTITUTE OF RECORDING, SOUND AN",FL,32804-3309,Proprietary  ,64,73,137,144,159,303
04204600,BEAUTY AND HEALTH INSTITUTE             ,FL,33626-2610,Proprietary  ,28,85,113,55,159,214
04206300,FLORIDA VOCATIONAL INSTITUTE            ,FL,33155-3762,Proprietary  ,8,69,77,24,137,161
04207900,SAE INSTITUTE OF TECHNOLOGY - MIAMI     ,FL,33160-4307,Proprietary  ,47,63,110,108,139,247
04209500,SHEAR FINESSE HAIRSTYLING ACADEMY       ,FL,32208-5005,Proprietary  ,9,29,38,19,51,70
04210800,ULTRASOUND MEDICAL INSTITUTE            ,FL,33462-4221,Proprietary  ,4,13,17,7,22,29
04212600,COSMIX SCHOOL OF MAKEUP ARTISTRY        ,FL,33306-1640,Proprietary  ,31,69,100,66,134,200
04213200,KAIZEN BEAUTY ACADEMY                   ,FL,33024-6609,Proprietary  ,5,16,21,12,25,37
04214500,PRESTIGE HEALTH & BEAUTY SCIENCES ACADEM,FL,33160-4102,Proprietary  ,9,18,27,23,34,57
04216600,AZURE COLLEGE                           ,FL,33169-5345,Proprietary  ,24,217,241,63,492,555
04216900,SAN IGNACIO COLLEGE                     ,FL,33178-2350,Proprietary  ,4,9,13,9,20,29
04217800,BOCA BEAUTY ACADEMY                     ,FL,33434-4178,Proprietary  ,34,86,120,59,142,201
04220200,MORE TECH INSTITUTE                     ,FL,33012-2165,Proprietary  ,1,6,7,2,11,13
04221200,BLY'S SCHOOL OF COSMETOLOGY             ,FL,32601-4021,Proprietary  ,0,0,0,16,41,57
04223400,INTERAMERICAN TECHNICAL INSTITUTE       ,FL,00174-2950,Proprietary  ,7,46,53,22,85,107
04225000,PARISIAN SPA INSTITUTE                  ,FL,32204-4127,Proprietary  ,10,76,86,21,136,157
04225200,YECHANLAZ INSTITUTO VOCACIONAL          ,FL,33144-4817,Proprietary  ,1,15,16,2,23,25
04225800,FRED D. LEAREY TECHNICAL CENTER         ,FL,33614-1892,Public       ,32,97,129,65,175,240
04227500,MERRYFIELD SCHOOL OF PET GROOMING       ,FL,33334-4925,Proprietary  ,3,28,31,4,51,55
04228900,BEAUTY ANATOMY INSTITUTE OF COSMETOLOGY ,FL,33069-4313,Proprietary  ,6,15,21,19,34,53
04229700,FIRST COAST BARBER ACADEMY              ,FL,32210-8054,Proprietary  ,5,26,31,9,65,74
04233200,UNILATINA INTERNATIONAL COLLEGE         ,FL,33025-3943,Proprietary  ,1,6,7,4,13,17
04233400,LEE PROFESSIONAL INSTITUTE              ,FL,33916-9320,Proprietary  ,15,67,82,38,116,154
04233900,ATLANTIS UNIVERSITY                     ,FL,33132-1417,Proprietary  ,47,58,105,140,116,256
04234500,BURNETT INTERNATIONAL COLLEGE           ,FL,33426-6591,Proprietary  ,3,49,52,8,73,81
04238400,FLORIDA INTERNATIONAL TRAINING INSTITUTE,FL,33172-1507,Proprietary  ,10,29,39,25,59,84
04242000,LATIN BEAUTY ACADEMY                    ,FL,33415-6104,Proprietary  ,3,21,24,3,23,26
04243600,INTERNATIONAL HAIR AND BARBER ACADEMY   ,FL,33433-3443,Proprietary  ,5,18,23,9,24,33
00160500,CHAMINADE UNIV OF HONOLULU              ,HI,96816-1578,Private      ,340,555,895,1869,1513,3382
00160600,BRIGHAM YOUNG UNIV-HAWAII CAMPUS        ,HI,96762-1294,Private      ,410,271,681,1599,576,2175
00161000,UNIVERSITY OF HAWAII AT MANOA           ,HI,96822-2399,Public       ,1841,1962,3803,13111,7501,20612
00161100,UNIVERSITY OF HAWAII AT HILO            ,HI,96720-4091,Public       ,545,642,1187,3240,2231,5471
00161200,HONOLULU COMMUNITY COLLEGE              ,HI,96817-4598,Public       ,552,798,1350,1706,1873,3579
00161300,KAPIOLANI COMMUNITY COLLEGE             ,HI,96816-4421,Public       ,797,1098,1895,2696,2551,5247
00161400,KAUAI COMMUNITY COLLEGE                 ,HI,96766-9591,Public       ,169,229,398,455,548,1003
00161500,UNIVERSITY OF HAWAII MAUI COLLEGE       ,HI,96732-1644,Public       ,415,763,1178,1379,1751,3130
00454900,LEEWARD COMMUNITY COLLEGE               ,HI,96782-3393,Public       ,866,1093,1959,2330,2415,4745
00525800,HAWAII COMMUNITY COLLEGE                ,HI,96720-4075,Public       ,397,618,1015,1333,1672,3005
00723401,HEALD COLLEGE - HONOLULU                ,HI,96814-0000,Proprietary  ,100,181,281,443,801,1244
00727900,HAWAII PACIFIC UNIVERSITY               ,HI,96813-2882,Private      ,522,816,1338,4241,2212,6453
01122000,WINDWARD COMMUNITY COLLEGE              ,HI,96744-0000,Public       ,220,374,594,758,1059,1817
02100300,MED-ASSIST SCHOOL OF HAWAII             ,HI,96813-0000,Proprietary  ,20,61,81,72,154,226
02107800,UNIVERSITY OF HAWAII - WEST OAHU        ,HI,96707-0000,Public       ,403,702,1105,1765,1915,3680
02139500,HAWAII INSTITUTE OF HAIR DESIGN         ,HI,96817-5195,Proprietary  ,26,65,91,57,127,184
03017800,TRAVEL INSTITUTE OF THE PACIFIC         ,HI,96814-1946,Proprietary  ,13,42,55,41,94,135
03072500,WORLD MEDICINE INSTITUTE                ,HI,96826-0000,Private      ,13,45,58,37,101,138
03735300,INST OF CLINICAL ACUPUNCTURE & ORIENT MD,HI,96813-2307,Proprietary  ,4,24,28,11,65,76
04165200,MAUNA LOA HELICOPTERS                   ,HI,96740-2650,Proprietary  ,9,18,27,24,47,71
04175100,PAUL MITCHELL THE SCHOOL HONOLULU       ,HI,96816-2433,Proprietary  ,43,78,121,95,148,243
04182200,HAWAII MEDICAL INSTITUTE                ,HI,96814-3518,Proprietary  ,53,210,263,180,462,642
00161600,BOISE STATE UNIVERSITY                  ,ID,83725-1000,Public       ,1703,2718,4421,12654,8483,21137
00161700,"COLLEGE OF IDAHO, THE                   ",ID,83605-4432,Private      ,225,122,347,1685,368,2053
00161900,COLLEGE OF SOUTHERN IDAHO               ,ID,83301-0000,Public       ,634,883,1517,2557,2085,4642
00162000,IDAHO STATE UNIVERSITY                  ,ID,83209-5377,Public       ,1155,2391,3546,5058,4981,10039
00162100,LEWIS-CLARK STATE COLLEGE               ,ID,83501-2698,Public       ,274,455,729,2400,1664,4064
00162300,NORTH IDAHO COLLEGE                     ,ID,83814-2199,Public       ,412,747,1159,2465,2632,5097
00162400,NORTHWEST NAZARENE UNIVERSITY           ,ID,83686-5897,Private      ,249,407,656,1402,1009,2411
00162500,BRIGHAM YOUNG UNIVERSITY-IDAHO          ,ID,83460-1650,Private      ,5076,5348,10424,12842,9736,22578
00162600,UNIVERSITY OF IDAHO                     ,ID,83844-4291,Public       ,651,885,1536,8796,3385,12181
00732915,ITT TECHNICAL INSTITUTE                 ,ID,83713-1529,Proprietary  ,129,559,688,255,1170,1425
00987300,MR JUAN'S CLG OF HAIR DESIGN            ,ID,83301-4154,Proprietary  ,7,25,32,17,45,62
01113300,EASTERN IDAHO TECHNICAL COLLEGE         ,ID,83404-5788,Public       ,85,308,393,319,674,993
02218000,CARRINGTON COLLEGE                      ,ID,83704-0000,Proprietary  ,134,487,621,289,1031,1320
02234500,BOISE BIBLE COLLEGE                     ,ID,83714-1220,Private      ,47,38,85,138,83,221
02275800,MR LEONS SCHOOL OF HAIR DESIGN          ,ID,83843-8384,Proprietary  ,4,16,20,14,22,36
02275801,MR. LEON'S SCHOOL OF HAIR DESIGN        ,ID,83501-1910,Proprietary  ,1,7,8,4,13,17
02314000,SCHOOL OF HAIRSTYLING (THE)             ,ID,83202-0000,Proprietary  ,5,7,12,7,20,27
02319800,TONI&GUY HAIRDRESSING ACADEMY           ,ID,83814-2822,Proprietary  ,14,37,51,36,77,113
02319801,TONI&GUY HAIRDRESSING ACADEMY - BOISE   ,ID,83705-2636,Proprietary  ,23,50,73,62,88,150
02349200,HEADMASTERS SCHOOL OF HAIR DESIGN       ,ID,83501-0000,Proprietary  ,8,17,25,15,33,48
02559500,RAZZLE DAZZLE CLG OF HAIR DESIGN        ,ID,83686-5104,Proprietary  ,16,29,45,48,81,129
02607100,PAUL MITCHELL THE SCHOOL BOISE          ,ID,83709-1662,Proprietary  ,33,91,124,118,162,280
03098700,ACADEMY OF COURT REPORTING              ,ID,83704-8320,Proprietary  ,29,95,124,66,196,262
03832400,COSMETOLOGY SCHOOL OF ARTS & SCIENCES   ,ID,83318-1327,Proprietary  ,2,27,29,10,48,58
04051323,ART INSTITUTE OF PHOENIX (THE) - BROWN M,ID,83709-2746,Proprietary  ,8,49,57,41,116,157
04134300,EVANS HAIRSTYLING COLLEGE               ,ID,83440-5277,Proprietary  ,25,19,44,48,31,79
04144500,HAIR ACDMY PAUL MITCHELL PARTNER SCHOOL ,ID,83440-2600,Proprietary  ,43,53,96,64,81,145
04150600,D & L ACADEMY OF HAIR DESIGN            ,ID,83301-6229,Proprietary  ,3,9,12,12,24,36
04155200,OLIVER FINLEY ACADEMY OF COSMETOLOGY    ,ID,83704-8011,Proprietary  ,40,75,115,103,137,240
04163800,MASTER EDUCATORS BEAUTY SCHOOL          ,ID,83301-4118,Proprietary  ,10,14,24,24,30,54
04168600,COLLEGE OF MASSAGE THERAPY              ,ID,83221-1758,Proprietary  ,2,21,23,11,36,47
04176700,D'SHAW INSTITUTE OF COSMETOLOGY         ,ID,83704-4406,Proprietary  ,6,21,27,27,42,69
04194800,VELVET TOUCH ACADEMY OF COSMETOLOGY     ,ID,83687-5020,Proprietary  ,6,11,17,24,39,63
04203200,BOISE BARBER COLLEGE                    ,ID,83704-5919,Proprietary  ,6,33,39,15,72,87
04203500,AUSTIN KADE ACADEMY                     ,ID,83404-5540,Proprietary  ,20,86,106,35,130,165
04207200,ACADEMY DI FIRENZE                      ,ID,83338-2329,Proprietary  ,0,9,9,6,15,21
04211800,COLLEGE OF WESTERN IDAHO                ,ID,83687-5505,Public       ,1062,2318,3380,3330,4846,8176
00149912,EVEREST UNIVERSITY - EVEREST COLLEGE - K,MO,64114-3246,Proprietary  ,35,226,261,65,375,440
00163200,AQUINAS INSTITUTE OF THEOLOGY           ,MO,63108-3323,Private      ,1,25,26,1,45,46
00244900,AVILA UNIVERSITY                        ,MO,64145-1698,Private      ,322,480,802,1356,1122,2478
00245000,CALVARY BIBLE COLLEGE                   ,MO,64147-1341,Private      ,34,63,97,127,136,263
00245300,CENTRAL METHODIST UNIVERSITY            ,MO,65248-1198,Private      ,326,656,982,1696,1708,3404
00245400,UNIVERSITY OF CENTRAL MISSOURI          ,MO,64093-5178,Public       ,2071,1429,3500,8115,3397,11512
00245600,COLUMBIA COLLEGE                        ,MO,65216-4581,Private      ,636,4227,4863,2436,13578,16014
00245700,CONCORDIA SEMINARY                      ,MO,63105-3199,Private      ,0,72,72,2,376,378
00245800,COTTEY COLLEGE                          ,MO,64772-2790,Private      ,59,21,80,361,51,412
00245900,CROWDER COLLEGE                         ,MO,64850-9165,Public       ,821,978,1799,2085,1946,4031
00246000,CULVER STOCKTON COLLEGE                 ,MO,63435-1299,Private      ,243,60,303,1336,171,1507
00246100,DRURY UNIVERSITY                        ,MO,65802-3791,Private      ,498,946,1444,2074,2204,4278
00246200,EDEN THEOLOGICAL SEMINARY               ,MO,63119-0000,Private      ,0,37,37,1,74,75
00246300,EVANGEL UNIVERSITY                      ,MO,65802-2125,Private      ,516,357,873,2005,782,2787
00246400,FONTBONNE UNIVERSITY                    ,MO,63105-3098,Private      ,205,547,752,1113,1442,2555
00246600,HARRIS-STOWE STATE COLLEGE              ,MO,63103-2199,Public       ,410,529,939,1283,1282,2565
00246700,CONCEPTION SEMINARY COLLEGE             ,MO,64433-0502,Private      ,6,3,9,37,7,44
00246800,JEFFERSON COLLEGE                       ,MO,63050-2441,Public       ,937,891,1828,2098,1732,3830
00247100,ST LOUIS COMMUNITY COLLEGE              ,MO,63102-0000,Public       ,3315,4783,8098,7962,9026,16988
00247300,KANSAS CITY ART INSTITUTE               ,MO,64111-1874,Private      ,201,95,296,1103,288,1391
00247400,KANSAS CITY UNIV OF MED AND BIOSCIENCES ,MO,64106-0000,Private      ,24,242,266,78,1182,1260
00247600,KENRICK-GLENNON SEMINARY                ,MO,63119-4330,Private      ,12,5,17,29,7,36
00247700,A.T. STILL UNIV OF HEALTH SCIENCES      ,MO,63501-0000,Private      ,6,1206,1212,18,2830,2848
00247900,LINCOLN UNIVERSITY                      ,MO,65101-3500,Public       ,641,425,1066,2292,1147,3439
00248000,LINDENWOOD UNIVERSITY                   ,MO,63301-1695,Private      ,1547,2104,3651,6304,5219,11523
00248200,MARYVILLE UNIVERSITY                    ,MO,63141-7299,Private      ,450,1736,2186,2432,3670,6102
00248400,METROPOLITAN COMMUNITY COLLEGE          ,MO,64111-2408,Public       ,3011,4088,7099,6967,7930,14897
00248500,MIDWESTERN BAPTIST THEOL SEMINARY       ,MO,64118-4697,Private      ,46,167,213,105,295,400
00248600,MINERAL AREA COLLEGE                    ,MO,63601-1000,Public       ,597,706,1303,1502,1357,2859
00248800,MISSOURI SOUTHERN STATE UNIVERSITY      ,MO,64801-1595,Public       ,1144,1117,2261,4172,2779,6951
00248900,MISSOURI VALLEY COLLEGE                 ,MO,65340-3197,Private      ,454,145,599,1597,355,1952
00249000,MISSOURI WESTERN STATE UNIVERSITY       ,MO,64507-2294,Public       ,688,619,1307,3826,1763,5589
00249100,MOBERLY AREA COMMUNITY COLLEGE          ,MO,65270-1304,Public       ,805,873,1678,2334,1912,4246
00249400,NAZARENE THEOLOGICAL SEMINARY           ,MO,64131-1246,Private      ,1,39,40,5,109,114
00249500,TRUMAN STATE UNIVERSITY                 ,MO,63501-4221,Public       ,796,149,945,5452,534,5986
00249600,NORTHWEST MISSOURI STATE UNIV           ,MO,64468-6001,Public       ,1188,354,1542,5659,1003,6662
00249800,PARK UNIVERSITY                         ,MO,64152-3795,Private      ,374,2486,2860,1187,5447,6634
00249900,ROCKHURST UNIVERSITY                    ,MO,64110-2561,Private      ,284,312,596,2156,878,3034
00250000,COLLEGE OF THE OZARKS                   ,MO,65726-2502,Private      ,253,58,311,3258,308,3566
00250100,SOUTHEAST MISSOURI STATE UNIV           ,MO,63701-4799,Public       ,1182,977,2159,8249,3272,11521
00250200,SOUTHWEST BAPTIST UNIVERSITY            ,MO,65613-2597,Private      ,356,492,848,1935,1254,3189
00250300,MISSOURI STATE UNIVERSITY               ,MO,65897-0094,Public       ,3186,2573,5759,15450,6572,22022
00250400,ST LOUIS COLLEGE OF PHARMACY            ,MO,63110-1088,Private      ,117,252,369,730,747,1477
00250600,SAINT LOUIS UNIVERSITY                  ,MO,63103-2097,Private      ,1001,1840,2841,9471,5738,15209
00250900,SAINT PAUL SCHOOL OF THEOLOGY           ,MO,64127-2499,Private      ,1,39,40,1,69,70
00251200,STEPHENS COLLEGE                        ,MO,65215-0001,Private      ,160,225,385,969,509,1478
00251400,NORTH CENTRAL MISSOURI COLLEGE          ,MO,64683-1824,Public       ,273,311,584,817,608,1425
00251600,UNIVERSITY OF MISSOURI - COLUMBIA       ,MO,65211-1600,Public       ,2997,1934,4931,25890,6897,32787
00251700,MISSOURI UNIVERSITY OF SCIENCE & TECHNOL,MO,65409-0250,Public       ,800,327,1127,6257,1238,7495
00251800,UNIVERSITY OF MISSOURI-KANSAS CITY      ,MO,64110-2497,Public       ,1409,2257,3666,7252,7132,14384
00251900,UNIVERSITY OF MISSOURI-ST LOUIS         ,MO,63121-4499,Public       ,1503,2812,4315,6084,7460,13544
00252000,WASHINGTON UNIVERSITY                   ,MO,63130-4899,Private      ,627,1166,1793,15166,4634,19800
00252001,WASHINGTON UNIV-SCHOOL OF MEDICINE      ,MO,63110-0000,Private      ,26,432,458,138,1356,1494
00252100,WEBSTER UNIVERSITY                      ,MO,63119-3194,Private      ,574,3915,4489,3199,8292,11491
00252200,WENTWORTH MILITARY ACADEMY              ,MO,64067-1799,Private      ,107,59,166,231,149,380
00252300,WESTMINSTER COLLEGE                     ,MO,65251-1299,Private      ,116,22,138,1150,115,1265
00252400,WILLIAM JEWELL COLLEGE                  ,MO,64068-1896,Private      ,167,53,220,1156,204,1360
00252500,WILLIAM WOODS UNIVERSITY                ,MO,65251-2388,Private      ,216,415,631,954,797,1751
00405704,NATIONAL AMERICAN UNIVERSITY            ,MO,64057-1791,Proprietary  ,17,213,230,39,441,480
00470300,LOGAN COLLEGE OF CHIROPRACTIC           ,MO,63006-0000,Private      ,8,256,264,43,592,635
00470700,COVENANT THEOLOGICAL SEMINARY           ,MO,63141-8697,Private      ,1,193,194,5,401,406
00471100,STATE TECHNICAL COLLEGE OF MISSOURI     ,MO,65051-9607,Public       ,334,119,453,1271,330,1601
00471300,THREE RIVERS COMMUNITY COLLEGE          ,MO,63901-2393,Public       ,604,1003,1607,1540,2123,3663
00528800,KIRKSVILLE AREA TECHNICAL CENTER        ,MO,63501-0000,Public       ,7,29,36,21,55,76
00528900,WAYNESVILLE CAREER CENTER               ,MO,65583-2131,Public       ,20,52,72,40,101,141
00542400,SOUTH CENTRAL CAREER CENTER             ,MO,65775-3052,Public       ,30,37,67,47,86,133
00542600,SIKESTON CAREER AND TECHNOLOGY CTR      ,MO,63801-0000,Public       ,28,63,91,74,146,220
00542900,ROLLA TECHNICAL INSTITUTE               ,MO,65401-3601,Public       ,58,102,160,204,248,452
00543000,POPLAR BLUFF TECHNICAL CAREER CNTR      ,MO,63901-0000,Public       ,26,62,88,64,154,218
00543800,SALINE COUNTY CAREER CENTER             ,MO,65340-0000,Public       ,2,6,8,12,49,61
00544500,TRUMAN MEDICAL CENTER SCHOOL OF NURSE AN,MO,64108-2677,Private      ,13,27,40,50,96,146
00553100,GRAND RIVER TECHNICAL SCHOOL            ,MO,64601-1299,Public       ,17,20,37,57,44,101
00553200,CAPE GIRARDEAU CAREER & TECHNOLOGY CENTE,MO,63703-7511,Public       ,94,176,270,234,387,621
00638900,BARNES JEWISH COLLEGE OF NURSING AND ALL,MO,63110-1091,Private      ,150,305,455,516,863,1379
00639200,RESEARCH COLLEGE OF NURSING             ,MO,64132-1199,Proprietary  ,45,116,161,127,225,352
00639201,RESEARCH MEDICAL CENTER - COLLEGE OF NUR,MO,64132-1199,Proprietary  ,20,43,63,49,98,147
00639202,RESEARCH MED CTR SCHL OF RAD TECH       ,MO,64132-0000,Proprietary  ,11,19,30,24,49,73
00666600,LUTHERAN  SCHOOL OF NURSING             ,MO,63118-3909,Proprietary  ,0,0,0,54,187,241
00732923,ITT TECHNICAL INSTITUTE                 ,MO,63045-1122,Proprietary  ,211,1201,1412,376,1954,2330
00754000,MISSOURI BAPTIST UNIVERSITY             ,MO,63141-8698,Private      ,440,733,1173,1676,1608,3284
00808000,STATE FAIR COMMUNITY COLLEGE            ,MO,65301-0000,Public       ,669,959,1628,1785,1977,3762
00826900,HILLYARD TECHNICAL CENTER               ,MO,64506-0000,Public       ,45,83,128,156,171,327
00855200,STEVENS INSTITUTE OF BUSINESS & ARTS    ,MO,63103-0000,Proprietary  ,32,54,86,75,145,220
00886200,EAST CENTRAL COLLEGE                    ,MO,63084-0529,Public       ,559,658,1217,1561,1429,2990
00908900,HANNIBAL-LAGRANGE COLLEGE               ,MO,63401-1999,Private      ,165,181,346,640,392,1032
00952000,NATIONAL ACADEMY OF BEAUTY ARTS         ,MO,63128-1307,Proprietary  ,26,58,84,51,110,161
00959000,INDEPENDENCE COLLEGE OF COSMETOLOGY     ,MO,64055-1105,Proprietary  ,11,30,41,29,62,91
00960700,HOUSE OF HEAVILIN BEAUTY COLLEGE        ,MO,64110-2826,Proprietary  ,9,29,38,28,79,107
00978200,SAINT LUKE'S COLLEGE OF HEALTH SCIENCES ,MO,64114-3237,Private      ,78,155,233,243,385,628
00979500,MISSOURI COLLEGE                        ,MO,63144-2901,Proprietary  ,72,216,288,133,402,535
01027900,HICKEY COLLEGE                          ,MO,63146-0000,Proprietary  ,213,150,363,473,317,790
01040500,PINNACLE CAREER INSTITUTE               ,MO,64131-3367,Proprietary  ,66,503,569,97,778,875
01040501,PINNACLE CAREER INSTITUTE - NORTH KANSAS,MO,64153-1151,Proprietary  ,21,99,120,34,197,231
01050303,WICHITA TECHNICAL INSTITUTE - WTI JOPLIN,MO,64801-2970,Proprietary  ,13,73,86,23,103,126
01102600,WARRENSBURG AREA VOC TECH SCH           ,MO,64093-0000,Public       ,14,25,39,38,58,96
01173500,PIKE/LINCOLN TECHNICAL CENTER           ,MO,63344-0000,Public       ,4,16,20,11,22,33
01250000,RANKEN TECHNICAL COLLEGE                ,MO,63113-2811,Private      ,605,671,1276,1377,1233,2610
01258000,ST LOUIS CHRISTIAN COLLEGE              ,MO,63033-6499,Private      ,24,58,82,74,119,193
01320800,BAPTIST BIBLE COLLEGE                   ,MO,65803-3498,Private      ,97,73,170,217,144,361
02056100,FOUR RIVERS CAREER CENTER               ,MO,63090-0000,Public       ,8,30,38,22,52,74
02068200,COX HEALTH - COX COLLEGE                ,MO,65802-0000,Private      ,94,366,460,306,900,1206
02119200,COURT REPORTING INSTITUTE OF ST LOUIS   ,MO,63105-3329,Proprietary  ,10,121,131,19,234,253
02119204,COURT REPORTING INSTITUTE OF DALLAS - CO,MO,63105-3329,Proprietary  ,0,0,0,1,20,21
02121100,MIDWEST INSTITUTE                       ,MO,63122-0000,Proprietary  ,11,52,63,29,89,118
02124500,FRANKLIN TECHNOLOGY CENTER              ,MO,64801-0000,Public       ,32,118,150,76,247,323
02142200,LEX LA RAY TECHNICAL CENTER             ,MO,64067-0000,Public       ,9,15,24,19,65,84
02154900,MISSOURI SCH OF BARB & HAIR             ,MO,63031-0000,Proprietary  ,2,21,23,9,44,53
02164200,FOREST INSTITUTE OF PROFESSIONAL PSYCHOL,MO,65807-1445,Private      ,7,36,43,12,71,83
02165900,CHILLICOTHE BEAUTY ACADEMY              ,MO,64601-0000,Proprietary  ,4,5,9,8,9,17
02180200,METRO BUSINESS COLLEGE                  ,MO,63701-0000,Proprietary  ,30,197,227,59,337,396
02188100,NORTHLAND CAREER CENTER                 ,MO,64079-8333,Public       ,9,27,36,21,53,74
02202700,OZARK CHRISTIAN COLLEGE                 ,MO,64801-0000,Private      ,195,66,261,556,144,700
02203400,NEVADA REGIONAL TECHNICAL CENTER        ,MO,64772-0000,Public       ,16,36,52,36,60,96
02205200,SANFORD-BROWN COLLEGE                   ,MO,63026-7305,Proprietary  ,1,4,5,10,28,38
02214500,SALEM COLLEGE OF HAIRSTYLING            ,MO,65401-0000,Proprietary  ,6,4,10,8,18,26
02239200,ANTHEM COLLEGE                          ,MO,63043-0000,Proprietary  ,2,6,8,9,19,28
02250600,EVEREST COLLEGE                         ,MO,65807-2446,Proprietary  ,27,154,181,52,342,394
02263400,LAKE CAREER AND TECHNICAL CENTER        ,MO,65020-0000,Public       ,1,23,24,6,37,43
02266400,CENTRAL CHRISTIAN CLG OF THE BIBLE      ,MO,65270-0000,Private      ,80,47,127,184,90,274
02277500,HOUSE OF HEAVILIN BEAUTY COLLEGE        ,MO,64014-3953,Proprietary  ,17,50,67,43,90,133
02289200,COLUMBIA AREA CAREER CENTER             ,MO,65203-0000,Public       ,60,117,177,142,306,448
02295700,MISSOURI BEAUTY ACADEMY                 ,MO,63640-1827,Proprietary  ,7,32,39,14,60,74
02300105,EVEREST COLLEGE - EARTH CITY            ,MO,63045-1100,Proprietary  ,3,16,19,8,39,47
02304000,MISSOURI TECH                           ,MO,63303-3887,Proprietary  ,15,51,66,60,108,168
02309100,AMERICAN COLLEGE OF HAIR DESIGN         ,MO,65301-2144,Proprietary  ,10,13,23,19,22,41
02313000,CASS CAREER CENTER                      ,MO,64701-0000,Public       ,5,26,31,10,53,63
02340500,ST LOUIS COLLEGE OF HEALTH CAREERS      ,MO,63110-0000,Proprietary  ,73,481,554,175,781,956
02342100,CAREER & TECHNOLOGY CTR AT FT OSAGE     ,MO,64058-0000,Public       ,6,27,33,10,56,66
02361600,CONCORDE CAREER COLLEGE                 ,MO,64111-0000,Proprietary  ,89,441,530,178,779,957
02497500,CLINTON TECHNICAL SCHOOL                ,MO,64735-2966,Public       ,6,23,29,12,48,60
02520800,MERRELL UNIV OF BTY ARTS & SCIENCES     ,MO,65109-0000,Proprietary  ,20,51,71,44,91,135
02530600,SAINT CHARLES COMMUNITY COLLEGE         ,MO,63376-0975,Public       ,1659,1017,2676,3579,1938,5517
02543800,PARIS II EDUCATIONAL CENTER (THE)       ,MO,64118-0000,Proprietary  ,11,29,40,22,52,74
02564700,ELAINE STEVEN BEAUTY COLLEGE            ,MO,63136-0000,Proprietary  ,22,74,96,51,128,179
02564702,ELAINE STEVEN BEAUTY COLLEGE - ADVANCE B,MO,63401-2269,Proprietary  ,3,3,6,9,16,25
02568500,GRABBER SCHOOL OF HAIR DESIGN           ,MO,63011-0000,Proprietary  ,39,57,96,69,85,154
02599700,VATTEROTT COLLEGE                       ,MO,63134-2900,Proprietary  ,152,759,911,210,1115,1325
02599701,VATTEROTT COLLEGE - KANSAS CITY         ,MO,64117-0000,Proprietary  ,72,408,480,115,559,674
02599702,VATTEROTT COLLEGE - SPRINGFIELD LOCATION,MO,65807-5340,Proprietary  ,69,322,391,106,505,611
02599703,VATTEROTT COLLEGE - JOPLIN              ,MO,64801-5033,Proprietary  ,36,188,224,57,342,399
02599705,VATTEROTT COLLEGE - SUNSET HILLS        ,MO,63127-1516,Proprietary  ,46,218,264,72,370,442
02599712,VATTEROTT COLLEGE - O'FALLON            ,MO,63366-2748,Proprietary  ,58,237,295,73,342,415
02599714,VATTEROTT COLLEGE - EX'TREME INSTITUTE B,MO,63102-2115,Proprietary  ,88,256,344,159,383,542
02608000,NEOSHO BEAUTY COLLEGE                   ,MO,64850-1525,Proprietary  ,3,10,13,11,20,31
02609202,VATTEROTT COLLEGE-ST JOSEPH             ,MO,64501-2911,Proprietary  ,16,82,98,34,175,209
02609203,VATTEROTT COLLEGE - L'ECOLE CULINAIRE   ,MO,63124-1103,Proprietary  ,42,152,194,72,219,291
02609206,VATTEROTT COLLEGE - L'ECOLE CULINAIRE   ,MO,64112-2110,Proprietary  ,34,119,153,50,204,254
02611004,HERITAGE COLLEGE-KANSAS CITY            ,MO,64131-4203,Proprietary  ,45,185,230,70,325,395
03066300,BRYAN CAREER COLLEGE                    ,MO,65806-2507,Proprietary  ,23,257,280,37,382,419
03066303,BRYAN COLLEGE - COLUMBIA                ,MO,65201-8248,Proprietary  ,25,107,132,55,179,234
03068600,SPECIAL SCHOOL DISTRICT OF ST. LOUIS CO.,MO,63127-1324,Public       ,19,161,180,43,285,328
03070200,CENTRAL COLLEGE OF COSMETOLOGY          ,MO,65583-0000,Proprietary  ,9,25,34,18,43,61
03070900,SE MO HOSP CLG NURSING & HEALTH SCI     ,MO,63703-4507,Private      ,37,105,142,148,337,485
03077200,COSMETOLOGY CONCEPTS INSTITUTE          ,MO,65202-1972,Proprietary  ,21,38,59,48,74,122
03083000,OZARKS TECHNICAL COMMUNITY COLLEGE      ,MO,65802-3601,Public       ,2402,3527,5929,5764,7182,12946
03092600,MESSENGER COLLEGE                       ,MO,64804-0000,Private      ,37,37,74,84,75,159
03097600,ST LOUIS HAIR ACADEMY                   ,MO,63107-1737,Proprietary  ,13,37,50,30,78,108
03101000,NEW DIMENSION SCHOOL OF HAIR DESIGN     ,MO,64801-5017,Proprietary  ,7,26,33,16,49,65
03106000,MISSOURI STATE UNIVERSITY - WEST PLAINS ,MO,65775-2715,Public       ,336,377,713,1117,810,1927
03110900,HOUSE OF HEAVILIN BEAUTY COLLEGE        ,MO,64083-9195,Proprietary  ,13,15,28,18,32,50
03519300,MISSOURI COLLEGE OF COSMETOLOGY NORTH   ,MO,65803-0000,Proprietary  ,9,56,65,38,98,136
03579300,TEXAS COUNTY TECHNICAL INSTITUTE        ,MO,65483-2700,Private      ,13,60,73,34,166,200
03616300,AVIATION INSTITUTE OF MAINTENANCE       ,MO,64129-1811,Proprietary  ,13,68,81,35,155,190
03878300,PROFESSIONAL MASSAGE TRAINING CENTER    ,MO,65803-2939,Proprietary  ,7,27,34,13,53,66
03916300,ECLIPS SCHOOL OF COSMETOLOGY AND BARBERI,MO,63703-5809,Proprietary  ,8,40,48,16,81,97
03924300,HAIR ACADEMY 110 (THE)                  ,MO,63501-2915,Proprietary  ,2,7,9,6,14,20
03970400,WELLSPRING SCHOOL OF ALLIED HEALTH      ,MO,64114-3313,Proprietary  ,21,92,113,33,149,182
04037500,ACADEMY OF HAIR DESIGN                  ,MO,65804-2303,Proprietary  ,22,77,99,57,159,216
04051329,ART INSTITUTE OF PHOENIX (THE) - BROWN M,MO,63026-2564,Proprietary  ,34,56,90,75,134,209
04118700,AMERICAN BUSINESS & TECHNOLOGY UNIVERSIT,MO,64506-2961,Proprietary  ,9,77,86,26,199,225
04119100,CITY VISION COLLEGE                     ,MO,64141-3188,Private      ,9,41,50,15,97,112
04122300,GRANTHAM UNIVERSITY                     ,MO,64153-2262,Proprietary  ,183,3579,3762,367,7769,8136
04130600,"CENTER FOR HEALING ARTS (THE), LLC      ",MO,63143-2103,Proprietary  ,0,38,38,6,70,76
04133300,TREND SETTERS SCHOOL OF COSMETOLOGY     ,MO,63702-7607,Proprietary  ,9,40,49,23,69,92
04145200,TRANSFORMED BARBER AND COSMETOLOGY ACADE,MO,64137-1207,Proprietary  ,10,56,66,25,101,126
04145700,THE SYSTEM A PAUL MITCHELL PARTNER SCHL ,MO,65807-5969,Proprietary  ,24,59,83,63,115,178
04146100,URSHAN GRADUATE SCHOOL OF THEOLOGY      ,MO,63031-7526,Private      ,5,16,21,20,29,49
04152200,CARTHAGE R-9 SCHOOL DISTRICT/CARTHAGE TE,MO,64836-1332,Public       ,2,19,21,5,39,44
04170600,SALON PROFESSIONAL ACADEMY (THE)        ,MO,63301-1021,Proprietary  ,13,40,53,35,59,94
04170700,PAUL MITCHELL THE SCHOOL ST LOUIS       ,MO,63108-1554,Proprietary  ,78,106,184,159,175,334
04173900,COSMETOLOGY COLLEGE OF FRANKLIN COUNTY  ,MO,63077-3448,Proprietary  ,4,7,11,10,17,27
04174000,SKIN INSTITUTE                          ,MO,63128-1307,Proprietary  ,12,20,32,29,50,79
04174800,AMERICAN TRADE SCHOOL                   ,MO,63074-1807,Proprietary  ,13,67,80,19,110,129
04179000,"SALON PROFESSIONAL ACADEMY, THE         ",MO,65616-7216,Proprietary  ,0,0,0,1,4,5
04184400,SEYMOUR BEAUTY ACADEMY                  ,MO,65746-8743,Proprietary  ,3,13,16,4,21,25
04187000,DONNA'S ACADEMY OF HAIR DESIGN          ,MO,64089-9042,Proprietary  ,9,7,16,19,12,31
04212100,ACADEMY OF SALON PROFESSIONALS          ,MO,65301-6910,Proprietary  ,7,24,31,13,42,55
04218400,CITY POINTE BEAUTY ACADEMY              ,MO,64870-2502,Proprietary  ,15,24,39,27,56,83
00314600,WESTERN OKLAHOMA STATE COLLEGE          ,OK,73521-1397,Public       ,141,291,432,397,563,960
00314700,BACONE COLLEGE                          ,OK,74403-1597,Private      ,301,188,489,612,407,1019
00314900,SOUTHERN NAZARENE UNIVERSITY            ,OK,73008-2694,Private      ,226,657,883,1068,1263,2331
00315000,CAMERON UNIVERSITY                      ,OK,73505-6377,Public       ,495,1102,1597,1567,2447,4014
00315100,OKLAHOMA WESLEYAN UNIVERSITY            ,OK,74006-6299,Private      ,199,356,555,1064,894,1958
00315200,UNIV OF CENTRAL OKLAHOMA                ,OK,73034-5209,Public       ,2324,2613,4937,8377,5394,13771
00315300,CONNORS STATE COLLEGE                   ,OK,74469-2204,Public       ,334,475,809,1083,1047,2130
00315400,EAST CENTRAL UNIVERSITY                 ,OK,74820-6999,Public       ,543,696,1239,2436,1641,4077
00315500,EASTERN OKLAHOMA STATE COLLEGE          ,OK,74578-4999,Public       ,183,310,493,650,681,1331
00315600,REDLANDS COMMUNITY COLLEGE              ,OK,73036-5304,Public       ,204,301,505,572,625,1197
00315700,LANGSTON UNIVERSITY                     ,OK,73050-0000,Public       ,678,553,1231,2928,1382,4310
00315800,MURRAY STATE COLLEGE                    ,OK,73460-3137,Public       ,321,489,810,1054,1003,2057
00316000,NORTHEASTERN OKLAHOMA A & M COLLEGE     ,OK,74354-6497,Public       ,423,350,773,1480,748,2228
00316100,NORTHEASTERN STATE UNIVERSITY           ,OK,74464-2399,Public       ,1190,1798,2988,4405,4372,8777
00316200,NORTHERN OKLAHOMA COLLEGE               ,OK,74653-0310,Public       ,501,538,1039,1471,1173,2644
00316300,NORTHWESTERN OKLAHOMA STATE UNIV        ,OK,73717-2799,Public       ,266,298,564,1134,654,1788
00316400,OKLAHOMA BAPTIST UNIVERSITY             ,OK,74801-2590,Private      ,418,121,539,2467,367,2834
00316500,OKLAHOMA CHRISTIAN UNIVERSITY           ,OK,73131-0000,Private      ,675,332,1007,2242,660,2902
00316600,OKLAHOMA CITY UNIVERSITY                ,OK,73106-1493,Private      ,448,870,1318,2318,2007,4325
00316700,UNIV OF SCIENCE & ARTS OF OKLAHOMA      ,OK,73018-5322,Public       ,176,103,279,732,287,1019
00316800,ROGERS STATE UNIVERSITY                 ,OK,74017-3252,Public       ,671,825,1496,2285,1853,4138
00317000,OKLAHOMA STATE UNIVERSITY               ,OK,74078-1026,Public       ,3581,2233,5814,17063,6028,23091
00317200,OKLAHOMA STATE UNIVERSITY-OKMULGEE      ,OK,74447-3901,Public       ,443,485,928,1490,1207,2697
00317400,OKLAHOMA PANHANDLE STATE UNIVERSITY     ,OK,73939-0000,Public       ,196,134,330,618,241,859
00317600,CARL ALBERT STATE COLLEGE               ,OK,74953-5208,Public       ,348,547,895,1010,1115,2125
00317800,SEMINOLE STATE COLLEGE                  ,OK,74818-0351,Public       ,226,312,538,726,741,1467
00317900,SOUTHEASTERN OKLAHOMA STATE UNIV        ,OK,74701-0609,Public       ,508,731,1239,1868,1592,3460
00318000,SOUTHWESTERN CHRISTIAN UNIVERSITY       ,OK,73008-2335,Private      ,111,219,330,356,384,740
00318100,SOUTHWESTERN OKLAHOMA STATE UNIV        ,OK,73096-3098,Public       ,700,633,1333,2827,1478,4305
00318101,SOUTHWESTERN OK STATE UNIV AT SAYRE     ,OK,73662-0000,Public       ,35,50,85,130,112,242
00318300,ST GREGORY'S UNIVERSITY                 ,OK,74804-2499,Private      ,114,119,233,418,267,685
00318308,SAINT GREGORY'S UNIVERSITY - IPD TULSA  ,OK,74135-2499,Private      ,8,42,50,34,89,123
00318400,UNIVERSITY OF OKLAHOMA                  ,OK,73019-4078,Public       ,3161,3059,6220,16789,7448,24237
00318401,UNIVERSITY OF OKLAHOMA-HLTH SCI CTR     ,OK,73190-0000,Public       ,189,1058,1247,653,2729,3382
00318500,UNIVERSITY OF TULSA                     ,OK,74104-3189,Private      ,498,487,985,3438,1387,4825
00398500,ORAL ROBERTS UNIVERSITY                 ,OK,74171-0001,Private      ,733,647,1380,2721,1407,4128
00531100,TULSA COUNTY AREA VOC TECH SCHOOL       ,OK,74145-0000,Public       ,231,555,786,493,1094,1587
00531200,RED RIVER TECHNOLOGY CENTER             ,OK,73533-2700,Public       ,5,50,55,19,96,115
00533900,METRO TECHNOLOGY CENTERS SCH DIST22     ,OK,73111-0000,Public       ,68,298,366,141,644,785
00533903,METRO TECHNOLOGY CENTERS SCH DIST22     ,OK,73129-0000,Public       ,50,219,269,106,457,563
00694200,MID-AMERICA CHRISTIAN UNIVERSITY        ,OK,73170-4504,Private      ,164,895,1059,455,2004,2459
00767800,SPARTAN COLLEGE OF AERONAUTICS AND TECHN,OK,74115-5800,Proprietary  ,354,332,686,751,544,1295
00791100,VIRGILS BEAUTY COLLEGE                  ,OK,74401-6802,Proprietary  ,4,5,9,7,26,33
00834300,AUTRY TECHNOLOGY CENTER                 ,OK,73703-2598,Public       ,27,78,105,58,141,199
00861900,TRI COUNTY TECHNOLOGY CENTER            ,OK,74006-6029,Public       ,2,18,20,19,65,84
00918500,ROSE STATE COLLEGE                      ,OK,73110-2799,Public       ,816,1557,2373,2177,3078,5255
00920400,KIAMICHI TECHNOLOGY CENTER              ,OK,74578-0548,Public       ,93,227,320,181,489,670
00961800,TULSA WELDING SCHOOL                    ,OK,74104-0000,Proprietary  ,636,804,1440,1403,1452,2855
00964700,"OKLAHOMA STATE UNIV, OKLA CITY          ",OK,73107-6159,Public       ,695,1863,2558,2205,3902,6107
00970800,EVES COLLEGE OF HAIRSTYLING             ,OK,73501-0000,Proprietary  ,3,33,36,8,62,70
00976300,TULSA COMMUNITY COLLEGE                 ,OK,74135-6198,Public       ,2536,3575,6111,6492,7716,14208
00996300,CADDO KIOWA VOC TECH CENTER             ,OK,73038-0000,Public       ,28,63,91,57,143,200
00996400,CENTRAL OKLAHOMA AREA VOC TECH SCH      ,OK,74030-9613,Public       ,26,74,100,67,165,232
00996500,CANADIAN VALLEY TECHNOLOGY CENTER       ,OK,73036-9117,Public       ,17,91,108,45,194,239
00996800,GORDON COOPER TECHNOLOGY CENTER         ,OK,74804-9913,Public       ,33,126,159,88,269,357
01005300,INDIAN CAPITAL TECHNOLGY CENTER #4      ,OK,74403-9907,Public       ,74,183,257,161,385,546
01026600,HILLSDALE FREE WILL BAPTIST COLLEGE     ,OK,73153-0000,Private      ,62,34,96,189,60,249
01034200,SOUTHERN OKLAHOMA TECHNOLOGY CENTER     ,OK,73401-2100,Public       ,23,92,115,62,181,243
01039100,OKLAHOMA CITY COMMUNITY COLLEGE         ,OK,73159-4444,Public       ,1413,2667,4080,4005,5603,9608
01050304,WTI TULSA CAMPUS                        ,OK,74112-3140,Proprietary  ,12,96,108,25,142,167
01071700,GREAT PLAINS TECHNOLOGY CENTER SCHOOL DI,OK,73505-8399,Public       ,54,161,215,128,374,502
01076200,WESTERN OK AREA VOC TECH SCH DIST12     ,OK,73624-1469,Public       ,7,37,44,31,74,105
01120600,PIONEER TECHNOLOGY CENTER               ,OK,74601-1106,Public       ,11,54,65,21,107,128
01128200,OKLAHOMA STATE UNV CLG OSTEOPTHC MD     ,OK,74107-0000,Public       ,45,350,395,117,598,715
01153700,MID-AMERICA TECHNOLOGY CENTER           ,OK,73095-0210,Public       ,11,28,39,30,78,108
01227200,MOORE-NORMAN TECHNOLOGY CENTER          ,OK,73069-8399,Public       ,67,278,345,165,571,736
02052700,NORTHEAST TECHNOLOGY CENTER             ,OK,74361-0487,Public       ,53,152,205,103,300,403
02060800,MERIDIAN TECHNOLOGY CENTER              ,OK,74074-0000,Public       ,31,79,110,97,164,261
02126500,ENID BEAUTY COLLEGE                     ,OK,73701-0000,Proprietary  ,10,16,26,16,23,39
02184400,SAND SPRINGS BEAUTY COLLEGE             ,OK,74063-0000,Proprietary  ,8,25,33,14,49,63
02197300,HOLLYWOOD COSMETOLOGY CENTER            ,OK,73189-0000,Proprietary  ,5,23,28,16,41,57
02222700,FRANCIS TUTTLE TECHNOLOGY CENTER        ,OK,73142-0000,Public       ,97,422,519,216,891,1107
02238500,CENTRAL STATE BEAUTY ACADEMY            ,OK,73162-6007,Proprietary  ,23,101,124,44,160,204
02250900,E OK COUNTY AREA VO-TECH                ,OK,73020-0000,Public       ,14,37,51,37,60,97
02256200,"BROKEN ARROW BEAUTY COLLEGE, INC        ",OK,74012-0000,Proprietary  ,19,76,95,38,122,160
02282100,HIGH PLAINS AREA VOC-TECH               ,OK,73801-0000,Public       ,6,24,30,18,46,64
02306800,PLATT COLLEGE                           ,OK,74145-0000,Proprietary  ,76,475,551,130,742,872
02306811,PLATT COLLEGE - LAWTON                  ,OK,73501-3808,Proprietary  ,25,140,165,49,241,290
02510300,BEAUTY TECHNICAL COLLEGE                ,OK,74465-0000,Proprietary  ,4,17,21,7,32,39
02531200,WOODWARD BEAUTY COLLEGE                 ,OK,73801-0000,Proprietary  ,4,21,25,5,32,37
02556500,YUKON BEAUTY COLLEGE                    ,OK,73099-4108,Proprietary  ,2,12,14,5,20,25
02560200,PHILLIPS THEOLOGICAL SEMINARY -         ,OK,74116-5612,Private      ,0,43,43,1,68,69
02581100,CLAREMORE BEAUTY COLLEGE                ,OK,74017-7034,Proprietary  ,4,8,12,8,13,21
02581200,CC'S COSMETOLOGY COLLEGE                ,OK,74129-0000,Proprietary  ,19,40,59,36,81,117
02591101,CAREER POINT INSTITUTE                  ,OK,74146-0000,Proprietary  ,14,94,108,48,205,253
02596501,ATI-CAREER TRAINING CENTER - OKLAHOMA CI,OK,73107-2442,Proprietary  ,3,25,28,9,60,69
02596502,ATI- CAREER TRAINING CENTER - OKLAHOMA C,OK,76101-2740,Proprietary  ,5,35,40,16,77,93
02597400,PONTOTOC TECHNOLOGY CENTER SCHOOL       ,OK,74820-8621,Public       ,16,60,76,54,116,170
02599706,VATTEROTT COLLEGE - TULSA               ,OK,74146-2205,Proprietary  ,23,187,210,40,267,307
02600000,NORTHWEST TECHNOLOG CTR SCH DIST 10     ,OK,73717-9600,Public       ,4,11,15,12,23,35
02600500,WES WATKINS TECHNOLOGY CENTER           ,OK,74883-9660,Public       ,6,35,41,20,79,99
02609205,VATTEROTT COLLEGE - OKLAHOMA CITY       ,OK,73127-2103,Proprietary  ,19,288,307,38,420,458
03008700,SOUTHWEST TECHNOLOGY CENTER             ,OK,73521-1527,Public       ,13,27,40,29,76,105
03024700,STILLWATER BEAUTY ACADEMY               ,OK,74075-3467,Proprietary  ,3,19,22,9,25,34
03030700,OKLAHOMA SCHOOL OF PHOTOGRAPHY          ,OK,73160-3320,Proprietary  ,4,30,34,26,56,82
03030800,AMERICAN BROADCASTING SCHOOL            ,OK,73115-3334,Proprietary  ,9,76,85,25,147,172
03051100,CHISHOLM TRAIL TECHNOLOGY CENTER        ,OK,73764-6335,Public       ,2,10,12,6,30,36
03078500,TECH INST OF COSMETOLOGY ARTS & SCI     ,OK,74120-3610,Proprietary  ,11,22,33,25,47,72
03103800,SOUTHERN SCHOOL OF BEAUTY               ,OK,74701-5008,Proprietary  ,4,18,22,10,25,35
03109800,PONCA CITY BEAUTY COLLEGE               ,OK,74601-4201,Proprietary  ,2,17,19,8,26,34
03109801,BARTLESVILLE BEAUTY COLLEGE             ,OK,74003-2835,Proprietary  ,0,10,10,3,24,27
03115100,HERITAGE COLLEGE                        ,OK,73119-0000,Proprietary  ,63,300,363,113,526,639
03124901,IMAGINE -  PAUL MITCHELL PARTNER SCHOOL ,OK,73072-4831,Proprietary  ,36,83,119,59,122,181
03126200,GREEN COUNTRY AREA VOC TECH SCHOOL      ,OK,74447-1217,Public       ,23,55,78,49,111,160
03198400,MID-DEL AREA VOCATIONAL & TECH SCH      ,OK,73110-4825,Public       ,19,46,65,37,100,137
03329400,PRYOR BEAUTY COLLEGE                    ,OK,74361-0000,Proprietary  ,0,14,14,4,16,20
03329401,PRYOR BEAUTY COLLEGE - GROVE BEAUTY COLL,OK,74345-0009,Proprietary  ,0,8,8,0,9,9
03329402,PRYOR BEAUTY COLLEGE - NORTH EAST OKLAHO,OK,74338-0000,Proprietary  ,0,0,0,0,1,1
03367400,COMMUNITY CARE COLLEGE                  ,OK,74145-6420,Proprietary  ,166,692,858,288,1057,1345
03453400,SHAWNEE BEAUTY COLLEGE                  ,OK,74801-7014,Proprietary  ,2,12,14,4,25,29
03676300,FAMILY OF FAITH COLLEGE                 ,OK,74802-1805,Private      ,3,7,10,6,18,24
03831300,INSTITUTE OF HAIR DESIGN                ,OK,74804-0000,Proprietary  ,3,7,10,4,16,20
03928300,CENTRAL STATE MASSAGE ACADEMY           ,OK,73162-6007,Proprietary  ,4,25,29,13,57,70
04051324,ART INSTITUTE OF PHOENIX (THE) - BROWN M,OK,74146-5234,Proprietary  ,15,80,95,41,204,245
04060300,AMERICAN INSTITUTE OF MEDICAL TECHNOLOGY,OK,74146-5201,Proprietary  ,32,95,127,78,186,264
04133600,CUTTER'S EDGE SCHOOL OF COSMETOLOGY     ,OK,74023-2905,Proprietary  ,2,6,8,3,13,16
04144400,ACADEMY OF HAIR DESIGN (THE)            ,OK,73120-6808,Proprietary  ,9,39,48,28,98,126
04184300,PAUL MITCHELL THE SCHOOL ARDMORE        ,OK,73401-3912,Proprietary  ,2,11,13,9,31,40
04213600,RIVER VALLEY COSMETOLOGY INSTITUTE      ,OK,74953-5260,Proprietary  ,6,21,27,11,41,52
04224700,JB'S HAIR DESIGN AND BARBER COLLEGE     ,OK,73139-1602,Proprietary  ,10,48,58,17,94,111
04224900,COLLEGE OF THE MUSCOGEE NATION          ,OK,74447-0917,Public       ,33,37,70,75,92,167
04225100,COMANCHE NATION COLLEGE                 ,OK,73501-7434,Public       ,3,29,32,13,71,84
04240500,PAUL MITCHELL THE SCHOOL TULSA          ,OK,74134-1410,Proprietary  ,32,71,103,63,132,195
00163700,BETHANY THEOLOGICAL SEMINARY            ,IN,47374-0000,Private      ,0,24,24,1,37,38
00178400,ANCILLA COLLEGE-FINANCIAL AID OFFC      ,IN,46513-0001,Private      ,37,40,77,499,326,825
00178500,ANDERSON UNIVERSITY                     ,IN,46012-3495,Private      ,167,194,361,2492,890,3382
00178600,BALL STATE UNIVERSITY                   ,IN,47306-0880,Public       ,715,1170,1885,23201,7598,30799
00178700,BETHEL COLLEGE INC                      ,IN,46545-5591,Private      ,69,175,244,1737,1157,2894
00178800,BUTLER UNIVERSITY                       ,IN,46208-3487,Private      ,309,320,629,7873,1969,9842
00178900,CHRISTIAN THEOLOGICAL SEMINARY          ,IN,46208-0000,Private      ,1,45,46,14,218,232
00179200,DEPAUW UNIVERSITY                       ,IN,46135-0037,Private      ,170,20,190,3196,150,3346
00179300,EARLHAM COLLEGE                         ,IN,47374-4095,Private      ,172,40,212,1535,145,1680
00179301,EARLHAM SCHOOL OF RELIGION              ,IN,47374-0000,Private      ,0,19,19,13,45,58
00179500,UNIVERSITY OF EVANSVILLE                ,IN,47722-0002,Private      ,150,130,280,3288,687,3975
00179800,FRANKLIN COLLEGE OF INDIANA             ,IN,46131-2623,Private      ,49,36,85,1927,312,2239
00179900,GOSHEN COLLEGE                          ,IN,46526-4794,Private      ,64,74,138,854,455,1309
00180000,GRACE COLLEGE & THEO SEMINARY           ,IN,46590-1224,Private      ,113,122,235,2188,612,2800
00180100,HANOVER COLLEGE                         ,IN,47243-0108,Private      ,38,12,50,2136,114,2250
00180300,HUNTINGTON UNIVERSITY                   ,IN,46750-1299,Private      ,30,95,125,1268,494,1762
00180400,UNIVERSITY OF INDIANAPOLIS              ,IN,46227-3697,Private      ,209,591,800,6611,4291,10902
00180500,INDIANA INSTITUTE OF TECHNOLOGY         ,IN,46803-1297,Private      ,228,1331,1559,2605,6481,9086
00180700,INDIANA STATE UNIVERSITY                ,IN,47809-2501,Public       ,563,1200,1763,14486,6527,21013
00180800,UNIVERSITY OF SOUTHERN INDIANA          ,IN,47712-3596,Public       ,433,587,1020,8154,3009,11163
00180900,INDIANA UNIVERSITY-BLOOMINGTON          ,IN,47405-7000,Public       ,1311,1708,3019,33838,9839,43677
00181100,INDIANA UNIV-EAST                       ,IN,47374-1289,Public       ,144,422,566,1982,2419,4401
00181300,INDIANA UNIV-PURDUE UNIV INDPLS         ,IN,46202-5145,Public       ,889,3154,4043,23584,19730,43314
00181301,INDIANA UNIVERSITY - PURDUE UNIVERSITY I,IN,47203-1769,Public       ,84,245,329,2014,1632,3646
00181400,INDIANA UNIV KOKOMO                     ,IN,46902-3557,Public       ,106,282,388,2722,2139,4861
00181500,INDIANA UNIV-NORTHWEST                  ,IN,46408-1197,Public       ,274,757,1031,3910,3974,7884
00181600,INDIANA UNIVERSITY - SOUTH BEND         ,IN,46615-0000,Public       ,234,550,784,4942,4264,9206
00181700,INDIANA UNIVERSITY-SOUTHEAST            ,IN,47150-6405,Public       ,365,757,1122,3997,3027,7024
00182000,MANCHESTER UNIVERSITY                   ,IN,46962-1276,Private      ,42,50,92,2609,531,3140
00182100,MARIAN UNIVERSITY                       ,IN,46222-1997,Private      ,109,577,686,2403,2879,5282
00182200,INDIANA WESLEYAN UNIVERSITY             ,IN,46953-4974,Private      ,289,3111,3400,4116,12617,16733
00182300,ASSOCIATED MENNONITE BIBLICAL SEM       ,IN,46517-1999,Private      ,0,31,31,3,69,72
00182400,OAKLAND CITY UNIVERSITY                 ,IN,47660-1099,Private      ,28,98,126,455,506,961
00182500,PURDUE UNIVERSITY                       ,IN,47907-2050,Public       ,1094,1009,2103,34483,6607,41090
00182600,PURDUE UNIV NORTH CENTRAL CAMPUS        ,IN,46391-9542,Public       ,185,291,476,3231,1887,5118
00182700,PURDUE UNIV CALUMET                     ,IN,46323-2094,Public       ,429,1052,1481,5515,5054,10569
00182800,INDIANA UNIV-PURDUE UNIV FORT WAYNE     ,IN,46805-1499,Public       ,482,888,1370,9297,5722,15019
00183000,ROSE HULMAN INSTITUTE OF TECHNOLOGY     ,IN,47803-3999,Private      ,221,31,252,3277,188,3465
00183200,UNIVERSITY OF SAINT FRANCIS             ,IN,46808-3994,Private      ,68,285,353,2264,1821,4085
00183300,ST JOSEPH'S COLLEGE                     ,IN,47978-0000,Private      ,53,29,82,1460,194,1654
00183400,CALUMET COLLEGE OF SAINT JOSEPH         ,IN,46394-2195,Private      ,65,113,178,499,570,1069
00183500,SAINT MARY-OF-THE-WOODS COLLEGE         ,IN,47876-0067,Private      ,24,180,204,401,828,1229
00183600,ST MARY'S COLLEGE                       ,IN,46556-5007,Private      ,123,22,145,1882,181,2063
00183800,TAYLOR UNIVERSITY                       ,IN,46989-1001,Private      ,140,41,181,2399,194,2593
00183900,TRINE UNIVERSITY                        ,IN,46703-1764,Private      ,83,128,211,2944,967,3911
00184000,UNIVERSITY OF NOTRE DAME                ,IN,46556-5602,Private      ,1542,471,2013,13467,2713,16180
00184200,VALPARAISO UNIVERSITY                   ,IN,46383-6493,Private      ,257,380,637,5558,1669,7227
00184300,VINCENNES UNIVERSITY                    ,IN,47591-1523,Public       ,367,709,1076,7036,3540,10576
00184400,WABASH COLLEGE                          ,IN,47933-0352,Private      ,35,14,49,1276,61,1337
00457900,INTERNATIONAL BUSINESS COLLEGE          ,IN,46804-0000,Proprietary  ,69,56,125,604,323,927
00457901,INTERNATIONAL BUSINESS COLLEGE          ,IN,46256-0000,Proprietary  ,40,68,108,601,420,1021
00625700,SAINT ELIZABETH SCHOOL OF NURSING       ,IN,47904-2198,Private      ,12,50,62,155,317,472
00638510,CHAMBERLAIN COLLEGE OF NURSING - INDIANA,IN,46240-2158,Proprietary  ,36,494,530,185,1456,1641
00726300,HOLY CROSS COLLEGE                      ,IN,46556-0308,Private      ,47,15,62,703,120,823
00727600,SAINT MEINRAD SCHOOL OF THEOLOGY        ,IN,47577-1002,Private      ,0,28,28,1,56,57
00732900,ITT TECHNICAL INSTITUTE                 ,IN,46268-1119,Proprietary  ,1120,5825,6945,2061,10646,12707
00732933,ITT TECHNICAL INSTITUTE                 ,IN,46635-1512,Proprietary  ,27,167,194,259,617,876
00732962,ITT TECHNICAL INSTITUTE                 ,IN,47630-7430,Proprietary  ,211,1183,1394,385,2101,2486
00732968,ITT TECHNICAL INSTITUTE                 ,IN,46410-0000,Proprietary  ,26,98,124,196,610,806
00732993,ITT TECHNICAL INSTITUTE                 ,IN,46825-2393,Proprietary  ,215,959,1174,629,1846,2475
00736200,MEDTECH COLLEGE                         ,IN,46250-3970,Proprietary  ,36,214,250,234,1211,1445
00736202,MEDTECH COLLEGE - GREENWOOD             ,IN,46143-6478,Proprietary  ,11,100,111,82,458,540
00736204,MEDTECH COLLEGE - FORT WAYNE            ,IN,46804-2209,Proprietary  ,22,155,177,160,753,913
00793800,LINCOLN COLLEGE OF TECHNOLOGY           ,IN,46202-0000,Proprietary  ,343,243,586,1361,783,2144
00951500,J MICHAEL HARROLD BEAUTY ACADEMY        ,IN,47807-3390,Proprietary  ,10,27,37,40,91,131
00961200,"APEX SCHOOL OF BEAUTY CULTURE, INC      ",IN,46016-0000,Proprietary  ,0,7,7,19,44,63
00961300,MERRILLVILLE BEAUTY COLLEGE             ,IN,46410-3401,Proprietary  ,9,68,77,31,132,163
00967300,RUDAE'S SCHOOL OF BEAUTY CULTURE        ,IN,46825-5444,Proprietary  ,15,53,68,95,150,245
00991700,IVY TECH COMMUNITY COLLEGE OF INDIANA   ,IN,46208-1763,Public       ,2863,10708,13571,36763,61993,98756
01015100,VINCENNES BEAUTY COLLEGE                ,IN,47591-1297,Proprietary  ,5,21,26,83,65,148
01040900,LAFAYETTE BEAUTY ACADEMY                ,IN,47901-1149,Proprietary  ,20,58,78,56,150,206
01048900,NATIONAL COLLEGE                        ,IN,46250-1930,Proprietary  ,4,69,73,43,312,355
01048910,NATIONAL COLLEGE - SOUTH BEND           ,IN,46617-3123,Proprietary  ,5,45,50,54,272,326
01048911,NATIONAL COLLEGE - FORT WAYNE           ,IN,46826-4905,Proprietary  ,6,37,43,41,166,207
01061800,MID-AMERICA CLG FUNERAL SERVICE         ,IN,47130-9990,Private      ,13,32,45,51,92,143
01150500,CREATIVE HAIR STYLING ACADEMY           ,IN,46322-1554,Proprietary  ,30,47,77,94,129,223
02084800,RAVENSCROFT BEAUTY COLLEGE              ,IN,46815-0000,Proprietary  ,19,62,81,84,156,240
02087600,CONCORDIA THEOLOGICAL SEMINARY          ,IN,46825-0000,Private      ,0,99,99,8,195,203
02100402,EVEREST INSTITUTE - EVEREST COLLEGE     ,IN,46410-7064,Proprietary  ,3,33,36,67,226,293
02140800,MARTIN UNIVERSITY                       ,IN,46218-0000,Private      ,6,134,140,130,901,1031
02158400,HARRISON COLLEGE                        ,IN,46204-2611,Proprietary  ,59,582,641,512,2387,2899
02158401,HARRISON COLLEGE - COLUMBUS             ,IN,47203-1843,Proprietary  ,11,91,102,131,482,613
02158402,HARRISON COLLEGE - LAFAYETTE            ,IN,47905-4859,Proprietary  ,25,126,151,156,481,637
02158405,HARRISON COLLEGE - TERRE HAUTE          ,IN,47802-0000,Proprietary  ,12,118,130,106,537,643
02158407,HARRISON COLLEGE - ANDERSON             ,IN,46013-0000,Proprietary  ,22,131,153,136,492,628
02158409,HARRISON COLLEGE - EVANSVILLE           ,IN,47715-3901,Proprietary  ,24,106,130,164,416,580
02158410,HARRISON COLLEGE - EAST                 ,IN,46239-8903,Proprietary  ,30,207,237,205,951,1156
02158412,HARRISON COLLEGE - FORT WAYNE           ,IN,46825-0000,Proprietary  ,14,113,127,121,520,641
02158413,HARRISON COLLEGE - NORTHWEST            ,IN,46278-0000,Proprietary  ,15,62,77,220,374,594
02158415,HARRISON COLLEGE - MUNCIE               ,IN,47303-0000,Proprietary  ,3,39,42,79,170,249
02158416,HARRISON COLLEGE - ELKHART              ,IN,46516-0000,Proprietary  ,6,49,55,58,237,295
02158800,DON ROBERTS BEAUTY SCHOOLS              ,IN,46383-0000,Proprietary  ,3,17,20,31,51,82
02164300,DON ROBERTS SCHOOL OF HAIR DESIGN       ,IN,46375-9999,Proprietary  ,6,26,32,21,51,72
02180108,ROSS MEDICAL EDUCATION CENTER -         ,IN,46530-4479,Proprietary  ,5,38,43,54,153,207
02201800,KAPLAN COLLEGE                          ,IN,46324-3347,Proprietary  ,44,226,270,173,575,748
02201806,KAPLAN COLLEGE - SOUTHEAST INDIANAPOLIS ,IN,46227-1493,Proprietary  ,62,424,486,318,1367,1685
02241700,PJ'S COLLEGE OF COSMETOLOGY             ,IN,47129-0000,Proprietary  ,15,49,64,56,114,170
02245505,FORTIS COLLEGE - INDIANAPOLIS CAMPUS    ,IN,46268-0000,Proprietary  ,12,110,122,80,533,613
02304800,PJ'S COLLEGE OF COSMETOLOGY             ,IN,47374-0000,Proprietary  ,6,16,22,44,68,112
02308900,MASTER'S OF COSMETOLOGY COLLEGE         ,IN,46809-0000,Proprietary  ,13,21,34,89,108,197
02339600,ROGER'S ACADEMY OF HAIR DESIGN          ,IN,47712-0000,Proprietary  ,15,38,53,60,80,140
02351300,KNOX BEAUTY COLLEGE                     ,IN,46534-0000,Proprietary  ,4,4,8,10,19,29
02490500,HAIR FASHIONS BY KAYE BEAUTY CLG        ,IN,46250-0000,Proprietary  ,12,77,89,76,227,303
02490800,HAIR FASHIONS BY KAYE BEAUTY CLG        ,IN,46060-0000,Proprietary  ,3,12,15,24,38,62
02607000,HAIR ARTS ACADEMY                       ,IN,47404-2419,Proprietary  ,7,18,25,53,81,134
02615800,COLLEGE OF COURT REPORTING              ,IN,46342-5969,Proprietary  ,9,87,96,26,187,213
03176300,AVIATION INSTITUTE OF MAINTENANCE       ,IN,46241-1445,Proprietary  ,16,78,94,119,281,400
03456700,CROSSROADS BIBLE COLLEGE                ,IN,46219-4912,Private      ,4,37,41,54,369,423
03538300,ALEXANDRIA SCH OF SCIENTIFIC THERAP     ,IN,46001-0287,Proprietary  ,2,20,22,17,50,67
04038700,IDEAL BEAUTY ACADEMY                    ,IN,47130-4215,Proprietary  ,1,12,13,15,35,50
04051304,ART INSTITUTE OF PHOENIX (THE) - ART  IN,IN,46268-1170,Proprietary  ,107,198,305,899,750,1649
04051311,ART INSTITUTE OF PHOENIX (THE) - BROWN M,IN,46410-5608,Proprietary  ,30,165,195,102,489,591
04051312,ART INSTITUTE OF PHOENIX (THE) - BROWN M,IN,46360-7362,Proprietary  ,4,14,18,36,95,131
04051318,ART INSTITUTE OF PHOENIX (THE) - BROWN M,IN,46204-1017,Proprietary  ,27,253,280,213,1028,1241
04051321,ART INSTITUTE OF PHOENIX (THE) - BROWN M,IN,46635-1176,Proprietary  ,24,112,136,114,435,549
04051322,ART INSTITUTE OF PHOENIX (THE) - BROWN M,IN,46805-0000,Proprietary  ,19,142,161,135,504,639
04100300,SUCCESS SCHOOLS                         ,IN,46410-5310,Proprietary  ,22,48,70,57,141,198
04121000,TECHSKILLS - INDIANAPOLIS               ,IN,46240-4302,Proprietary  ,16,148,164,82,319,401
04130900,HONORS BEAUTY COLLEGE                   ,IN,46256-3317,Proprietary  ,27,68,95,91,215,306
04155900,AVEDA FREDRIC'S INSTITUTE               ,IN,46250-4746,Proprietary  ,19,44,63,159,202,361
04166700,REM SPA INC                             ,IN,46013-3136,Proprietary  ,12,35,47,50,108,158
04171700,AVANT GARD THE SCHOOL                   ,IN,46214-6500,Proprietary  ,1,11,12,20,55,75
04172700,SALON PROFESSIONAL ACADEMY (THE)        ,IN,47715-7822,Proprietary  ,21,44,65,101,105,206
04184000,PAUL MITCHELL THE SCHOOL INDIANAPOLIS   ,IN,46227-6252,Proprietary  ,18,52,70,146,222,368
04186600,SALON PROFESSIONAL ACADEMY (THE)        ,IN,46901-6248,Proprietary  ,14,40,54,57,104,161
04205500,LIL LOU'S BARBER COLLEGE                ,IN,46409-2645,Proprietary  ,5,38,43,30,99,129
04230300,EXCEL ACADEMIES OF COSMETOLOGY - MERRILL,IN,46410-5540,Proprietary  ,6,23,29,58,74,132
00190100,ALLEN COUNTY COMMUNITY COLLEGE          ,KS,66749-1607,Public       ,289,385,674,837,768,1605
00190200,COWLEY COUNTY COMMUNITY COLLEGE & AREA V,KS,67005-2662,Public       ,396,580,976,1111,1107,2218
00190300,BAKER UNIVERSITY                        ,KS,66006-0065,Private      ,213,509,722,1196,1112,2308
00190400,BETHANY COLLEGE                         ,KS,67456-1897,Private      ,227,35,262,818,101,919
00190500,BETHEL COLLEGE                          ,KS,67117-8061,Private      ,175,52,227,676,139,815
00190600,BUTLER COUNTY COMMUNITY COLLEGE         ,KS,67042-3280,Public       ,1210,1624,2834,3183,2935,6118
00190700,CENTRAL BAPTIST THEOLOGY SEMINARY       ,KS,66226-3513,Private      ,0,19,19,0,29,29
00190800,CENTRAL CHRISTIAN COLLEGE OF KANSAS     ,KS,67460-5799,Private      ,111,274,385,311,506,817
00190900,CLOUD COUNTY COMMUNITY COLLEGE          ,KS,66901-1002,Public       ,230,244,474,585,554,1139
00191000,COFFEYVILLE COMMUNITY COLLEGE           ,KS,67337-5064,Public       ,277,186,463,755,324,1079
00191100,COLBY COMMUNITY COLLEGE                 ,KS,67701-4099,Public       ,162,187,349,464,360,824
00191300,DODGE CITY COMMUNITY COLLEGE            ,KS,67801-2399,Public       ,298,195,493,670,381,1051
00191400,DONNELLY COLLEGE                        ,KS,66102-4298,Private      ,74,153,227,247,317,564
00191500,FORT HAYS STATE UNIVERSITY              ,KS,67601-4099,Public       ,1072,2058,3130,4002,4949,8951
00191600,FORT SCOTT COMMUNITY COLLEGE            ,KS,66701-3199,Public       ,341,257,598,855,481,1336
00191700,BARCLAY COLLEGE                         ,KS,67059-0288,Private      ,49,31,80,120,85,205
00191800,FRIENDS UNIVERSITY                      ,KS,67213-3397,Private      ,304,750,1054,1188,1351,2539
00191900,GARDEN CITY COMMUNITY COLLEGE           ,KS,67846-6398,Public       ,423,207,630,981,402,1383
00192000,HESSTON COLLEGE                         ,KS,67062-2093,Private      ,66,56,122,370,144,514
00192100,HIGHLAND COMMUNITY COLLEGE              ,KS,66035-4062,Public       ,362,370,732,978,810,1788
00192300,HUTCHINSON COMMUNITY COLLEGE            ,KS,67501-5894,Public       ,566,709,1275,1783,1488,3271
00192400,INDEPENDENCE COMMUNITY COLLEGE          ,KS,67301-0708,Public       ,248,136,384,493,230,723
00192500,KANSAS CITY KANSAS COMMUNITY CLG        ,KS,66112-9978,Public       ,566,1357,1923,1512,2673,4185
00192600,PITTSBURG STATE UNIVERSITY              ,KS,66762-7500,Public       ,1286,784,2070,4737,1870,6607
00192700,EMPORIA STATE UNIVERSITY                ,KS,66801-5415,Public       ,791,833,1624,3119,2045,5164
00192800,KANSAS STATE UNIVERSITY                 ,KS,66506-1104,Public       ,2293,1491,3784,15041,5112,20153
00192900,KANSAS WESLEYAN UNIVERSITY              ,KS,67401-6196,Private      ,157,67,224,940,222,1162
00193000,LABETTE COMMUNITY COLLEGE               ,KS,67357-4299,Public       ,191,275,466,477,486,963
00193100,MANHATTAN CHRISTIAN COLLEGE             ,KS,66502-4081,Private      ,63,40,103,304,86,390
00193300,MCPHERSON COLLEGE                       ,KS,67460-3899,Private      ,180,45,225,790,131,921
00193600,NEOSHO COUNTY COMMUNITY COLLEGE         ,KS,66720-2699,Public       ,245,329,574,601,681,1282
00193700,OTTAWA UNIVERSITY                       ,KS,66067-3399,Private      ,256,827,1083,953,1550,2503
00193800,PRATT COMMUNITY COLLEGE                 ,KS,67124-8432,Public       ,182,155,337,451,363,814
00193900,NEWMAN UNIVERSITY                       ,KS,67213-2084,Private      ,226,453,679,1048,1075,2123
00194000,SOUTHWESTERN COLLEGE                    ,KS,67156-2499,Private      ,148,415,563,666,830,1496
00194300,UNIVERSITY OF ST MARY                   ,KS,66048-5023,Private      ,202,279,481,744,599,1343
00194500,STERLING COLLEGE                        ,KS,67579-1533,Private      ,128,41,169,902,123,1025
00194600,TABOR COLLEGE                           ,KS,67063-1799,Private      ,140,72,212,731,174,905
00194800,UNIVERSITY OF KANSAS                    ,KS,66045-7535,Public       ,2051,2025,4076,16712,8042,24754
00194900,WASHBURN UNIVERSITY                     ,KS,66621-1110,Public       ,512,879,1391,3232,2797,6029
00194901,WASHBURN INSTITUTE OF TECHNOLOGY        ,KS,66604-2199,Public       ,102,256,358,270,574,844
00195000,WICHITA STATE UNIVERSITY                ,KS,67208-0000,Public       ,1774,2442,4216,7551,5648,13199
00460800,BARTON COUNTY COMMUNITY COLLEGE         ,KS,67530-9283,Public       ,305,672,977,762,1345,2107
00526400,FLINT HILLS TECHNICAL COLLEGE           ,KS,66801-5999,Public       ,94,137,231,212,266,478
00526500,NORTH CENTRAL KANSAS TECH COLG          ,KS,67420-0000,Public       ,116,107,223,301,197,498
00526700,NORTHWEST KANSAS TECHNICAL SCHOOL       ,KS,67735-3441,Public       ,124,36,160,285,73,358
00549800,WICHITA AREA TECHNICAL COLLEGE          ,KS,67211-2099,Public       ,235,767,1002,540,1464,2004
00549900,SALINA AREA TECHNICAL COLLEGE           ,KS,67401-8195,Public       ,68,101,169,136,197,333
00550000,MANHATTAN AREA TECHNICAL COLLEGE        ,KS,66503-2499,Public       ,124,220,344,308,428,736
00675500,BROWN MACKIE COLLEGE (THE)              ,KS,67401-7307,Proprietary  ,176,895,1071,327,1485,1812
00703200,MID AMERICA NAZARENE UNIVERSITY         ,KS,66062-1899,Private      ,175,394,569,1012,907,1919
00822800,SEWARD CO COMM CO/AREA TECHNICAL SCHOOL ,KS,67905-0000,Public       ,198,142,340,388,255,643
00824400,JOHNSON COUNTY COMMUNITY COLLEGE        ,KS,66210-1299,Public       ,1586,2249,3835,4623,4518,9141
00833200,MARINELLO SCHOOL OF BEAUTY              ,KS,66502-6082,Proprietary  ,8,37,45,23,61,84
00833201,MARINELLO SCHOOL OF BEAUTY - LAWRENCE   ,KS,66046-2743,Proprietary  ,6,13,19,15,31,46
00869423,RASMUSSEN COLLEGE - OVERLAND PARK       ,KS,66210-2786,Proprietary  ,9,104,113,24,188,212
00869424,RASMUSSEN COLLEGE - TOPEKA              ,KS,66606-2339,Proprietary  ,14,124,138,41,274,315
01025600,BENEDICTINE COLLEGE                     ,KS,66002-1499,Private      ,354,44,398,2339,132,2471
01043800,HASKELL INDIAN NATIONS UNIVERSITY       ,KS,66046-4800,Public       ,320,217,537,711,450,1161
01050300,WICHITA TECHNICAL INSTITUTE             ,KS,67213-1927,Proprietary  ,67,276,343,119,503,622
01050302,WICHITA TECHNICAL INSTITUTE - WTI TOPEKA,KS,66609-1217,Proprietary  ,12,90,102,26,134,160
01050305,WICHITA TECHNICAL INSTITUTE - EAST CAMPU,KS,67208-4243,Proprietary  ,22,93,115,49,198,247
02090700,CLEVELAND CHIROPRACTIC COLLEGE          ,KS,66210-1613,Private      ,17,225,242,44,408,452
02134800,OLD TOWN BARBER AND BEAUTY COLLEGE      ,KS,67211-0000,Proprietary  ,9,34,43,21,68,89
02168900,KANSAS CITY COLLEGE & BIBLE SCHOOL      ,KS,66204-1975,Private      ,4,12,16,8,30,38
02257700,HAYS ACADEMY OF HAIR DESIGN             ,KS,67601-3685,Proprietary  ,19,21,40,39,34,73
02257702,HAYS ACADEMY OF HAIR DESIGN -           ,KS,67401-0000,Proprietary  ,17,19,36,38,37,75
02340700,LABARON HAIRDRESSING ACADEMY            ,KS,66204-0000,Proprietary  ,1,16,17,4,25,29
02590900,WRIGHT CAREER COLLEGE                   ,KS,66212-0000,Private      ,111,991,1102,154,1638,1792
02599709,VATTEROTT COLLEGE - WICHITA             ,KS,67226-1304,Proprietary  ,22,142,164,38,269,307
02603100,XENON INTERNATIONAL ACADEMY             ,KS,67203-5428,Proprietary  ,43,77,120,73,141,214
02606300,PAUL MITCHELL THE SCHOOL WICHITA        ,KS,67226-2803,Proprietary  ,44,47,91,91,108,199
02611005,HERITAGE COLLEGE - WICHITA              ,KS,67210-1879,Proprietary  ,42,162,204,84,302,386
02613000,PINNACLE CAREER INSTITUTE               ,KS,66046-2703,Proprietary  ,18,85,103,38,161,199
03066200,BRYAN COLLEGE                           ,KS,66604-2496,Proprietary  ,6,87,93,19,147,166
03450300,MARINELLO SCHOOL OF BEAUTY              ,KS,66611-1101,Proprietary  ,13,34,47,36,71,107
03450301,MARINELLO SCHOOL OF BEAUTY - WICHITA    ,KS,67207-5148,Proprietary  ,9,40,49,28,73,101
03450302,MARINELLO SCHOOL OF BEAUTY - OVERLAND PA,KS,66212-5451,Proprietary  ,12,61,73,31,101,132
03529300,SIDNEY'S HAIRDRESSING COLLEGE           ,KS,67501-7094,Proprietary  ,5,13,18,14,18,32
04132900,Z HAIR ACADEMY                          ,KS,66046-4040,Proprietary  ,26,34,60,38,44,82
04162700,ERIC FISHER ACADEMY                     ,KS,67212-3376,Proprietary  ,62,70,132,110,128,238
04179600,ENTOURAGE INSTITUTE OF BEAUTY AND ESTHET,KS,66215-3803,Proprietary  ,3,30,33,13,66,79
04205300,MITSU SATO HAIR ACADEMY                 ,KS,66212-1457,Proprietary  ,3,10,13,8,20,28
04209300,PAUL MITCHELL THE SCHOOL - OVERLAND PARK,KS,66212-4050,Proprietary  ,40,65,105,80,108,188
00203300,UNIVERSITY OF MAINE-PRESQUE ISLE        ,ME,04769-2888,Public       ,122,110,232,1043,372,1415
00203600,BATES COLLEGE                           ,ME,04240-6028,Private      ,340,25,365,3082,105,3187
00203800,BOWDOIN COLLEGE                         ,ME,04011-8451,Private      ,336,25,361,3851,101,3952
00203900,COLBY COLLEGE                           ,ME,04901-8841,Private      ,269,17,286,3520,84,3604
00204000,UNIVERSITY OF MAINE-FARMINGTON          ,ME,04938-1990,Public       ,178,100,278,2470,396,2866
00204100,UNIVERSITY OF MAINE-FORT KENT           ,ME,04743-1292,Public       ,98,166,264,665,509,1174
00204300,HUSSON UNIVERSITY                       ,ME,04401-2999,Private      ,429,401,830,3109,1267,4376
00204400,MAINE MARITIME ACADEMY                  ,ME,04420-0001,Public       ,105,37,142,1137,178,1315
00205000,UNIVERSITY OF NEW ENGLAND               ,ME,04005-9599,Private      ,486,1590,2076,4701,4600,9301
00205100,SAINT JOSEPH'S COLLEGE                  ,ME,04084-5236,Private      ,231,407,638,1690,999,2689
00205200,THOMAS COLLEGE                          ,ME,04901-5097,Private      ,196,79,275,1196,246,1442
00205300,UNIVERSITY OF MAINE                     ,ME,04469-0001,Public       ,772,482,1254,13457,2447,15904
00205400,UNIVERSITY OF SOUTHERN MAINE            ,ME,04104-0000,Public       ,515,882,1397,5334,4217,9551
00205500,UNIVERSITY OF MAINE-MACHIAS             ,ME,04654-1397,Public       ,85,78,163,551,301,852
00458615,KAPLAN UNIVERSITY - PORTLAND            ,ME,04106-2415,Proprietary  ,29,288,317,73,645,718
00458616,KAPLAN UNIVERSITY - LEWISTON            ,ME,04240-0000,Proprietary  ,28,244,272,72,715,787
00458617,KAPLAN UNIVERSITY - AUGUSTA             ,ME,04330-8038,Proprietary  ,40,332,372,106,738,844
00520400,BEAL COLLEGE                            ,ME,04401-6896,Proprietary  ,61,199,260,170,486,656
00527600,CENTRAL MAINE COMMUNITY COLLEGE         ,ME,04210-6498,Public       ,375,526,901,1355,1443,2798
00527700,EASTERN MAINE COMMUNITY COLLEGE         ,ME,04401-4280,Public       ,379,523,902,1483,1329,2812
00552500,SOUTHERN MAINE COMMUNITY  COLLEGE       ,ME,04106-1698,Public       ,1021,1380,2401,3143,2782,5925
00576000,NORTHERN MAINE COMMUNITY COLLEGE        ,ME,04769-2016,Public       ,120,155,275,411,357,768
00630500,CENTRAL MAINE MEDICAL CENTER COLLEGE OF ,ME,04243-9986,Private      ,29,92,121,113,250,363
00676000,UNIVERSITY OF MAINE-AUGUSTA             ,ME,04330-9410,Public       ,269,1147,1416,1304,3766,5070
00685800,UNITY COLLEGE                           ,ME,04988-9502,Private      ,151,26,177,1063,103,1166
00903800,MR BERNARD'S SCH HAIR FASHION INC       ,ME,04243-1163,Proprietary  ,0,0,0,1,3,4
00923100,WASHINGTON COUNTY COMMUNITY COLLEGE     ,ME,04619-9704,Public       ,47,65,112,244,185,429
00945900,EMPIRE BEAUTY SCHOOL                    ,ME,04101-3348,Proprietary  ,184,527,711,327,851,1178
00982600,KENNEBEC VALLEY  COMMUNITY  COLLEGE     ,ME,04937-1367,Public       ,221,545,766,812,1296,2108
01138500,COLLEGE OF THE ATLANTIC                 ,ME,04609-1105,Private      ,26,12,38,569,77,646
01167300,MAINE COLLEGE OF ART                    ,ME,04101-3987,Private      ,98,62,160,732,185,917
02104400,SPA TECH INSTITUTE                      ,ME,04093-0000,Proprietary  ,34,109,143,78,205,283
02347100,NEW ENGLAND SCHOOL OF COMMUNICATIONS    ,ME,04401-0000,Private      ,31,18,49,158,59,217
02361300,LANDING SCHOOL OF BOATBUILDING & DESIGN ,ME,04046-1490,Private      ,8,14,22,30,28,58
03122900,YORK COUNTY COMMUNITY COLLEGE           ,ME,04090-0529,Public       ,179,262,441,575,687,1262
03429300,SEACOAST CAREER SCHOOLS                 ,ME,04073-0000,Proprietary  ,20,116,136,36,178,214
03612300,BIRTHWISE MIDWIFERY SCHOOL              ,ME,04009-1110,Proprietary  ,3,30,33,13,72,85
04177400,CAPILO SCHOOL OF HAIR DESIGN            ,ME,04330-0000,Proprietary  ,19,47,66,60,73,133
04185100,NORTHEAST TECHNICAL INSTITUTE           ,ME,04074-0000,Proprietary  ,34,129,163,71,284,355
04188800,INSTITUTE FOR DOCTORAL STUDIES IN THE VI,ME,04102-0000,Private      ,0,25,25,2,45,47
04214100,COSMOTECH SCHOOL OF COSMETOLOGY         ,ME,04092-2878,Proprietary  ,5,14,19,17,30,47
00209300,ST JOHN'S COLLEGE                       ,NM,87505-4599,Private      ,36,48,84,298,143,441
00264900,SANTA FE UNIVERSITY OF ART AND DESIGN   ,NM,87505-7634,Proprietary  ,348,105,453,1314,302,1616
00265000,UNIVERSITY OF THE SOUTHWEST             ,NM,88240-9129,Private      ,134,262,396,257,507,764
00265100,EASTERN NEW MEXICO UNIV PORTALES        ,NM,88130-6000,Public       ,972,1034,2006,2613,1890,4503
00265101,EASTERN NEW MEXICO UNIV-ROSWELL CAM     ,NM,88202-0000,Public       ,321,441,762,671,808,1479
00265300,NEW MEXICO HIGHLANDS UNIVERSITY         ,NM,87701-4436,Public       ,399,897,1296,1622,1858,3480
00265400,NEW MEXICO INST OF MINING & TECH        ,NM,87801-4796,Public       ,323,155,478,1276,372,1648
00265500,NEW MEXICO JUNIOR COLLEGE               ,NM,88240-9123,Public       ,246,274,520,546,501,1047
00265600,NEW MEXICO MILITARY INSTITUTE           ,NM,88201-5173,Public       ,111,17,128,340,37,377
00265700,NEW MEXICO STATE UNIVERSITY             ,NM,88003-8001,Public       ,2494,2393,4887,9581,5451,15032
00265701,NEW MEXICO STATE UNIV-ALAMOGORDO        ,NM,88311-0000,Public       ,107,308,415,311,611,922
00265702,NEW MEXICO STATE UNIV.-DONA ANA CLG     ,NM,88003-0000,Public       ,868,1295,2163,2418,2682,5100
00265703,NEW MEXICO STATE UNIV-CARLSBAD          ,NM,88220-0000,Public       ,106,174,280,201,317,518
00265704,NEW MEXICO STATE UNIV-GRANTS            ,NM,87020-0000,Public       ,45,123,168,116,235,351
00266000,SAN JUAN COLLEGE                        ,NM,87402-4699,Public       ,786,1771,2557,1462,3112,4574
00266300,THE UNIVERSITY OF NEW MEXICO            ,NM,87131-0001,Public       ,3181,4157,7338,16764,13843,30607
00266400,WESTERN NEW MEXICO UNIVERSITY           ,NM,88061-5417,Public       ,321,869,1190,1152,1602,2754
00405701,NATIONAL AMERICAN UNIVERSITY            ,NM,87110-0000,Proprietary  ,20,188,208,58,378,436
00474200,CENTRAL NEW MEXICO COMMUNITY COLLEGE    ,NM,87106-4096,Public       ,2661,4389,7050,6472,9173,15645
00474300,CLOVIS COMMUNITY COLLEGE                ,NM,88101-8381,Public       ,207,544,751,453,865,1318
00996200,LUNA COMMUNITY COLLEGE                  ,NM,87701-0000,Public       ,104,133,237,271,243,514
01063200,DEWOLFF CLG HAIRSTYLING/COSMETOLOGY     ,NM,87112-4113,Proprietary  ,17,42,59,41,82,123
01300500,OLYMPIAN UNIVERSITY OF COSMETOLOGY      ,NM,88310-5051,Proprietary  ,170,551,721,226,720,946
02083900,NORTHERN NEW MEXICO COLLEGE             ,NM,87530-0000,Public       ,133,225,358,343,425,768
02146400,INSTITUTE OF AMERICAN INDIAN ARTS       ,NM,87508-0000,Public       ,54,90,144,136,221,357
02218808,BROOKLINE COLLEGE - ALBUQUERQUE         ,NM,87105-1649,Proprietary  ,65,229,294,139,408,547
02278100,SANTA FE COMMUNITY COLLEGE              ,NM,87507-0000,Public       ,348,832,1180,773,1475,2248
02293203,ATI CAREER TRAINING CENTER - ALBUQUERQUE,NM,87109-2016,Proprietary  ,13,51,64,40,99,139
02357600,NAVAJO TECHNICAL COLLEGE                ,NM,87313-0000,Public       ,230,463,693,329,658,987
02511000,SOUTHWESTERN INDIAN POLYTECH INST       ,NM,87184-0000,Public       ,81,133,214,168,243,411
02572003,COMPUTER CAREER CENTER - LAS CRUCES CAMP,NM,88011-8220,Proprietary  ,78,189,267,120,296,416
02622000,SOUTHWEST ACUPUNCTURE COLLEGE           ,NM,87505-0000,Proprietary  ,1,66,67,5,125,130
03076100,SOUTHWESTERN COLLEGE                    ,NM,87507-0000,Private      ,6,102,108,16,223,239
03206300,MESALANDS COMMUNITY COLLEGE             ,NM,88401-3352,Public       ,26,48,74,80,98,178
03430300,UNIVERSAL THERAPEUTIC MASSAGE INSTITUTE ,NM,87107-4403,Proprietary  ,12,77,89,31,134,165
03678300,PIMA MEDICAL INSTITUTE                  ,NM,87110-0000,Proprietary  ,92,236,328,273,480,753
03944300,MASSAGE THERAPY TRAINING INSTITUTE      ,NM,88007-0000,Proprietary  ,18,41,59,40,73,113
04162400,TONI AND GUY HAIRDRESSING  ACADEMY      ,NM,87110-4404,Proprietary  ,37,70,107,95,145,240
04174500,AVEDA INSTITUTE OF NEW MEXICO (THE)     ,NM,87110-3640,Proprietary  ,41,91,132,111,177,288
04178500,VOGUE COLLEGE OF COSMETOLOGY            ,NM,87505-7636,Proprietary  ,16,49,65,43,73,116
00223400,ADRIAN COLLEGE                          ,MI,49221-2575,Private      ,403,84,487,2848,300,3148
00223500,ALBION COLLEGE                          ,MI,49224-1831,Private      ,279,32,311,2340,128,2468
00223600,ALMA COLLEGE                            ,MI,48801-1599,Private      ,132,24,156,2360,122,2482
00223700,ALPENA COMMUNITY COLLEGE                ,MI,49707-1495,Public       ,168,201,369,818,530,1348
00223800,ANDREWS UNIVERSITY                      ,MI,49104-0750,Private      ,337,325,662,1467,857,2324
00223900,AQUINAS COLLEGE                         ,MI,49506-1799,Private      ,299,158,457,2501,439,2940
00224000,BAY DE NOC COMMUNITY COLLEGE            ,MI,49829-2524,Public       ,160,273,433,823,655,1478
00224100,CALVIN COLLEGE                          ,MI,49546-4388,Private      ,271,133,404,4539,462,5001
00224200,CALVIN THEOLOGICAL SEMINARY             ,MI,49546-4387,Private      ,2,21,23,13,143,156
00224300,CENTRAL MICHIGAN UNIVERSITY             ,MI,48859-0001,Public       ,2752,2454,5206,21540,7929,29469
00224600,CLEARY UNIVERSITY                       ,MI,48105-0000,Private      ,72,146,218,267,357,624
00224800,CRANBROOK ACADEMY OF ART                ,MI,48303-0000,Private      ,6,47,53,32,223,255
00224900,DAVENPORT UNIVERSITY                    ,MI,49503-0000,Private      ,625,2263,2888,3651,6735,10386
00225100,DELTA COLLEGE                           ,MI,48710-0001,Public       ,1297,2058,3355,4822,4588,9410
00225400,MICHIGAN STATE UNIVERSITY COLLEGE OF LAW,MI,48824-1300,Private      ,42,308,350,280,1585,1865
00225900,EASTERN MICHIGAN UNIVERSITY             ,MI,48197-2214,Public       ,2798,3174,5972,17377,9641,27018
00226000,FERRIS STATE UNIVERSITY                 ,MI,49307-2251,Public       ,1671,1714,3385,14056,6040,20096
00226100,CHARLES STEWART MOTT COMMUNITY CLG      ,MI,48503-2089,Public       ,1169,2309,3478,4001,5104,9105
00226200,KETTERING UNIVERSITY                    ,MI,48504-4898,Private      ,283,123,406,2431,376,2807
00226300,GLEN OAKS COMMUNITY COLLEGE             ,MI,49032-9784,Public       ,133,193,326,513,444,957
00226400,GOGEBIC COMMUNITY COLLEGE               ,MI,49938-1365,Public       ,113,148,261,509,293,802
00226500,GRACE BIBLE COLLEGE                     ,MI,49509-1998,Private      ,107,210,317,476,561,1037
00226600,CORNERSTONE UNIVERSITY                  ,MI,49525-5897,Private      ,274,496,770,2137,1246,3383
00226700,GRAND RAPIDS COMMUNITY COLLEGE          ,MI,49503-3295,Public       ,2036,2625,4661,8776,6278,15054
00226800,GRAND VALLEY STATE UNIVERSITY           ,MI,49401-9403,Public       ,2352,1597,3949,25431,6800,32231
00226900,GREAT LAKES CHRISTIAN COLLEGE           ,MI,48917-1299,Private      ,47,47,94,144,108,252
00227000,HENRY FORD COMMUNITY COLLEGE            ,MI,48128-1495,Public       ,2634,3892,6526,7658,8904,16562
00227300,HOPE COLLEGE                            ,MI,49423-3607,Private      ,238,38,276,4685,170,4855
00227400,JACKSON COMMUNITY COLLEGE               ,MI,49201-8399,Public       ,682,1066,1748,2941,2612,5553
00227500,KALAMAZOO COLLEGE                       ,MI,49006-3295,Private      ,138,74,212,2182,217,2399
00227600,KELLOGG COMMUNITY COLLEGE               ,MI,49017-3397,Public       ,552,1414,1966,2111,2922,5033
00227700,LAKE MICHIGAN COLLEGE                   ,MI,49022-1899,Public       ,368,654,1022,1652,1639,3291
00227800,LANSING COMMUNITY COLLEGE               ,MI,48933-1293,Public       ,1853,2603,4456,7138,6056,13194
00227900,LAWRENCE TECHNOLOGICAL UNIVERSITY       ,MI,48075-1058,Private      ,302,333,635,2175,864,3039
00228200,MADONNA UNIVERSITY                      ,MI,48150-1173,Private      ,342,752,1094,1547,2096,3643
00228400,MARYGROVE COLLEGE                       ,MI,48221-2599,Private      ,269,688,957,1039,1722,2761
00228800,ROCHESTER COLLEGE                       ,MI,48307-2764,Private      ,218,220,438,755,553,1308
00229000,MICHIGAN STATE UNIVERSITY               ,MI,48824-1113,Public       ,4507,3243,7750,38028,11637,49665
00229200,MICHIGAN TECHNOLOGICAL UNIV             ,MI,49931-1295,Public       ,676,198,874,6241,716,6957
00229300,LAKE SUPERIOR STATE UNIVERSITY          ,MI,49783-1691,Public       ,228,161,389,2425,653,3078
00229400,MONROE COUNTY COMMUNITY CLG             ,MI,48161-9746,Public       ,419,564,983,1270,1196,2466
00229500,MONTCALM COMMUNITY COLLEGE              ,MI,48885-9723,Public       ,164,340,504,757,851,1608
00229700,MUSKEGON COMMUNITY COLLEGE              ,MI,49442-1432,Public       ,513,741,1254,2547,1847,4394
00229900,NORTH CENTRAL MICHIGAN COLLEGE          ,MI,49770-8740,Public       ,226,307,533,977,761,1738
00230100,NORTHERN MICHIGAN UNIVERSITY            ,MI,49855-5316,Public       ,976,550,1526,7081,1821,8902
00230200,NORTHWESTERN MICHIGAN COLLEGE           ,MI,49686-3061,Public       ,441,621,1062,2120,1693,3813
00230301,OAKLAND COMMUNITY COLLEGE - ORCHARD RIDG,MI,48334-4579,Public       ,800,1346,2146,2662,3351,6013
00230302,OAKLAND COMMUNITY COLLEGE - ROYAL OAK CA,MI,48067-3898,Public       ,1030,1965,2995,3416,4673,8089
00230303,OAKLAND COMMUNITY COLLEGE - SOUTHFIELD C,MI,48075-4793,Public       ,807,2124,2931,2603,5146,7749
00230304,OAKLAND COMMUNITY COLLEGE - AUBURN HILLS,MI,48323-2845,Public       ,1041,1544,2585,3917,3841,7758
00230305,OAKLAND COMMUNITY COLLEGE - HIGHLAND LAK,MI,48327-4187,Public       ,542,923,1465,1916,2317,4233
00230700,OAKLAND UNIVERSITY                      ,MI,48309-4401,Public       ,2562,2473,5035,16032,7639,23671
00230800,OLIVET COLLEGE                          ,MI,49076-9902,Private      ,197,45,242,1554,184,1738
00231000,ST. CLAIR COUNTY COMMUNITY COLLEGE      ,MI,48061-0000,Public       ,360,585,945,1591,1291,2882
00231100,KUYPER COLLEGE                          ,MI,49525-9749,Private      ,46,36,82,325,118,443
00231300,SACRED HEART MAJOR SEMINARY             ,MI,48206-1799,Private      ,11,52,63,32,127,159
00231400,SAGINAW VALLEY STATE UNIV               ,MI,48710-0001,Public       ,1168,892,2060,9471,3093,12564
00231500,SCHOOLCRAFT COLLEGE                     ,MI,48152-2696,Public       ,1660,2600,4260,5473,6082,11555
00231600,SIENA HEIGHTS UNIVERSITY                ,MI,49221-1796,Private      ,302,672,974,1706,1744,3450
00231700,SOUTHWESTERN MICHIGAN COLLEGE           ,MI,49047-9793,Public       ,359,361,720,1907,1038,2945
00231800,SPRING ARBOR UNIVERSITY                 ,MI,49283-9984,Private      ,277,794,1071,1815,2010,3825
00232200,FINLANDIA UNIVERSITY                    ,MI,49930-1882,Private      ,136,52,188,710,197,907
00232300,UNIVERSITY OF DETROIT MERCY             ,MI,48221-3038,Private      ,409,929,1338,3377,2660,6037
00232303,UNIV OF DETROIT MERCY - LAW SCHOOL      ,MI,48226-0000,Private      ,10,144,154,46,484,530
00232330,UNIV OF DETROIT MERCY - DENTAL SCHOOL   ,MI,48208-2576,Private      ,32,222,254,169,564,733
00232500,UNIVERSITY OF MICHIGAN - ANN ARBOR      ,MI,48109-1316,Public       ,3388,2282,5670,35987,10296,46283
00232501,UNIVERSITY OF MICHIGAN-MEDICAL SCH      ,MI,48109-0000,Public       ,42,135,177,280,951,1231
00232503,UNIVERSITY OF MICHIGAN LAW SCHOOL       ,MI,48109-0000,Public       ,10,277,287,72,1942,2014
00232600,UNIVERSITY OF MICHIGAN-DEARBORN         ,MI,48128-2406,Public       ,1108,1330,2438,6862,4226,11088
00232700,UNIVERSITY OF MICHIGAN-FLINT            ,MI,48502-1950,Public       ,704,1553,2257,4881,5033,9914
00232800,WASHTENAW COMMUNITY COLLEGE             ,MI,48106-0000,Public       ,1055,1854,2909,3812,4517,8329
00232900,WAYNE STATE UNIVERSITY                  ,MI,48202-0000,Public       ,3076,4930,8006,16919,15239,32158
00232901,WAYNE STATE UNIV SCH OF MEDICINE        ,MI,48201-3359,Public       ,141,432,573,638,1765,2403
00232902,WAYNE STATE UNIVERSITY - LAW SCHOOL     ,MI,48202-3424,Public       ,43,214,257,149,780,929
00233000,WESTERN MICHIGAN UNIVERSITY             ,MI,49008-3899,Public       ,2651,2466,5117,20084,7920,28004
00233100,WESTERN THEOLOGICAL SEMINARY            ,MI,49423-0000,Private      ,0,59,59,3,137,140
00384256,CONCORDIA UNIVERSITY - WISCONSIN - ANN A,MI,48105-2750,Private      ,137,96,233,964,269,1233
00407100,WALSH COLLEGE OF ACCT & BUS ADMN        ,MI,48007-7006,Private      ,73,502,575,295,1312,1607
00407200,NORTHWOOD UNIVERSITY                    ,MI,48640-2398,Private      ,367,599,966,2101,1419,3520
00467300,BAKER COLLEGE - FLINT                   ,MI,48507-5508,Private      ,510,1451,1961,1827,3757,5584
00467301,BAKER COLLEGE OF CADILLAC               ,MI,49601-0000,Private      ,120,352,472,486,923,1409
00467302,BAKER COLLEGE OF CLINTON TOWNSHIP       ,MI,48035-0000,Private      ,314,909,1223,1005,2361,3366
00467303,BAKER COLLEGE OF MUSKEGON               ,MI,49442-0000,Private      ,411,771,1182,1643,1858,3501
00467304,BAKER COLLEGE OF OWOSSO                 ,MI,48867-0000,Private      ,325,460,785,1065,1123,2188
00467305,BAKER COLLEGE OF AUBURN HILLS           ,MI,48326-0000,Private      ,243,781,1024,746,1883,2629
00467306,BAKER COLLEGE OF PORT HURON             ,MI,48060-0000,Private      ,96,191,287,324,428,752
00467309,BAKER COLLEGE OF JACKSON                ,MI,49202-0000,Private      ,160,571,731,635,1375,2010
00467311,BAKER COLLEGE-CASS CITY                 ,MI,48726-0000,Private      ,23,56,79,106,162,268
00467313,BAKER COLLEGE - GRADUATE ON-LINE        ,MI,48507-0000,Private      ,80,1247,1327,284,3388,3672
00467317,BAKER COLLEGE-ALLEN PARK                ,MI,48101-0000,Private      ,294,1013,1307,880,2556,3436
00467330,BAKER COLLEGE - CULINARY INSTITUTE OF MI,MI,49440-1246,Private      ,84,60,144,443,161,604
00467343,BAKER COLLEGE - CULINARY INSTITUTE OF MI,MI,48060-0000,Private      ,44,33,77,172,79,251
00467348,BAKER COLLEGE - AUTO DIESEL INSTITUTE OF,MI,48867-0000,Private      ,87,57,144,340,134,474
00469200,DORSEY SCHOOL OF BUSINESS               ,MI,48195-2334,Proprietary  ,15,86,101,48,164,212
00469201,DORSEY SCHOOL OF BUSINESS               ,MI,48184-0000,Proprietary  ,20,112,132,38,175,213
00469202,DORSEY SCHOOL OF BUSINESS               ,MI,48071-0000,Proprietary  ,63,185,248,92,318,410
00469204,DORSEY SCHOOL OF BUSINESS               ,MI,48066-0000,Proprietary  ,104,277,381,145,425,570
00469205,DORSEY BUSINESS SCHOOL - FARMINGTON HILL,MI,48334-3385,Proprietary  ,12,51,63,29,113,142
00469206,DORSEY BUSINESS SCHOOL - ROSEVILLE CULIN,MI,48066-4555,Proprietary  ,40,123,163,83,211,294
00469207,DORSEY BUSINESS SCHOOL - WATERFORD/PONTI,MI,48341-1037,Proprietary  ,37,143,180,60,223,283
00469208,DORSEY BUSINESS SCHOOL - SAGINAW CAMPUS ,MI,48603-5201,Proprietary  ,34,156,190,61,249,310
00469209,DORSEY SCHOOL OF BUSINESS - LANSING     ,MI,48911-5744,Proprietary  ,22,97,119,44,165,209
00469210,DORSEY SCHOOL OF BUSINESS - DEARBORN    ,MI,48228-3858,Proprietary  ,68,212,280,148,401,549
00676800,MID MICHIGAN COMMUNITY COLLEGE          ,MI,48625-9447,Public       ,546,696,1242,1822,1499,3321
00677100,COLLEGE FOR CREATIVE STUDIES            ,MI,48202-4034,Private      ,301,209,510,1738,643,2381
00694900,KALAMAZOO VALLEY COMMUNITY COLLEGE      ,MI,49003-4070,Public       ,1088,1614,2702,4113,3613,7726
00717100,KIRTLAND COMMUNITY COLLEGE              ,MI,48653-0000,Public       ,179,420,599,637,965,1602
00732991,ITT TECHNICAL INSTITUTE                 ,MI,49519-1851,Proprietary  ,151,854,1005,322,1481,1803
00761700,CARNEGIE INSTITUTE                      ,MI,48083-1159,Proprietary  ,27,141,168,45,244,289
00795000,WEST SHORE COMMUNITY COLLEGE            ,MI,49454-0000,Public       ,127,221,348,494,492,986
00817800,EMPIRE BEAUTY SCHOOL                    ,MI,49525-2440,Proprietary  ,280,605,885,449,964,1413
00890600,MACOMB COMMUNITY COLLEGE                ,MI,48088-3896,Public       ,2860,3862,6722,9488,8837,18325
00894600,PORT HURON COSMETOLOGY COLLEGE          ,MI,48329-1618,Proprietary  ,2,9,11,9,30,39
00923000,WAYNE COUNTY COMMUNITY CLG-DISTRICT     ,MI,48226-3010,Public       ,1607,5112,6719,5202,12688,17890
00982800,EVEREST INSTITUTE                       ,MI,48033-4400,Proprietary  ,50,324,374,105,597,702
00982801,EVEREST INSTITUTE- DEARBORN             ,MI,48124-1927,Proprietary  ,49,232,281,114,416,530
00982803,EVEREST INSTITUTE - DETROIT             ,MI,48207-4291,Proprietary  ,59,210,269,145,451,596
01047000,KALAMAZOO BEAUTY ACADEMY                ,MI,49002-5220,Proprietary  ,9,20,29,18,36,54
01082700,DAVID PRESSLEY PROF SCH OF COSMTLGY     ,MI,48067-3219,Proprietary  ,44,85,129,89,187,276
01109800,FLINT INSTITUTE OF BARBERING            ,MI,48504-4395,Proprietary  ,13,51,64,28,100,128
01229100,WRIGHT BEAUTY ACADEMY                   ,MI,49015-2696,Proprietary  ,9,26,35,20,60,80
01262700,THOMAS M. COOLEY LAW SCHOOL             ,MI,48901-1586,Private      ,4,401,405,18,1223,1241
01321800,M J MURPHY BTY CLG MT PLEASANT          ,MI,48858-2502,Proprietary  ,17,15,32,33,40,73
02060300,MICHIGAN INSTITUTE OF AERONAUTICS       ,MI,48188-2533,Proprietary  ,115,179,294,292,288,580
02099700,ROSS MEDICAL EDUCATION CENTER           ,MI,48532-0000,Proprietary  ,138,365,503,231,680,911
02099701,ROSS MEDICAL EDUCATION CENTER-SAGINAW   ,MI,48603-5227,Proprietary  ,15,49,64,40,109,149
02099702,ROSS MEDICAL EDUCATION CENTER-PORT HURON,MI,48060-1958,Proprietary  ,7,11,18,30,31,61
02099703,ROSS MEDICAL EDUCATION CENTER-ROOSEVELT ,MI,49441-4156,Proprietary  ,1,10,11,6,26,32
02100400,EVEREST INSTITUTE                       ,MI,49525-2301,Proprietary  ,7,50,57,40,129,169
02100401,EVEREST INSTITUTE - KALAMAZOO           ,MI,49009-3307,Proprietary  ,4,22,26,25,82,107
02125600,MICHIGAN COLLEGE OF BEAUTY              ,MI,48083-0000,Proprietary  ,41,94,135,95,165,260
02158600,MR BELA'S SCHOOL OF COSMETOLOGY         ,MI,48092-4637,Proprietary  ,5,35,40,19,68,87
02160303,INTERNATIONAL ACADEMY OF DESIGN AND TECH,MI,48083-2160,Proprietary  ,18,46,64,68,129,197
02180100,ROSS MEDICAL EDUCATION CENTER           ,MI,48092-0000,Proprietary  ,68,224,292,143,434,577
02180105,ROSS MEDICAL EDUCATION CENTER-REDFORD   ,MI,48239-1260,Proprietary  ,5,27,32,13,63,76
02198900,MICHIGAN SCHOOL OF PROFESSIONAL PSYCHOLO,MI,48334-4512,Private      ,5,67,72,15,155,170
02209200,TAYLORTOWN SCHOOL OF BEAUTY             ,MI,48180-0000,Proprietary  ,33,81,114,61,138,199
02237800,SPECS HOWARD SCHOOL OF MEDIA ARTS       ,MI,48075-0000,Proprietary  ,193,234,427,411,472,883
02285700,BAYSHIRE BEAUTY ACADEMY                 ,MI,48708-5614,Proprietary  ,20,33,53,37,69,106
02324500,MICHIGAN COLLEGE OF BEAUTY              ,MI,48161-3901,Proprietary  ,20,43,63,50,82,132
02339700,ROSS MEDICAL EDUCATION CENTER           ,MI,48116-0000,Proprietary  ,84,267,351,144,610,754
02339701,ROSS MEDICAL EDUCATION CENTER-ANN ARBOR ,MI,48108-1411,Proprietary  ,10,34,44,30,70,100
02339703,ROSS MEDICAL EDUCATION CENTER - DAVISON ,MI,48423-1751,Proprietary  ,7,12,19,19,39,58
02361500,MICHIGAN BARBER COLLEGE                 ,MI,48204-2244,Private      ,21,125,146,65,254,319
02363800,YESHIVA GEDOLAH OF GREATER DETROIT      ,MI,48237-0000,Private      ,0,2,2,4,2,6
02491000,WEST MI COLG OF BARBERING & BEAUTY      ,MI,49008-0000,Proprietary  ,12,35,47,26,70,96
02531806,PAUL MITCHELL THE SCHOOL -MICHIGAN      ,MI,48313-0000,Proprietary  ,64,98,162,151,189,340
02533600,ROSS MEDICAL EDUCATION CENTER           ,MI,48917-2108,Proprietary  ,82,269,351,138,446,584
02533601,ROSS MEDICAL EDUCATION CENTER - GRAND RA,MI,49546-2430,Proprietary  ,9,55,64,58,134,192
02588200,DOUGLAS J AVEDA INSTITUTE               ,MI,48823-4351,Proprietary  ,200,218,418,515,447,962
02588201,DOUGLAS J AVEDA INSTITUTE - ANN ARBOR   ,MI,48104-2211,Proprietary  ,39,34,73,105,105,210
02595700,HILLSDALE BEAUTY COLLEGE                ,MI,49242-0000,Proprietary  ,8,10,18,48,27,75
02618400,MICHIGAN CAREER & TECHNICAL INST        ,MI,49080-9254,Public       ,59,23,82,212,72,284
03005700,DETROIT BUSINESS INST. DOWNRIVER        ,MI,48193-6761,Proprietary  ,10,68,78,21,116,137
03066600,BAY MILLS COMMUNITY COLLEGE             ,MI,49715-9750,Public       ,33,92,125,155,256,411
03075200,TWIN CITY BEAUTY COLLEGE                ,MI,49085-3305,Proprietary  ,27,46,73,62,85,147
03075201,TWIN CITY BEAUTY COLLEGE - TRAVERSE CITY,MI,49686-5119,Proprietary  ,7,10,17,20,32,52
03090000,SHARP'S ACADEMY OF HAIRSTYLING          ,MI,48439-1838,Proprietary  ,14,20,34,24,31,55
03109700,HOUGHTON LAKE INST OF COSMETOLOGY       ,MI,48629-0669,Proprietary  ,6,17,23,15,36,51
03110300,THE SCHOOL OF CREATIVE HAIR DESIGN      ,MI,49036-1139,Proprietary  ,6,19,25,14,32,46
03124000,NORTHWESTERN TECHNOLOGICAL INST         ,MI,48075-2412,Proprietary  ,27,120,147,50,198,248
03284300,MICHIGAN JEWISH INSTITUTE               ,MI,48237-0000,Private      ,406,508,914,488,542,1030
03490300,PAUL MITCHELL THE SCHOOL ESCANABA       ,MI,49829-0000,Proprietary  ,8,13,21,38,31,69
03588300,IRENE'S MYOMASSOLOGY INSTITUTE          ,MI,48033-2404,Proprietary  ,19,71,90,42,155,197
03704300,BLUE WATER COLLEGE OF COSMETOLOGY       ,MI,48040-2093,Proprietary  ,1,6,7,10,11,21
03772300,SAGINAW CHIPPEWA TRIBAL COLLEGE         ,MI,48858-0000,Public       ,7,18,25,25,42,67
03815300,IN SESSION-ARTS OF COSMETOLOGY BEAU     ,MI,48609-0000,Proprietary  ,12,50,62,29,82,111
03907300,PAUL MITCHELL THE SCHOOL GREAT LAKES    ,MI,48060-0000,Proprietary  ,21,18,39,55,41,96
03915300,CAREER QUEST LEARNING CENTER            ,MI,48910-4732,Proprietary  ,35,269,304,73,399,472
03915301,CAREER QUEST LEARNING CENTER - JACKSON  ,MI,49201-2475,Proprietary  ,29,162,191,51,256,307
03915302,CAREER QUEST LEARNING CENTER - KALAMAZOO,MI,49002-1711,Proprietary  ,0,0,0,6,26,32
03968300,LAKEWOOD SCHOOL OF THERAPEUTIC MASSAGE  ,MI,48060-0000,Proprietary  ,4,24,28,10,39,49
03976500,ANN ARBOR INSTITUTE OF MASSAGE THERAPY  ,MI,48103-0000,Proprietary  ,12,28,40,33,60,93
04002400,ECUMENICAL THEOLOGICAL SEMINARY         ,MI,48201-3035,Private      ,2,33,35,6,70,76
04006300,NUVO COLLEGE OF COSMETOLOGY             ,MI,49441-3822,Proprietary  ,12,17,29,23,50,73
04014300,P&A SCHOLARS BEAUTY SCHOOL              ,MI,48204-0000,Proprietary  ,43,157,200,114,345,459
04094300,ROBERT B. MILLER COLLEGE (THE)          ,MI,49017-3306,Private      ,23,120,143,89,281,370
04121100,GALLERY COLLEGE OF BEAUTY (THE)         ,MI,48036-3591,Proprietary  ,7,32,39,21,79,100
04136300,FOCUS:  HOPE INFORMATION TECHNOLOGIES CE,MI,48238-2949,Private      ,29,100,129,90,257,347
04138400,SCHOOL OF DESIGNING ARTS                ,MI,49015-2853,Proprietary  ,20,30,50,46,66,112
04140900,INTERNATIONAL COSMETOLOGY ACADEMY       ,MI,49508-1308,Proprietary  ,9,28,37,35,57,92
04141100,FRENCH ACADEMY OF COSMETOLOGY           ,MI,49456-3207,Proprietary  ,8,19,27,18,33,51
04158400,L'ESPRIT ACADEMY                        ,MI,48150-0000,Proprietary  ,26,34,60,58,73,131
04159300,MARKETTI ACADEMY OF COSMETOLOGY         ,MI,48329-3506,Proprietary  ,14,22,36,35,47,82
04163300,COMPASS COLLEGE OF CINEMATIC ARTS       ,MI,49503-4227,Private      ,27,20,47,155,57,212
04164700,KEWEENAW BAY OJIBWA COMMUNITY COLLEGE   ,MI,49908-0000,Public       ,4,17,21,11,30,41
04183300,ABCOTT INSTITUTE                        ,MI,48075-5227,Proprietary  ,6,36,42,22,73,95
04184700,PROTEGE ACADEMY                         ,MI,48823-8660,Proprietary  ,22,51,73,43,93,136
04207000,SCHOOL OF MISSIONARY AVIATION TECHNOLOGY,MI,48846-7412,Private      ,1,11,12,16,26,42
04211200,BRIGHTON INSTITUTE OF COSMETOLOGY       ,MI,48116-8360,Proprietary  ,8,10,18,19,23,42
04222300,MANTHANO CHRISTIAN COLLEGE              ,MI,48185-1919,Private      ,0,14,14,5,30,35
04230200,EXCEL ACADEMIES OF COSMETOLOGY          ,MI,48085-1300,Proprietary  ,9,10,19,29,29,58
04230400,EXCEL ACADEMIES OF COSMETOLOGY          ,MI,48912-4686,Proprietary  ,10,30,40,31,46,77
04230500,EXCEL ACADEMIES OF COSMETOLOGY          ,MI,49512-1781,Proprietary  ,5,10,15,36,18,54
04231800,PRINCESS BEAUTY SCHOOL                  ,MI,48127-2999,Proprietary  ,13,30,43,48,67,115
00233200,ANOKA-RAMSEY CC-CAMBRIDGE/COONRAPID     ,MN,55433-3499,Public       ,1297,1337,2634,2239,2294,4533
00233400,AUGSBURG COLLEGE                        ,MN,55454-1351,Private      ,1090,1051,2141,2912,1714,4626
00233500,RIVERLAND COMMUNITY COLLEGE             ,MN,55912-1473,Public       ,306,457,763,572,752,1324
00233600,BEMIDJI STATE UNIVERSITY                ,MN,56601-2699,Public       ,872,656,1528,3208,1485,4693
00233700,BETHANY LUTHERAN COLLEGE INC            ,MN,56001-6163,Private      ,199,23,222,541,49,590
00233900,CENTRAL LAKES COLG-BRAINERD/STAPLES     ,MN,56401-3900,Public       ,419,551,970,747,864,1611
00234000,CARLETON COLLEGE                        ,MN,55057-4001,Private      ,146,14,160,3366,73,3439
00234100,COLLEGE OF ST BENEDICT                  ,MN,56374-2099,Private      ,544,31,575,2003,53,2056
00234200,ST. CATHERINE UNIVERSITY                ,MN,55105-1789,Private      ,876,1242,2118,2521,2335,4856
00234300,COLLEGE OF ST SCHOLASTICA               ,MN,55811-4199,Private      ,629,864,1493,2137,1576,3713
00234500,UNIVERSITY OF ST THOMAS                 ,MN,55105-1096,Private      ,1107,1181,2288,6139,2189,8328
00234600,CONCORDIA COLLEGE-MOORHEAD              ,MN,56562-0001,Private      ,651,65,716,2281,145,2426
00234700,"CONCORDIA UNIVERSITY, ST PAUL, MN       ",MN,55104-5494,Private      ,559,1338,1897,1510,2175,3685
00235000,VERMILION COMMUNITY COLLEGE             ,MN,55731-1996,Public       ,153,47,200,349,96,445
00235300,GUSTAVUS ADOLPHUS COLLEGE               ,MN,56082-1498,Private      ,619,18,637,2938,75,3013
00235400,HAMLINE UNIVERSITY                      ,MN,55104-1284,Private      ,817,732,1549,3216,1429,4645
00235500,HIBBING COMMUNITY COLLEGE               ,MN,55746-3300,Public       ,177,265,442,310,476,786
00235600,ITASCA COMMUNITY COLLEGE                ,MN,55744-3397,Public       ,252,160,412,536,306,842
00235700,LUTHER SEMINARY                         ,MN,55108-0000,Private      ,1,104,105,4,253,257
00235800,MACALESTER COLLEGE                      ,MN,55105-1899,Private      ,626,40,666,3495,119,3614
00236000,"MINNESOTA STATE UNIVERSITY, MANKATO     ",MN,56002-0000,Public       ,3001,1265,4266,10035,2845,12880
00236100,MARTIN LUTHER COLLEGE                   ,MN,56073-3965,Private      ,297,26,323,663,41,704
00236200,MINNEAPOLIS COMM AND TECH COLLEGE       ,MN,55403-1779,Public       ,1395,2879,4274,2494,4802,7296
00236500,MINNEAPOLIS COLLEGE OF ART & DESIGN     ,MN,55404-4343,Private      ,194,159,353,879,414,1293
00236600,CROSSROADS COLLEGE                      ,MN,55902-2382,Private      ,22,27,49,55,41,96
00236700,MINNESOTA STATE UNIVERSITY MOORHEAD     ,MN,56563-0001,Public       ,1222,730,1952,3431,1473,4904
00236900,NORTH CENTRAL UNIVERSITY                ,MN,55404-1391,Private      ,408,144,552,998,306,1304
00237000,NORTH HENNEPIN COMMUNITY COLLEGE        ,MN,55445-2299,Public       ,1011,1873,2884,1844,3055,4899
00237100,UNIVERSITY OF NORTHWESTERN- ST PAUL     ,MN,55113-1598,Private      ,684,245,929,1902,445,2347
00237300,ROCHESTER COMMUNITY/TECH COLLEGE        ,MN,55904-4999,Public       ,934,1155,2089,1690,1872,3562
00237500,SOUTHWEST MINNESOTA STATE UNIVERSITY    ,MN,56258-1598,Public       ,483,380,863,1772,658,2430
00237700,ST CLOUD STATE UNIVERSITY               ,MN,56301-4498,Public       ,2863,1619,4482,7568,3048,10616
00237900,SAINT JOHNS UNIVERSITY                  ,MN,56321-2000,Private      ,477,24,501,1718,66,1784
00238000,SAINT MARY'S UNIVERSITY                 ,MN,55987-1399,Private      ,225,1205,1430,1541,2048,3589
00238200,ST OLAF COLLEGE                         ,MN,55057-1098,Private      ,784,19,803,3956,120,4076
00238300,CROWN COLLEGE                           ,MN,55375-9001,Private      ,222,164,386,685,341,1026
00238500,NORTHLAND COMMUNITY & TECHNICAL CLG     ,MN,56701-2598,Public       ,465,499,964,796,832,1628
00238600,UNITED THEOLGCL SEMINRY TWIN CITIES     ,MN,55112-0000,Private      ,0,30,30,2,50,52
00238800,"UNIVERSITY OF MINNESOTA, DULUTH         ",MN,55812-2496,Public       ,2823,716,3539,8263,1507,9770
00238900,"UNIVERSITY OF MINNESOTA, MORRIS         ",MN,56267-2113,Public       ,571,90,661,2050,212,2262
00239100,WILLIAM MITCHELL COLLEGE OF LAW         ,MN,55105-0000,Private      ,1,403,404,3,777,780
00239300,MINNESOTA STATE COLLEGE-SE TECH         ,MN,55987-0409,Public       ,245,424,669,446,675,1121
00239400,WINONA STATE UNIVERSITY                 ,MN,55987-5838,Public       ,2129,605,2734,6015,1084,7099
00396900,UNIVERSITY OF MINNESOTA-TWIN CITIES     ,MN,55455-0422,Public       ,6848,4650,11498,30826,11567,42393
00400900,MESABI RANGE CMNTY & TECH COLLEGE       ,MN,55792-0000,Public       ,156,169,325,280,274,554
00405708,NATIONAL AMERICAN UNIVERSITY            ,MN,55113-0000,Proprietary  ,9,139,148,15,206,221
00405715,NATIONAL AMERICAN UNIVERSITY - BLOOMINGT,MN,55425-5550,Proprietary  ,10,155,165,17,272,289
00406900,UNIVERSITY OF MINNESOTA-CROOKSTON       ,MN,56716-5001,Public       ,274,302,576,857,629,1486
00438600,VETERAN'S MEDICAL CTR- SCH RAD TECH     ,MN,55417-2399,Public       ,3,5,8,6,13,19
00464100,DUNWOODY COLLEGE OF TECHNOLOGY          ,MN,55403-1192,Private      ,273,464,737,518,714,1232
00464200,GLOBE UNIVERSITY                        ,MN,55125-5408,Proprietary  ,370,962,1332,571,1542,2113
00464500,MINNEAPOLIS BUSINESS COLLEGE            ,MN,55113-4036,Proprietary  ,88,49,137,184,123,307
00464600,MINNESOTA SCHOOL OF BUSINESS            ,MN,55423-0000,Proprietary  ,288,854,1142,416,1237,1653
00525200,RIDGEWATER COLLEGE                      ,MN,56201-2098,Public       ,746,651,1397,1309,1003,2312
00526300,MINNESOTA WEST CMNTY & TECH COLG        ,MN,56241-1096,Public       ,284,434,718,517,683,1200
00553300,"SAINT PAUL COLLEGE, COMMUNITY/TECHNICAL ",MN,55102-1800,Public       ,1339,2295,3634,2421,3740,6161
00553400,SAINT CLOUD TECHNICAL COLLEGE AND COMMUN,MN,56303-1240,Public       ,1046,917,1963,1826,1477,3303
00553500,PINE TECHNICAL COLLEGE                  ,MN,55063-2198,Public       ,79,210,289,149,343,492
00553700,SOUTH CENTRAL COLLEGE                   ,MN,56003-0000,Public       ,573,617,1190,1024,1039,2063
00554100,MINNESOTA STATE COMMUNITY AND TECHNICAL ,MN,56573-1405,Public       ,811,1094,1905,1312,1717,3029
00554400,ALEXANDRIA TECHNICAL COLLEGE            ,MN,56308-3799,Public       ,471,291,762,874,490,1364
00575700,LAKE SUPERIOR COLLEGE                   ,MN,55811-3399,Public       ,621,872,1493,1123,1393,2516
00575900,NORTHWEST TECHNICAL COLLEGE - BEMIDJI   ,MN,56601-4907,Public       ,114,241,355,227,462,689
00677500,RAINY RIVER COMMUNITY COLLEGE           ,MN,56649-2187,Public       ,49,46,95,94,71,165
00735000,ANOKA-HENNEPIN TECHNICAL COLLEGE        ,MN,55303-1590,Public       ,336,717,1053,586,1184,1770
00735100,BROWN COLLEGE                           ,MN,55120-1004,Proprietary  ,25,177,202,53,279,332
00795400,NORMANDALE COMMUNITY COLLEGE            ,MN,55431-4399,Public       ,1489,1627,3116,3110,3027,6137
00869400,RASMUSSEN COLLEGE - ST. CLOUD           ,MN,56301-3713,Proprietary  ,104,544,648,157,867,1024
00869401,RASMUSSEN COLLEGE - BROOKLYN PARK       ,MN,55445-1512,Proprietary  ,58,429,487,86,684,770
00869406,RASMUSSEN COLLEGE - EAGAN               ,MN,55122-1346,Proprietary  ,53,367,420,90,634,724
00869407,RASMUSSEN COLLEGE - BLOOMINGTON         ,MN,55435-5444,Proprietary  ,84,575,659,135,997,1132
00869409,RASMUSSEN COLLEGE - MANKATO             ,MN,56001-8658,Proprietary  ,97,326,423,160,583,743
00869412,RASMUSSEN COLLEGE - LAKE ELMO           ,MN,55042-8624,Proprietary  ,58,306,364,85,480,565
00869416,RASMUSSEN COLLEGE - MOORHEAD            ,MN,56560-4513,Proprietary  ,66,234,300,112,392,504
00869417,RASMUSSEN COLLEGE - BLAINE              ,MN,55014-0000,Proprietary  ,68,495,563,104,775,879
00905800,BETHEL UNIVERSITY                       ,MN,55112-6999,Private      ,937,680,1617,2635,1210,3845
00960000,COSMETOLOGY CAREERS UNLTD-DULUTH        ,MN,55802-2031,Proprietary  ,2,16,18,9,26,35
00974000,INVER HILLS COMMUNITY COLLEGE           ,MN,55076-3224,Public       ,749,1039,1788,1487,2017,3504
00983100,MODEL COLLEGE OF HAIR DESIGN            ,MN,56301-4280,Proprietary  ,27,28,55,45,44,89
00989200,"DULUTH BUSINESS UNIV, INC.              ",MN,55807-0000,Proprietary  ,25,80,105,50,164,214
00999200,OAK HILLS CHRISTIAN COLLEGE             ,MN,56601-0000,Private      ,35,18,53,103,51,154
01024800,ART INSTITUTES INTL MINNESOTA           ,MN,55402-3137,Proprietary  ,256,252,508,547,459,1006
01037400,METROPOLITAN STATE UNIVERSITY           ,MN,55106-5000,Public       ,861,3342,4203,1767,5637,7404
01040200,DAKOTA COUNTY TECHNICAL COLLEGE         ,MN,55068-2999,Public       ,348,578,926,691,975,1666
01049000,REGENCY BEAUTY INSTITUTE                ,MN,55428-0000,Proprietary  ,1141,2081,3222,1758,3164,4922
01049100,HENNEPIN TECHNICAL COLLEGE              ,MN,55445-2399,Public       ,615,1836,2451,1066,2910,3976
01054600,CENTURY COLLEGE                         ,MN,55110-1894,Public       ,1675,2530,4205,2957,3956,6913
01173200,"MAYO CLINIC, COLLEGE OF MEDICINE        ",MN,55905-0000,Private      ,25,120,145,52,377,429
01173201,MAYO SCHOOL OF HEALTH-RELATED SCIEN     ,MN,55905-0000,Private      ,28,73,101,68,166,234
01173206,MAYO GRAD SCHOOL                        ,MN,55901-0000,Private      ,2,15,17,3,35,38
01173207,MAYO MEDICAL SCHOOL                     ,MN,55901-0000,Private      ,5,37,42,18,147,165
01232800,NORTHWESTERN HEALTH SCIENCES UNIV       ,MN,55431-1599,Private      ,26,237,263,55,421,476
02050300,ACADEMY COLLEGE                         ,MN,55420-1554,Proprietary  ,16,70,86,32,93,125
02097300,HASTINGS BEAUTY SCHOOL                  ,MN,55033-1205,Proprietary  ,4,20,24,7,28,35
02123200,AVEDA INSTITUTE                         ,MN,55414-0000,Proprietary  ,136,146,282,269,282,551
02159800,COSMETOLOGY CAREERS UNLTD - HIBBING     ,MN,55746-0000,Proprietary  ,4,6,10,5,14,19
02160901,PCI ACADEMY - PCI ACADEMY               ,MN,55446-4928,Proprietary  ,10,27,37,25,58,83
02238100,MINNESOTA SCHOOL OF COSMETOLOGY         ,MN,55125-0000,Proprietary  ,56,98,154,88,168,256
02260500,SUMMIT ACAD OPPORTUNITIES IND CTR       ,MN,55405-0000,Private      ,21,170,191,32,249,281
02504200,WALDEN UNIVERSITY                       ,MN,55401-2511,Proprietary  ,94,17334,17428,188,34590,34778
02514100,AMERICAN INDIAN OPPORTUNITIES CTR       ,MN,55404-0000,Private      ,5,33,38,10,55,65
03001200,MCNALLY SMITH COLLEGE OF MUSIC          ,MN,55101-2220,Proprietary  ,143,85,228,405,162,567
03051900,ALFRED ADLER GRADUATE SCHOOL            ,MN,55305-0000,Private      ,0,155,155,1,225,226
03096400,LEECH LAKE TRIBAL COLLEGE               ,MN,56633-0000,Public       ,14,98,112,19,151,170
03129100,FOND DU LAC TRIBAL & COMMUNITY CLG      ,MN,55720-2984,Public       ,146,249,395,259,385,644
03267300,CAPELLA UNIVERSITY                      ,MN,55402-3389,Proprietary  ,123,22261,22384,266,38937,39203
03833300,AMERICAN ACADEMY OF ACUPUNCTURE AND ORIE,MN,55113-0000,Proprietary  ,1,10,11,2,24,26
03921400,WHITE EARTH TRIBAL AND COMMUNITY COLLEGE,MN,56557-0478,Private      ,3,12,15,6,35,41
04044300,HAZELDEN GRADUATE SCHOOL OF ADDICTION ST,MN,55012-0000,Private      ,0,66,66,1,125,126
04130200,INST. OF PRODUCTION AND RECORDING       ,MN,55401-1315,Proprietary  ,106,98,204,198,157,355
04148800,CENTERPOINT MASSAGE & SHIATSU THERAPY SC,MN,55414-4525,Proprietary  ,5,26,31,10,51,61
04157600,NOVA ACADEMY OF COSMETOLOGY             ,MN,55906-4103,Proprietary  ,13,20,33,15,28,43
04160500,AVALON SCHOOL OF COSMETOLOGY            ,MN,56187-1930,Proprietary  ,6,18,24,15,28,43
04174400,ROCHESTER SCHOOL OF HAIR DESIGN         ,MN,55901-4310,Proprietary  ,6,8,14,12,18,30
04175600,PARK AVENUE SCHOOL OF COSMETOLOGY       ,MN,56470-3361,Proprietary  ,12,22,34,15,38,53
04227800,BETHANY GLOBAL UNIVERSITY               ,MN,55438-2849,Private      ,64,32,96,125,40,165
00239600,ALCORN STATE UNIVERSITY                 ,MS,39096-7500,Public       ,1343,1177,2520,3639,2233,5872
00239700,BELHAVEN UNIVERSITY                     ,MS,39202-1789,Private      ,601,1916,2517,1811,3578,5389
00239800,BLUE MOUNTAIN COLLEGE                   ,MS,38610-9370,Private      ,185,100,285,443,203,646
00240100,COAHOMA COMMUNITY COLLEGE               ,MS,38614-9799,Public       ,594,465,1059,1170,877,2047
00240200,COPIAH-LINCOLN COMMUNITY COLLEGE        ,MS,39191-0649,Public       ,753,636,1389,1504,1114,2618
00240300,DELTA STATE UNIVERSITY                  ,MS,38733-0000,Public       ,1145,1023,2168,2912,1829,4741
00240400,EAST CENTRAL COMMUNITY COLLEGE          ,MS,39327-0129,Public       ,585,530,1115,1515,956,2471
00240500,EAST MISSISSIPPI COMM COLLEGE           ,MS,39358-0000,Public       ,1156,830,1986,2321,1473,3794
00240700,HINDS COMMUNITY COLLEGE                 ,MS,39154-9799,Public       ,2635,3168,5803,5356,5468,10824
00240800,HOLMES COMMUNITY COLLEGE                ,MS,39079-0000,Public       ,1367,1733,3100,2799,3159,5958
00240900,ITAWAMBA COMMUNITY COLLEGE              ,MS,38843-1099,Public       ,1373,966,2339,2837,1669,4506
00241000,JACKSON STATE UNIVERSITY                ,MS,39217-0001,Public       ,2689,3477,6166,8142,6421,14563
00241100,JONES COUNTY JUNIOR COLLEGE             ,MS,39437-3999,Public       ,1329,842,2171,3007,1578,4585
00241300,MERIDIAN COMMUNITY COLLEGE              ,MS,39307-5890,Public       ,743,845,1588,1480,1438,2918
00241400,MILLSAPS COLLEGE                        ,MS,39201-0000,Private      ,286,229,515,1493,459,1952
00241500,MISSISSIPPI COLLEGE                     ,MS,39058-0001,Private      ,938,1367,2305,2635,2343,4978
00241501,MISSISSIPPI COLLEGE - SCHOOL OF LAW     ,MS,39201-1391,Private      ,27,320,347,74,549,623
00241600,MISSISSIPPI DELTA CMTY COLLEGE          ,MS,38761-0000,Public       ,738,555,1293,1476,1040,2516
00241700,MISSISSIPPI GULF CST CLG                ,MS,39573-0000,Public       ,1992,2425,4417,3997,4101,8098
00242200,MISSISSIPPI UNIV FOR WOMEN              ,MS,39701-5818,Public       ,616,895,1511,1502,1636,3138
00242300,MISSISSIPPI STATE UNIVERSITY            ,MS,39762-9698,Public       ,4874,2626,7500,16275,5364,21639
00242400,MISSISSIPPI VALLEY STATE UNIVERSITY     ,MS,38941-1400,Public       ,947,845,1792,2543,1648,4191
00242600,NORTHEAST MS CMNTY COLLEGE              ,MS,38829-1731,Public       ,1122,636,1758,2310,1109,3419
00242700,NORTHWEST MISSISSIPPI COMMUNITY CLG     ,MS,38668-1703,Public       ,1854,1592,3446,4522,3163,7685
00243000,PEARL RIVER COMMUNITY COLLEGE           ,MS,39470-2201,Public       ,1132,1079,2211,2470,1882,4352
00243300,RUST COLLEGE                            ,MS,38635-2328,Private      ,368,184,552,1162,477,1639
00243500,SOUTHEASTERN BAPTIST COLLEGE            ,MS,39440-0000,Private      ,9,30,39,14,41,55
00243600,SOUTHWEST MISSISSIPPI CMNTY CLG         ,MS,39666-8099,Public       ,622,524,1146,1102,818,1920
00243900,TOUGALOO COLLEGE                        ,MS,39174-9799,Private      ,413,261,674,1142,525,1667
00244000,UNIVERSITY OF MISSISSIPPI               ,MS,38677-1848,Public       ,3921,2178,6099,15096,4646,19742
00244001,UNIVERSITY OF MISSISSIPPI - MED CTR     ,MS,39216-0000,Public       ,239,1077,1316,655,2142,2797
00244100,UNIVERSITY OF SOUTHERN MISSISSIPPI      ,MS,39406-0001,Public       ,3550,3042,6592,10377,6954,17331
00244700,WILLIAM CAREY UNIVERSITY                ,MS,39401-5499,Private      ,749,1874,2623,1701,3162,4863
00489809,MCCANN SCHOOL OF BUSINESS & TECHNOLOGY -,MS,39503-3167,Proprietary  ,7,46,53,17,114,131
01289101,ANTONELLI COLLEGE - JACKSON             ,MS,39232-9514,Proprietary  ,47,491,538,89,819,908
01289102,ANTONELLI COLLEGE - HATTIESBURG         ,MS,39401-3056,Proprietary  ,54,231,285,98,436,534
02074900,CHRIS' BEAUTY COLLEGE                   ,MS,39501-0000,Proprietary  ,15,44,59,21,81,102
02160500,NORTH MISSISSIPPI MED CTR MED TECH      ,MS,38801-0000,Private      ,10,26,36,24,62,86
02235900,ACADEMY OF HAIR DESIGN #4               ,MS,39208-0000,Proprietary  ,29,51,80,41,82,123
02244300,ACADEMY OF HAIR DESIGN #1               ,MS,39204-5008,Proprietary  ,37,77,114,62,170,232
02244305,ACADEMY OF HAIR DESIGN #1-ACADEMY OF HAI,MS,38901-5108,Proprietary  ,20,45,65,33,70,103
02249900,DELTA BEAUTY COLLEGE                    ,MS,38701-0000,Proprietary  ,11,21,32,21,46,67
02251600,ACADEMY OF HAIR DESIGN #6               ,MS,39401-7581,Proprietary  ,35,89,124,56,150,206
02251700,FOSTER'S COSMETOLOGY COLLEGE            ,MS,38663-0000,Proprietary  ,2,8,10,5,15,20
02302800,MISSISSIPPI COLLEGE OF BEAUTY CULT      ,MS,39440-0000,Proprietary  ,9,26,35,20,54,74
02320800,MAGNOLIA COLLEGE OF COSMETOLOGY         ,MS,39206-0000,Proprietary  ,35,83,118,60,162,222
02502100,CREATIONS COLLEGE OF COSMETOLOGY        ,MS,38803-0000,Proprietary  ,8,29,37,18,53,71
02516200,WESLEY BIBLICAL SEMINARY                ,MS,39206-0000,Private      ,3,39,42,4,73,77
02586000,J & J HAIR DESIGN COLLEGE               ,MS,39051-3716,Proprietary  ,15,39,54,22,57,79
03010603,VIRGINIA COLLEGE - JACKSON              ,MS,39206-5602,Proprietary  ,56,228,284,90,438,528
03010610,VIRGINIA COLLEGE - BILOXI               ,MS,39532-2124,Proprietary  ,37,108,145,68,268,336
03032400,KC'S SCHOOL OF HAIR DESIGN              ,MS,38863-0000,Proprietary  ,11,41,52,18,57,75
03263300,TRAXLER'S SCHOOL OF HAIR                ,MS,39212-2529,Proprietary  ,4,35,39,10,48,58
03294305,BLUE CLIFF COLLEGE - GULFPORT           ,MS,39503-0000,Proprietary  ,28,99,127,54,198,252
03464300,ACADEMY OF HAIR DESIGN                  ,MS,39562-0000,Proprietary  ,7,15,22,12,29,41
03848300,DAY SPA CAREER COLLEGE                  ,MS,39564-0000,Proprietary  ,6,34,40,11,57,68
03963300,HEALING TOUCH CAREER COLLEGE            ,MS,39402-1300,Proprietary  ,13,75,88,27,162,189
04131300,CORINTH ACADEMY OF COSMETOLOGY          ,MS,38834-4813,Proprietary  ,19,58,77,29,88,117
04140200,"MISSISSIPPI INSTITUTE OF AESTHETICS, NAI",MS,39056-5628,Proprietary  ,18,34,52,29,59,88
00252600,CARROLL COLLEGE                         ,MT,59625-0002,Private      ,157,39,196,2325,195,2520
00252700,UNIVERSITY OF GREAT FALLS               ,MT,59405-4996,Private      ,106,136,242,913,368,1281
00252800,MILES COMMUNITY COLLEGE                 ,MT,59301-4799,Public       ,38,37,75,197,135,332
00252900,DAWSON COMMUNITY COLLEGE                ,MT,59330-1405,Public       ,46,27,73,160,70,230
00253000,MONTANA STATE UNIVERSITY - BILLINGS     ,MT,59101-0298,Public       ,402,745,1147,2178,2001,4179
00253100,MONTANA TECH OF THE UNIV OF MONTANA     ,MT,59701-8997,Public       ,213,365,578,1385,954,2339
00253200,MONTANA STATE UNIVERSITY - BOZEMAN      ,MT,59717-4160,Public       ,1314,1014,2328,12028,3412,15440
00253300,MONTANA STATE UNIVERSITY-NORTHERN       ,MT,59501-3148,Public       ,143,229,372,691,522,1213
00253400,ROCKY MOUNTAIN COLLEGE                  ,MT,59102-1796,Private      ,188,148,336,1158,353,1511
00253600,UNIVERSITY OF MONTANA (THE)             ,MT,59812-0001,Public       ,948,1508,2456,7388,5289,12677
00253700,UNIVERSITY OF MONTANA WESTERN (THE)     ,MT,59725-3598,Public       ,191,146,337,1254,409,1663
00677700,FLATHEAD VALLEY COMMUNITY COLLEGE       ,MT,59901-2699,Public       ,151,318,469,701,921,1622
00757000,HELENA COLLEGE OF TECHNOLOGY            ,MT,59601-3098,Public       ,90,208,298,379,591,970
00790000,BUTTE ACADEMY OF BEAUTY CULTURE         ,MT,59701-9197,Proprietary  ,10,21,31,18,30,48
00931400,GREAT FALLS COLLEGE MONTANA STATE UNIVER,MT,59405-4907,Public       ,103,410,513,484,1017,1501
02143400,SALISH KOOTENAI COLLEGE                 ,MT,59855-0000,Public       ,66,192,258,254,484,738
02286600,LITTLE BIG HORN COLLEGE                 ,MT,59022-0000,Public       ,8,11,19,67,55,122
02343000,FT PECK COMMUNITY COLLEGE               ,MT,59255-0000,Public       ,9,17,26,31,66,97
02510600,BLACKFEET COMMUNITY COLLEGE             ,MT,59417-0000,Private      ,14,36,50,92,143,235
02517500,FORT BELKNAP COLLEGE                    ,MT,59526-0000,Public       ,14,29,43,38,63,101
02545200,CHIEF DULL KNIFE COLLEGE                ,MT,59043-0098,Public       ,2,11,13,37,53,90
02610900,STONE CHILD COLLEGE                     ,MT,59521-9796,Public       ,10,21,31,55,66,121
02621300,ACADEMY OF COSMETOLOGY                  ,MT,59715-3544,Proprietary  ,12,16,28,44,34,78
03205300,MODERN BEAUTY SCHOOL                    ,MT,59801-8386,Proprietary  ,6,22,28,33,41,74
03763400,"ACADEMY OF NAIL, SKIN & HAIR            ",MT,59101-0000,Proprietary  ,19,49,68,56,88,144
03778300,HEALTH WORKS INSTITUTE                  ,MT,59715-0000,Proprietary  ,18,31,49,40,76,116
04163700,BITTERROOT SCHOOL OF COSMETOLOGY        ,MT,59840-3118,Proprietary  ,5,13,18,10,24,34
04164100,MONTANA ACADEMY OF SALON                ,MT,59405-0000,Proprietary  ,17,23,40,38,51,89
04187700,CREVIER'S SCHOOL OF COSMETOLOGY         ,MT,59901-4402,Proprietary  ,16,41,57,36,81,117
00253900,CHADRON STATE COLLEGE                   ,NE,69337-2690,Public       ,510,419,929,1590,861,2451
00254000,COLLEGE OF ST MARY                      ,NE,68106-2606,Private      ,147,374,521,521,811,1332
00254100,CONCORDIA UNIVERSITY                    ,NE,68434-1594,Private      ,270,421,691,1346,792,2138
00254200,CREIGHTON UNIVERSITY                    ,NE,68178-0001,Private      ,667,1609,2276,6034,4448,10482
00254400,DOANE COLLEGE                           ,NE,68333-2421,Private      ,341,358,699,1474,727,2201
00254700,GRACE UNIVERSITY                        ,NE,68108-3629,Private      ,130,116,246,322,239,561
00254800,HASTINGS COLLEGE                        ,NE,68901-7621,Private      ,376,85,461,1358,188,1546
00255100,UNIVERSITY OF NEBRASKA AT KEARNEY       ,NE,68849-0001,Public       ,1047,741,1788,3845,1497,5342
00255200,MCCOOK COMMUNITY COLLEGE                ,NE,69001-2631,Public       ,0,0,0,23,17,40
00255300,MIDLAND UNIVERSITY                      ,NE,68025-4254,Private      ,416,128,544,1436,266,1702
00255400,UNIVERSITY OF NEBRASKA-OMAHA            ,NE,68182-0001,Public       ,2187,2057,4244,8467,5202,13669
00255500,NEBRASKA WESLEYAN UNIVERSITY            ,NE,68504-2796,Private      ,448,252,700,1707,595,2302
00255700,MID-PLAINS COMM. COLLEGE-ALL CAMPUSES   ,NE,69101-9420,Public       ,180,236,416,456,456,912
00255900,PERU STATE COLLEGE                      ,NE,68421-0010,Public       ,273,318,591,1015,681,1696
00256000,WESTERN NEBRASKA COMMUNITY COLLEGE      ,NE,69361-1815,Public       ,146,215,361,543,480,1023
00256300,UNION COLLEGE                           ,NE,68506-4387,Private      ,249,113,362,713,296,1009
00256500,UNIVERSITY OF NEBRASKA-LINCOLN          ,NE,68588-0419,Public       ,3610,1510,5120,15082,4009,19091
00256596,UNIVERSITY OF NEBRASKA - CURTIS         ,NE,69025-9522,Public       ,65,18,83,244,35,279
00256600,WAYNE STATE COLLEGE                     ,NE,68787-1172,Public       ,688,285,973,2642,613,3255
00256700,YORK COLLEGE                            ,NE,68467-2699,Private      ,123,30,153,292,66,358
00443600,REGNL WST MEDCL CTR SCHL RAD            ,NE,69361-0000,Private      ,4,3,7,14,10,24
00458608,KAPLAN UNIVERSITY - OMAHA               ,NE,68134-1002,Proprietary  ,40,486,526,102,947,1049
00458609,KAPLAN UNIVERSITY - LINCOLN             ,NE,68508-2668,Proprietary  ,36,383,419,75,743,818
00639900,BRYANLGH COLLEGE OF HEALTH SCIENCES     ,NE,68506-1398,Private      ,139,158,297,363,341,704
00640400,NEBR METHODIST CLG OF NURS ALLD HLTH    ,NE,68114-2852,Private      ,135,351,486,403,724,1127
00689500,UNIVERSITY OF NEBRASKA-MED CTR          ,NE,68198-4265,Public       ,219,915,1134,650,2192,2842
00750100,VATTEROTT COLLEGE                       ,NE,68137-1237,Proprietary  ,6,53,59,20,122,142
00849200,ALEGENT HEALTH SCHOOLS                  ,NE,68114-2767,Private      ,12,66,78,59,156,215
00952300,BAHNER COLLEGE OF HAIRSTYLING           ,NE,68025-3297,Proprietary  ,8,8,16,11,21,32
00961700,CAPITOL BEAUTY SCHOOL                   ,NE,68144-0000,Proprietary  ,53,65,118,101,118,219
00974300,BELLEVUE UNIVERSITY                     ,NE,68005-0000,Private      ,254,2570,2824,566,5117,5683
00986200,CLARKSON COLLEGE                        ,NE,68131-2739,Private      ,138,399,537,458,937,1395
01151900,JOSEPH'S COLLEGE OF BEAUTY/ALL CAMPUSES ,NE,68510-2226,Proprietary  ,80,111,191,141,180,321
01166700,NORTHEAST COMMUNITY COLLEGE             ,NE,68702-0000,Public       ,568,418,986,1602,801,2403
01258600,METROPOLITAN COMMUNITY COLLEGE          ,NE,68103-0000,Public       ,1297,2556,3853,3557,6306,9863
01297600,NEBRASKA CHRISTIAN COLLEGE              ,NE,68046-4256,Private      ,52,25,77,104,41,145
02079700,COLLEGE OF HAIR DESIGN                  ,NE,68508-0000,Proprietary  ,46,89,135,92,132,224
02099500,CENTRAL COMMUNITY COLLEGE-ALL CAMPUSES  ,NE,68801-7299,Public       ,539,701,1240,1438,1358,2796
02508300,SOUTHEAST COMM. COLLEGE-ALL CAMPUSES    ,NE,68520-0000,Public       ,1251,1667,2918,3113,3391,6504
02550800,NEBRASKA INDIAN COMMUNITY COLLEGE       ,NE,68039-0000,Public       ,1,22,23,12,45,57
02610500,XENON INTERNATIONAL ACADEMY II          ,NE,68127-3522,Proprietary  ,82,95,177,154,170,324
03164300,THE CREATIVE CENTER                     ,NE,68164-2911,Proprietary  ,40,26,66,86,56,142
03279300,MYOTHERAPY INSTITUTE                    ,NE,68516-0000,Proprietary  ,12,17,29,21,37,58
03323300,LITTLE PRIEST TRIBAL COLLEGE            ,NE,68071-0000,Private      ,10,16,26,22,40,62
03821400,UNIVERSAL COLLEGE OF HEALING ARTS       ,NE,68112-1810,Proprietary  ,7,30,37,15,73,88
00256800,UNIVERSITY OF NEVADA RENO               ,NV,89557-0002,Public       ,1818,1602,3420,17278,5988,23266
00256900,UNIVERSITY OF NEVADA-LAS VEGAS          ,NV,89154-1001,Public       ,4036,5710,9746,19956,14859,34815
00697700,GREAT BASIN COLLEGE                     ,NV,89801-3348,Public       ,177,407,584,551,790,1341
00732954,ITT TECHNICAL INSTITUTE                 ,NV,89014-6712,Proprietary  ,86,276,362,175,522,697
00736700,MARINELLO SCHOOLS OF BEAUTY             ,NV,89110-3563,Proprietary  ,51,206,257,129,375,504
00736701,MARINELLO SCHOOLS OF BEAUTY -           ,NV,89014-2244,Proprietary  ,23,52,75,52,114,166
00737100,MARINELLO SCHOOL OF BEAUTY              ,NV,89502-6530,Proprietary  ,61,108,169,105,183,288
00919200,SIERRA NEVADA COLLEGE                   ,NV,89451-0000,Private      ,120,224,344,491,494,985
01036200,COLLEGE OF SOUTHERN NEVADA              ,NV,89146-1139,Public       ,4908,9727,14635,13021,19336,32357
01036300,WESTERN NEVADA COLLEGE                  ,NV,89703-0000,Public       ,394,919,1313,876,1755,2631
01246110,LINCOLN TECHNICAL INSTITUTE-EUPH INST OF,NV,89117-8803,Proprietary  ,72,133,205,100,229,329
01246111,LINCOLN TECHNICAL INSTITUTE-EUPH INS OFB,NV,89052-4964,Proprietary  ,25,64,89,36,88,124
01323200,ACADEMY OF HAIR DESIGN                  ,NV,89146-1617,Proprietary  ,50,152,202,131,308,439
02107700,TRUCKEE MEADOWS COMMUNITY CLG           ,NV,89512-0000,Public       ,1124,2085,3209,3582,4575,8157
02237500,EVEREST COLLEGE                         ,NV,89103-0000,Proprietary  ,161,524,685,363,1060,1423
02338512,GLENDALE CAREER COLLEGE - NEVADA CAREER ,NV,89131-3268,Proprietary  ,20,87,107,56,181,237
02616703,SCOTTSDALE CULINARY INSTITUTE - LE CORDO,NV,89144-7047,Proprietary  ,35,77,112,119,233,352
02621500,CAREER COLLEGE OF NORTHERN NEVADA       ,NV,89434-7905,Proprietary  ,83,317,400,160,498,658
03030603,UTAH CLG OF MASSAGE THERAPY-NSMT        ,NV,89123-0000,Proprietary  ,34,109,143,68,220,288
03031405,INTERNATIONAL ACADEMY OF DESIGN AND TECH,NV,89074-7750,Proprietary  ,50,74,124,85,147,232
03043200,KAPLAN COLLEGE                          ,NV,89102-8618,Proprietary  ,228,735,963,492,1430,1922
03787300,EXPERTISE SCHOOL OF BEAUTY              ,NV,89106-2516,Private      ,19,102,121,56,177,233
03838500,NORTHWEST HEALTH CAREERS                ,NV,89128-0255,Proprietary  ,63,211,274,162,456,618
03975300,INSTITUTE OF PROFESSIONAL CAREERS       ,NV,89119-7825,Proprietary  ,27,130,157,79,264,343
04051303,ART INSTITUTE OF PHOENIX (THE) - ART INS,NV,89074-7737,Proprietary  ,90,118,208,318,302,620
04065300,ROSEMAN UNIVERSITY OF HEALTH SCIENCES   ,NV,89014-2333,Private      ,47,656,703,135,1630,1765
04114300,NEVADA STATE COLLEGE                    ,NV,89002-9455,Public       ,595,1442,2037,2102,3223,5325
04142601,TOURO UNIVERSITY - NEVADA               ,NV,89014-8800,Private      ,33,278,311,121,861,982
04144800,INTERNATIONAL ACADEMY OF STYLE          ,NV,89509-3450,Proprietary  ,32,49,81,58,103,161
04147600,AVEDA INSTITUTE LAS VEGAS               ,NV,89119-6103,Proprietary  ,49,120,169,115,248,363
04171000,ADVANCED TRAINING INSTITUTE             ,NV,89115-7504,Proprietary  ,78,327,405,141,489,630
04180500,ADVANCED BEAUTY SCHOOL OF COSMETOLOGY   ,NV,89103-5864,Proprietary  ,22,89,111,56,162,218
04186300,PAUL MITCHELL THE SCHOOL LAS VEGAS      ,NV,89123-8014,Proprietary  ,92,150,242,197,281,478
04190300,AMERICAN INSTITUTE OF MEDICAL SONOGRAPHY,NV,89146-6597,Proprietary  ,9,30,39,92,208,300
04203100,PAUL MITCHELL THE SCHOOL RENO           ,NV,89501-3356,Proprietary  ,44,60,104,88,123,211
04226200,HEALTHCARE PREPARATORY INSTITUTE        ,NV,89130-2580,Proprietary  ,37,135,172,108,285,393
00257200,COLBY-SAWYER COLLEGE                    ,NH,03257-4648,Private      ,122,26,148,2139,102,2241
00257300,DARTMOUTH COLLEGE                       ,NH,03755-3529,Private      ,294,440,734,10966,1594,12560
00257500,FRANKLIN PIERCE UNIVERSITY              ,NH,03461-0060,Private      ,318,413,731,3076,973,4049
00257900,NEW ENGLAND COLLEGE                     ,NH,03242-3293,Private      ,361,830,1191,2333,1474,3807
00258000,SOUTHERN NEW HAMPSHIRE UNIVERSITY       ,NH,03106-1045,Private      ,2223,28830,31053,7920,49310,57230
00258100,NHTI  - CONCORD'S COMMUNITY COLLEGE     ,NH,03301-7412,Public       ,736,701,1437,2082,1371,3453
00258200,MANCHESTER COMMUNITY COLLEGE            ,NH,03102-8518,Public       ,456,674,1130,1048,1274,2322
00258300,GREAT BAY COMMUNITY COLLEGE             ,NH,03801-0000,Public       ,302,466,768,760,910,1670
00258600,RIVIER UNIVERSITY                       ,NH,03060-5086,Private      ,181,334,515,1262,847,2109
00258700,SAINT ANSELM COLLEGE                    ,NH,03102-1310,Private      ,429,43,472,3851,128,3979
00258900,UNIVERSITY OF NEW HAMPSHIRE             ,NH,03824-2511,Public       ,614,566,1180,21267,3382,24649
00258903,UNIVERSITY OF NEW HAMPSHIRE - SCHOOL OF ,NH,03301-4115,Public       ,0,0,0,0,14,14
00259000,KEENE STATE COLLEGE                     ,NH,03431-0000,Public       ,454,121,575,6742,554,7296
00259100,PLYMOUTH STATE UNIVERSITY               ,NH,03264-1595,Public       ,446,377,823,6616,1157,7773
00301004,ANTIOCH UNIVERSITY                      ,NH,03431-0000,Private      ,2,192,194,10,647,657
00472900,MOUNT WASHINGTON COLLEGE                ,NH,03103-7230,Proprietary  ,70,382,452,144,673,817
00472901,HESSER COLLEGE - NASHUA CAMPUS          ,NH,03063-1286,Proprietary  ,0,0,0,0,2,2
00473100,DANIEL WEBSTER COLLEGE                  ,NH,03063-1300,Proprietary  ,202,96,298,736,221,957
00529100,WHITE MOUNTAINS COMMUNITY COLLEGE       ,NH,03570-3799,Public       ,104,166,270,297,324,621
00702500,LEBANON COLLEGE                         ,NH,03766-0000,Private      ,0,0,0,0,1,1
00755500,LAKES REGION COMMUNITY COLLEGE          ,NH,03246-1326,Public       ,172,209,381,483,457,940
00756000,RIVER VALLEY COMMUNITY COLLEGE          ,NH,03743-9707,Public       ,106,229,335,249,546,795
00864500,EMPIRE BEAUTY SCHOOL                    ,NH,03220-0000,Proprietary  ,41,69,110,63,97,160
00923600,NASHUA COMMUNITY COLLEGE                ,NH,03063-2052,Public       ,309,369,678,754,665,1419
01318900,CONTINENTAL ACADEMIE OF HAIR DESIGN     ,NH,03051-3754,Proprietary  ,22,16,38,34,25,59
02140400,ST JOSEPH SCH OF PRAC NRSG              ,NH,03060-0000,Private      ,8,67,75,48,185,233
02174800,MICHAEL'S SCHOOL OF HAIR DESIGN & ESTHET,NH,03110-0000,Proprietary  ,31,31,62,64,56,120
02179600,EMPIRE BEAUTY SCHOOL                    ,NH,03878-0000,Proprietary  ,22,61,83,42,78,120
02211600,PORTSMOUTH BTY SCH OF HAIR DESIGN       ,NH,03801-4084,Proprietary  ,14,8,22,28,16,44
02223300,NORTHEAST CATHOLIC COLLEGE              ,NH,03278-4012,Private      ,30,3,33,77,9,86
02245400,KEENE BEAUTY ACADEMY                    ,NH,03431-0000,Proprietary  ,14,17,31,37,37,74
02247000,NEW ENGLAND SCHOOL OF HAIR DESIGN       ,NH,03784-0000,Proprietary  ,8,12,20,18,24,42
03043100,THOMAS MORE COLLEGE OF LIBERAL ARTS     ,NH,03054-4818,Private      ,35,3,38,91,10,101
03101300,GRANITE STATE COLLEGE                   ,NH,03301-6400,Public       ,143,1017,1160,338,1852,2190
03182300,NEW HAMPSHIRE INSTITUTE OF ART          ,NH,03104-4858,Private      ,135,73,208,557,155,712
03437300,UPPER VALLEY TEACHER TRANING PROGRAM    ,NH,03766-1358,Private      ,0,16,16,0,31,31
03729300,NH INSTITUTE FOR THERAPEUTIC ARTS       ,NH,03051-4906,Proprietary  ,1,9,10,7,23,30
04162200,LAIRD INSTITUTE OF SPA THERAPY          ,NH,03102-5263,Proprietary  ,6,19,25,11,32,43
00267000,SUMMIT UNIVERSITY OF PENNSYLVANIA       ,PA,18411-1297,Private      ,202,157,359,462,306,768
00322800,BRYN ATHYN COLLEGE OF THE NEW CHURCH    ,PA,19009-0717,Private      ,119,14,133,308,41,349
00322900,ALBRIGHT COLLEGE                        ,PA,19612-5234,Private      ,605,383,988,4555,930,5485
00323000,ALLEGHENY COLLEGE                       ,PA,16335-3902,Private      ,623,41,664,3270,118,3388
00323100,COMM CLG OF ALLEGHENY-ALLEGHENY CMP     ,PA,15212-0000,Public       ,1189,2037,3226,2221,3742,5963
00323101,"COMM CLG OF ALLEGHENY, BOYCE CAMPUS     ",PA,15146-0000,Public       ,606,905,1511,1073,1568,2641
00323102,"COMM CLG OF ALLEGHENY, NORTH CAMPUS     ",PA,15237-0000,Public       ,696,778,1474,1357,1439,2796
00323103,"COMM CLG OF ALLEGHENY, SOUTH CAMPUS     ",PA,15122-0000,Public       ,665,783,1448,1242,1368,2610
00323300,ALVERNIA UNIVERSITY                     ,PA,19607-1799,Private      ,647,602,1249,2254,1357,3611
00323500,ARCADIA UNIVERSITY                      ,PA,19038-3295,Private      ,802,462,1264,6113,1513,7626
00323700,BRYN MAWR COLLEGE                       ,PA,19010-2899,Private      ,217,137,354,1866,440,2306
00323800,BUCKNELL UNIVERSITY                     ,PA,17837-2122,Private      ,633,31,664,6308,183,6491
00323900,BUCKS COUNTY COMMUNITY COLLEGE          ,PA,18940-1320,Public       ,1491,1235,2726,3102,2535,5637
00324000,BUTLER COUNTY COMMUNITY COLLEGE         ,PA,16001-0000,Public       ,875,604,1479,1580,1109,2689
00324100,CABRINI COLLEGE                         ,PA,19087-3698,Private      ,473,163,636,2044,457,2501
00324200,CARNEGIE MELLON UNIVERSITY              ,PA,15213-3890,Private      ,947,362,1309,12867,1302,14169
00324201,CARNEGIE MELLON UNIV- THE HEINZ COLLEGE ,PA,15213-0000,Private      ,16,149,165,136,505,641
00324202,CARNEGIE MELLON- TEPPER SCHOOL OF BUSINE,PA,15213-0000,Private      ,16,230,246,235,411,646
00324300,CEDAR CREST COLLEGE                     ,PA,18104-6196,Private      ,300,601,901,1091,1101,2192
00324400,CHATHAM UNIVERSITY                      ,PA,15232-2826,Private      ,171,584,755,1024,1374,2398
00324500,CHESTNUT HILL COLLEGE                   ,PA,19118-2693,Private      ,335,664,999,1507,1578,3085
00324700,MISERICORDIA  UNIVERSITY                ,PA,18612-1008,Private      ,610,561,1171,2384,1144,3528
00324900,COMMUNITY COLLEGE OF PHILADELPHIA       ,PA,19130-3991,Public       ,4204,7216,11420,9758,15304,25062
00325100,CURTIS INSTITUTE OF MUSIC               ,PA,19103-6187,Private      ,28,26,54,265,132,397
00325200,DELAWARE VALLEY COLLEGE                 ,PA,18901-2697,Private      ,675,164,839,2585,371,2956
00325300,DICKINSON COLLEGE                       ,PA,17013-2896,Private      ,432,33,465,3524,167,3691
00325600,DREXEL UNIVERSITY                       ,PA,19104-2875,Private      ,1637,3575,5212,23558,13631,37189
00325800,DUQUESNE UNIVERSITY                     ,PA,15282-0001,Private      ,2216,1484,3700,8046,3205,11251
00325900,EASTERN UNIVERSITY                      ,PA,19087-3696,Private      ,525,921,1446,2116,1818,3934
00326200,ELIZABETHTOWN COLLEGE                   ,PA,17022-2298,Private      ,295,241,536,2757,597,3354
00326300,EVANGELICAL SCHOOL OF THEOLOGY          ,PA,17067-0000,Private      ,1,47,48,1,81,82
00326500,FRANKLIN & MARSHALL COLLEGE             ,PA,17604-0000,Private      ,454,47,501,4010,179,4189
00326600,GANNON UNIVERSITY                       ,PA,16541-0001,Private      ,491,358,849,3553,1124,4677
00326700,GENEVA COLLEGE                          ,PA,15010-3599,Private      ,401,283,684,1732,595,2327
00326800,GETTYSBURG COLLEGE                      ,PA,17325-1486,Private      ,569,37,606,4320,165,4485
00326900,GROVE CITY COLLEGE                      ,PA,16127-2104,Private      ,372,15,387,1684,45,1729
00327000,GWYNEDD-MERCY COLLEGE                   ,PA,19437-0901,Private      ,476,725,1201,1485,1523,3008
00327200,HARCUM COLLEGE                          ,PA,19010-3476,Private      ,314,732,1046,727,1451,2178
00327300,HARRISBURG AREA COMMUNITY COLLEGE       ,PA,17110-2999,Public       ,3864,5175,9039,7440,10386,17826
00327400,HAVERFORD COLLEGE                       ,PA,19041-1392,Private      ,251,20,271,2098,61,2159
00327500,HOLY FAMILY UNIVERSITY                  ,PA,19114-2094,Private      ,406,499,905,1861,1398,3259
00327600,IMMACULATA UNIVERSITY                   ,PA,19345-0647,Private      ,337,469,806,1475,1028,2503
00327700,INDIANA UNIVERSITY OF PENNSYLVANIA      ,PA,15705-1097,Public       ,4075,1307,5382,12945,2840,15785
00327900,JUNIATA COLLEGE                         ,PA,16652-2196,Private      ,170,24,194,2379,110,2489
00328000,KEYSTONE COLLEGE                        ,PA,18440-0200,Private      ,552,260,812,1460,469,1929
00328200,KINGS COLLEGE                           ,PA,18711-0801,Private      ,612,195,807,2956,460,3416
00328300,LACKAWANNA COLLEGE                      ,PA,18509-9961,Private      ,627,413,1040,1314,800,2114
00328400,LAFAYETTE COLLEGE                       ,PA,18042-1768,Private      ,434,35,469,4490,137,4627
00328500,LANCASTER BIBLE COLLEGE                 ,PA,17601-5036,Private      ,331,367,698,843,784,1627
00328600,LANCASTER THEOLOGICAL SEMINARY          ,PA,17603-0000,Private      ,1,57,58,2,99,101
00328700,LASALLE UNIVERSITY                      ,PA,19141-1199,Private      ,1184,1265,2449,5846,3146,8992
00328800,LEBANON VALLEY COLLEGE                  ,PA,17003-1400,Private      ,300,51,351,2834,236,3070
00328900,LEHIGH UNIVERSITY                       ,PA,18015-1588,Private      ,815,234,1049,8826,676,9502
00329000,LINCOLN UNIVERSITY                      ,PA,19352-0999,Public       ,745,326,1071,3305,872,4177
00329100,LUTHERAN THEOLOG SEMINARY-GETTYSBRG     ,PA,17325-0000,Private      ,0,30,30,1,61,62
00329200,LUTHERAN THEOLOGICAL SEMINARY           ,PA,19119-0000,Private      ,0,74,74,0,136,136
00329300,LYCOMING COLLEGE                        ,PA,17701-5192,Private      ,444,41,485,1875,138,2013
00329400,MANOR COLLEGE                           ,PA,19046-3399,Private      ,192,183,375,647,485,1132
00329600,MARYWOOD UNIVERSITY                     ,PA,18509-1598,Private      ,617,490,1107,2591,1164,3755
00329700,MERCYHURST UNIVERSITY                   ,PA,16546-0001,Private      ,618,484,1102,3445,1157,4602
00329800,MESSIAH COLLEGE                         ,PA,17027-0000,Private      ,379,170,549,3212,465,3677
00330000,MOORE COLLEGE OF ART & DESIGN           ,PA,19103-1179,Private      ,108,79,187,639,274,913
00330100,MORAVIAN COLLEGE                        ,PA,18018-6650,Private      ,500,150,650,2599,392,2991
00330101,MORAVIAN THEOLOGICAL SEMINARY           ,PA,18018-0000,Private      ,3,55,58,8,77,85
00330200,MOUNT ALOYSIUS COLLEGE                  ,PA,16630-1999,Private      ,326,285,611,1308,678,1986
00330300,CARLOW UNIVERSITY                       ,PA,15213-3165,Private      ,366,714,1080,1256,1545,2801
00330400,MUHLENBERG COLLEGE                      ,PA,18104-5586,Private      ,461,133,594,3702,302,4004
00330600,VALLEY FORGE CHRISTIAN COLLEGE          ,PA,19460-2399,Private      ,268,128,396,704,270,974
00330900,PEIRCE COLLEGE                          ,PA,19102-4699,Private      ,168,981,1149,360,1841,2201
00331100,SALUS UNIVERSITY                        ,PA,19027-1598,Private      ,4,332,336,24,1212,1236
00331300,WIDENER UNIVERSITY                      ,PA,19013-5792,Private      ,727,919,1646,4708,2279,6987
00331302,WIDENER UNIV SCH OF LAW- HARRISBURG     ,PA,17106-9381,Private      ,8,127,135,22,388,410
00331500,BLOOMSBURG UNIVERSITY OF PA             ,PA,17815-1301,Public       ,3328,741,4069,12172,1845,14017
00331600,CALIFORNIA UNIV OF PENNSYLVANIA         ,PA,15419-1394,Public       ,1939,1740,3679,5394,3486,8880
00331700,CHEYNEY UNIVERSITY OF PENNSYLVANIA      ,PA,19319-0200,Public       ,413,254,667,1311,592,1903
00331800,CLARION UNIVERSITY OF PENNSYLVANIA      ,PA,16214-1232,Public       ,1834,946,2780,4380,1819,6199
00332000,EAST STROUDSBURG UNIVERSITY             ,PA,18301-2999,Public       ,2108,801,2909,7555,1786,9341
00332100,EDINBORO UNIVERSITY OF PENNSYLVANIA     ,PA,16444-0001,Public       ,1003,746,1749,5265,2360,7625
00332200,KUTZTOWN UNIVERSITY OF PENNSYLVANIA     ,PA,19530-9339,Public       ,2457,784,3241,10385,1804,12189
00332300,LOCK HAVEN UNIV OF PENNSYLVANIA         ,PA,17745-2439,Public       ,890,343,1233,4884,1120,6004
00332400,MANSFIELD UNIVERSITY                    ,PA,16933-1123,Public       ,823,226,1049,2492,531,3023
00332500,MILLERSVILLE UNIVERSITY OF PA           ,PA,17551-1800,Public       ,1992,898,2890,7977,2085,10062
00332600,SHIPPENSBURG UNIVERSITY                 ,PA,17257-2299,Public       ,2070,560,2630,7821,1366,9187
00332700,SLIPPERY ROCK UNIVERSITY                ,PA,16057-1326,Public       ,2859,863,3722,8216,1748,9964
00332800,WEST CHESTER UNIVERSITY                 ,PA,19383-0001,Public       ,3252,1621,4873,16708,4387,21095
00332900,PENNSYLVANIA STATE UNIVERSITY (THE)     ,PA,16802-1503,Public       ,15943,9069,25012,69987,23291,93278
00335000,UNIVERSITY OF THE ARTS (THE)            ,PA,19102-9493,Private      ,496,182,678,2661,528,3189
00335100,CAIRN UNIVERSITY                        ,PA,19047-2942,Private      ,231,126,357,732,275,1007
00335200,PHILADELPHIA CLG OSTEOPATHIC MED        ,PA,19131-0000,Private      ,7,740,747,43,3217,3260
00335300,UNIVERSITY OF THE SCIENCES IN PHILADELPH,PA,19104-4495,Private      ,260,306,566,2976,1479,4455
00335400,PHILADELPHIA UNIVERSITY                 ,PA,19144-5497,Private      ,795,821,1616,3940,2019,5959
00335600,PITTSBURGH THEOLOGICAL SEMINARY         ,PA,15206-0000,Private      ,1,58,59,6,148,154
00335700,POINT PARK UNIVERSITY                   ,PA,15222-1912,Private      ,517,677,1194,3666,1831,5497
00335800,REFORMED PRESBYTERIAN THEOL SEMINAR     ,PA,15208-0000,Private      ,0,5,5,1,12,13
00335900,ROBERT MORRIS UNIVERSITY                ,PA,15108-1189,Private      ,1486,782,2268,5090,1589,6679
00336000,ROSEMONT COLLEGE                        ,PA,19010-1699,Private      ,157,174,331,661,412,1073
00336200,SETON HILL UNIVERSITY                   ,PA,15601-1599,Private      ,608,361,969,2000,740,2740
00336400,ST. CHARLES BORROMEO SEMINARY           ,PA,19096-0000,Private      ,8,9,17,22,14,36
00336600,SAINT FRANCIS UNIVERSITY                ,PA,15940-0600,Private      ,587,276,863,2113,645,2758
00336700,SAINT JOSEPH'S UNIVERSITY               ,PA,19131-1395,Private      ,1052,1085,2137,7307,2416,9723
00336800,ST VINCENT COLLEGE                      ,PA,15650-2690,Private      ,626,115,741,2004,226,2230
00336900,SUSQUEHANNA UNIVERSITY                  ,PA,17870-1001,Private      ,320,23,343,3792,118,3910
00337000,SWARTHMORE COLLEGE                      ,PA,19081-1397,Private      ,327,25,352,4058,104,4162
00337100,TEMPLE UNIVERSITY                       ,PA,19122-6003,Private      ,5657,5078,10735,34691,16148,50839
00337600,THIEL COLLEGE                           ,PA,16125-2181,Private      ,360,38,398,1452,99,1551
00337800,UNIVERSITY OF PENNSYLVANIA              ,PA,19104-6216,Private      ,2411,2804,5215,22464,10386,32850
00337900,UNIVERSITY OF PITTSBURGH                ,PA,15260-0000,Public       ,5080,2749,7829,30682,8022,38704
00337906,UNIVERSITY OF PITTSBURGH - SCHOOL OF MED,PA,15261-0001,Public       ,39,288,327,176,901,1077
00337907,UNIVERSITY OF PITTSBURGH - SCHOOL OF DEN,PA,15261-2523,Public       ,25,151,176,93,346,439
00338400,UNIVERSITY OF SCRANTON                  ,PA,18510-4622,Private      ,1054,486,1540,7748,1068,8816
00338500,URSINUS COLLEGE                         ,PA,19426-1000,Private      ,562,21,583,2608,82,2690
00338600,VALLEY FORGE MILITARY COLLEGE           ,PA,19087-3695,Private      ,151,19,170,458,65,523
00338800,VILLANOVA UNIVERSITY                    ,PA,19085-1699,Private      ,1309,1007,2316,12310,2271,14581
00338801,VILLANOVA UNIV SCH OF LAW               ,PA,19085-0000,Private      ,9,221,230,30,870,900
00338900,WASHINGTON & JEFFERSON COLLEGE          ,PA,15301-4801,Private      ,461,28,489,2573,99,2672
00339100,WAYNESBURG UNIVERSITY                   ,PA,15370-1222,Private      ,521,197,718,1878,411,2289
00339200,WESTMINSTER COLLEGE                     ,PA,16172-0002,Private      ,466,40,506,1785,118,1903
00339300,WESTMINSTER THEOLOGICAL SEMINARY        ,PA,19038-0000,Private      ,1,135,136,6,250,256
00339400,WILKES UNIVERSITY                       ,PA,18766-0998,Private      ,738,663,1401,3386,1249,4635
00339500,PENNSYLVANIA COLLEGE OF TECHNOLOGY      ,PA,17701-5779,Public       ,1948,925,2873,4491,1781,6272
00339600,WILSON COLLEGE                          ,PA,17201-1285,Private      ,106,149,255,586,375,961
00339900,YORK COLLEGE OF PENNSYLVANIA            ,PA,17405-7199,Private      ,1203,367,1570,6602,944,7546
00398600,DESALES UNIVERSITY                      ,PA,18034-9568,Private      ,544,534,1078,2688,1214,3902
00398700,LA ROCHE COLLEGE                        ,PA,15237-5898,Private      ,433,223,656,1153,418,1571
00398800,NEUMANN UNIVERSITY                      ,PA,19014-1298,Private      ,752,542,1294,2625,1172,3797
00405800,GRATZ COLLEGE                           ,PA,19027-3097,Private      ,1,27,28,1,53,54
00445200,MONTGOMERY COUNTY COMMUNITY COLLEGE     ,PA,19422-6300,Public       ,2095,2010,4105,4156,4012,8168
00488900,CAMBRIA-ROWE BUSINESS COLLEGE           ,PA,15902-2494,Proprietary  ,23,28,51,60,79,139
00488901,CAMBRIA ROWE BUSINESS COLLEGE - INDIANA ,PA,15701-2804,Proprietary  ,22,28,50,58,77,135
00488902,CAMBRIA ROWE BUSINESS COLLEGE - SCHOOL O,PA,15904-1945,Proprietary  ,8,13,21,9,16,25
00489000,CENTRAL PENN COLLEGE                    ,PA,17093-0309,Proprietary  ,288,588,876,842,1313,2155
00489300,DU BOIS BUSINESS COLLEGE                ,PA,15801-2401,Proprietary  ,57,69,126,98,139,237
00489800,MCCANN SCHOOL OF BUSINESS & TECHNOL     ,PA,17901-1335,Proprietary  ,489,1782,2271,695,2657,3352
00489807,MCCANN SCHOOL OF BUSINESS & TECHNOLOGY -,PA,17013-3180,Proprietary  ,31,71,102,44,128,172
00489900,MERCY HOSP SCH OF NURSING               ,PA,15219-5166,Private      ,48,65,113,107,134,241
00490200,PENN COMMERCIAL BUSINESS/TECHNICAL SCHL ,PA,15301-2871,Proprietary  ,91,147,238,163,271,434
00491000,KAPLAN CAREER INSTITUTE                 ,PA,17111-3571,Proprietary  ,50,173,223,116,339,455
00491001,THOMPSON INSTITUTE-PHILADEPHIA CAMPUS   ,PA,19104-3386,Proprietary  ,89,238,327,143,421,564
00500701,WEST VIRGINIA CAREER INSTITUTE          ,PA,15456-0000,Proprietary  ,25,34,59,41,64,105
00531000,PITTSBURGH INST OF AERONAUTICS          ,PA,15236-0000,Private      ,135,110,245,303,195,498
00533000,FAYETTE CNTY AREA VOC TECH PRC NRSG     ,PA,15401-0000,Public       ,11,37,48,24,73,97
00533500,CENTRAL PENN INST OF SCI & TECH PNP     ,PA,16823-0000,Public       ,37,78,115,63,126,189
00536500,YORK CO AREA VOC-TECH SCH-PRAC NSG      ,PA,17402-0000,Public       ,28,104,132,68,207,275
00653400,CITIZENS SCHOOL OF NURSING              ,PA,15068-6591,Private      ,50,86,136,92,145,237
00653700,CONEMAUGH VLY MEM HOSP SCH NRSNG        ,PA,15905-4398,Proprietary  ,84,71,155,84,71,155
00655100,ST MARGARET SCHL OF NURSING             ,PA,15238-3205,Private      ,28,63,91,68,130,198
00656000,OHIO VALLEY HOSP SCH OF NURSING         ,PA,15136-1694,Private      ,17,26,43,35,45,80
00656500,READING HOSPITAL SCHOOL OF HEALTH SCIENC,PA,19611-1744,Private      ,77,194,271,206,375,581
00657400,"ST LUKE'S HOSPITAL OF BETHLEHEM, PA     ",PA,18015-1065,Private      ,47,100,147,93,214,307
00657700,UPMC SHADYSIDE SCHOOL OF NURSING        ,PA,15232-1381,Private      ,76,118,194,184,241,425
00657800,SHARON REGIONAL HEALTH SYSTEM SCHOOL OF ,PA,16146-3395,Private      ,16,22,38,35,47,82
00658200,WASHINGTON HOSP SCH OF NURSING          ,PA,15301-3398,Private      ,13,32,45,35,62,97
00658202,WASHINGTON HOSP SCH OF RAD TECH         ,PA,15301-3398,Private      ,2,7,9,7,14,21
00658300,WESTERN PENN HOSP-SCH OF NURSING        ,PA,15224-1790,Private      ,60,79,139,130,154,284
00680700,COMMUNITY COLLEGE OF BEAVER COUNTY      ,PA,15061-2588,Public       ,442,478,920,841,885,1726
00681000,LEHIGH CARBON COMMUNITY COLLEGE         ,PA,18078-2598,Public       ,1478,1382,2860,2802,2711,5513
00681100,LUZERNE COUNTY COMMUNITY COLLEGE        ,PA,18634-3899,Public       ,1129,1242,2371,2291,2491,4782
00708700,ABINGTON MEM HOSP SCHL OF NURSING       ,PA,19090-1284,Private      ,31,128,159,123,318,441
00709100,EVEREST INSTITUTE                       ,PA,15222-1320,Proprietary  ,32,141,173,60,296,356
00711000,DELAWARE COUNTY COMMUNITY COLLEGE       ,PA,19063-1094,Public       ,2360,2843,5203,4717,5656,10373
00719100,NORTHAMPTON COMMUNITY COLLEGE           ,PA,18020-7599,Public       ,1956,1802,3758,5421,4637,10058
00730305,LINCOLN TECHNICAL INSTITUTE - PHILADELPH,PA,19136-1530,Proprietary  ,115,170,285,201,310,511
00732955,ITT TECHNICAL INSTITUTE                 ,PA,19406-1212,Proprietary  ,54,116,170,147,403,550
00743000,ANTONELLI INST OF ART & PHOTOGRAPHY     ,PA,19038-8242,Proprietary  ,85,10,95,229,26,255
00743600,KAPLAN CAREER INSTITUTE - ICM CAMPUS    ,PA,15222-1977,Proprietary  ,81,269,350,133,511,644
00743700,PITTSBURGH TECHNICAL INSTITUTE          ,PA,15071-3205,Proprietary  ,684,411,1095,2024,1046,3070
00746900,"HUSSIAN SCHOOL OF ART, INC.             ",PA,19106-0000,Proprietary  ,38,16,54,96,31,127
00747000,"ART INSTITUTE OF PITTSBURGH, THE        ",PA,15219-1328,Proprietary  ,794,2978,3772,1801,5338,7139
00752900,"CHESTER COUNTY INTERMEDIATE UNIT, PNP   ",PA,19335-3043,Public       ,20,64,84,34,114,148
00777900,LANSDALE SCHOOL OF BUSINESS             ,PA,19454-4114,Proprietary  ,29,152,181,45,255,300
00778000,NEW CASTLE SCHOOL OF TRADES             ,PA,16143-0000,Proprietary  ,128,245,373,225,393,618
00778100,CHI INSTITUTE/RETS CAMPUS               ,PA,19008-3516,Proprietary  ,43,116,159,60,187,247
00783900,TRIANGLE TECH                           ,PA,15214-3897,Proprietary  ,65,76,141,141,190,331
00791200,THADDEUS STEVENS CLG OF TECHNOLOGY      ,PA,17602-0000,Public       ,399,192,591,1169,479,1648
00791600,FRANKLIN CNTY CAREER & TECH CTR-PNP     ,PA,17201-0000,Public       ,16,40,56,32,78,110
00793807,LINCOLN TECHNICAL INSITUTE - ALLENTOWN  ,PA,18104-3212,Proprietary  ,126,230,356,213,393,606
00820000,JAMESON MEMORIAL HOSP SCH NURSING       ,PA,16105-2595,Private      ,17,42,59,33,63,96
00835000,ART INSTITUTE OF PHILADELPHIA           ,PA,19103-5198,Proprietary  ,541,511,1052,1653,1421,3074
00844100,ANTHEM INSTITUTE                        ,PA,19064-1243,Proprietary  ,2,8,10,4,16,20
00856800,VET TECH INSTITUTE                      ,PA,15222-3400,Proprietary  ,135,87,222,321,175,496
00865300,JEFFERSON CO DUBOIS VOC TECH-PR NSG     ,PA,15851-0000,Public       ,5,4,9,10,9,19
00895500,SALON PROFESSIONAL ACADEMY (THE)        ,PA,16602-0000,Proprietary  ,8,15,23,15,24,39
00915705,WYOTECH - BLAIRSVILLE                   ,PA,15717-8060,Proprietary  ,161,141,302,344,296,640
00918600,DEAN INSTITUTE OF TECHNOLOGY            ,PA,15226-1197,Proprietary  ,21,44,65,30,69,99
00944900,PENNCO TECH                             ,PA,19007-0000,Proprietary  ,85,121,206,128,222,350
00966400,EMPIRE BEAUTY SCHOOL                    ,PA,18052-5730,Proprietary  ,265,605,870,397,899,1296
00972100,BRADFORD SCHOOL                         ,PA,15219-2602,Proprietary  ,158,70,228,510,151,661
00972300,ARIA HEALTH SCHOOL OF NURSING           ,PA,19053-6939,Private      ,62,145,207,132,284,416
00986300,PENNSYLVANIA COLLEGE OF HEALTH SCIENCES ,PA,17602-4955,Private      ,232,435,667,577,857,1434
01000600,GREATER JOHNSTOWN AREA VOC TECH SCH     ,PA,15904-0000,Public       ,29,65,94,45,137,182
01005500,CRAWFORD CNTY AREA VO-TECH PRAC NUR     ,PA,16335-0000,Public       ,6,18,24,12,31,43
01017600,WESTMORELAND COUNTY COMMUNITY CLG       ,PA,15697-1895,Public       ,1205,1128,2333,2198,2041,4239
01038800,READING AREA COMMUNITY COLLEGE          ,PA,19603-1706,Public       ,858,1245,2103,1575,2280,3855
01054200,EMPIRE BEAUTY SCHOOL                    ,PA,18701-0000,Proprietary  ,262,582,844,411,948,1359
01081400,PITTSBURGH INST MORTUARY SCIENCE        ,PA,15206-3706,Private      ,40,86,126,93,223,316
01086000,GREATER ALTOONA CAREER/TECH CENTER      ,PA,16602-0000,Public       ,40,77,117,65,141,206
01096300,GREENE COUNTY VOC-TECH SCHOOL           ,PA,15370-0000,Public       ,6,15,21,8,24,32
01099800,PENNSYLVANIA INSTITUTE OF TECH          ,PA,19063-4098,Private      ,97,290,387,225,595,820
01162100,AUTOMOTIVE TRAINING CENTER              ,PA,19341-1310,Proprietary  ,344,132,476,665,257,922
01162200,WELDER TRAINING & TESTING INST          ,PA,18109-3253,Proprietary  ,9,33,42,22,61,83
01171500,SCHUYLKILL HEALTH SCHOOL OF NURSING     ,PA,17901-3692,Private      ,18,27,45,56,59,115
01191900,BEAVER FALLS BEAUTY ACADEMY             ,PA,15010-4208,Proprietary  ,5,10,15,13,18,31
01205000,ROSEDALE TECHNICAL INSTITUTE            ,PA,15205-9791,Private      ,144,116,260,262,259,521
01239300,THOMAS JEFF UNIV-CLG ALLIED HEALTH      ,PA,19107-0000,Private      ,80,406,486,265,1356,1621
01239301,THOMAS JEFFERSON UNIVERSITY - JEFFERSON ,PA,19107-5001,Private      ,100,662,762,360,2181,2541
01239303,THOMAS JEFFERSON UNIVERSITY - COLLEGE OF,PA,19107-6731,Private      ,61,245,306,204,620,824
01246104,LINCOLN TECHNICAL INSTITUTE             ,PA,19104-0202,Proprietary  ,117,283,400,208,456,664
01246105,LINCOLN TECHNICAL INSTITUTE             ,PA,19116-4202,Proprietary  ,92,201,293,154,359,513
01252300,TALMUDICAL YESHIVA OF PHILA             ,PA,19131-1296,Private      ,19,1,20,19,2,21
01260600,EMPIRE BEAUTY SCHOOL                    ,PA,17901-3859,Proprietary  ,235,499,734,353,781,1134
01292900,SOUTH HILLS BEAUTY ACADEMY              ,PA,15216-2335,Proprietary  ,23,43,66,40,84,124
01313400,YESHIVATH BETH MOSHE                    ,PA,18505-2196,Private      ,0,0,0,5,3,8
01321400,ROXBOROUGH MEM HOSP SCH OF NURSING      ,PA,19128-0000,Proprietary  ,41,150,191,95,323,418
01326300,SOUTH HILLS SCHOOL OF BUSINESS & TECHNOL,PA,16801-4516,Proprietary  ,266,227,493,392,347,739
02061000,VENUS BEAUTY ACADEMY                    ,PA,19079-0000,Proprietary  ,11,14,25,16,22,38
02068300,DOUGLAS SCHOOL OF BUSINESS              ,PA,15062-0000,Proprietary  ,98,86,184,191,158,349
02090200,TRIANGLE TECH                           ,PA,16502-0000,Proprietary  ,21,14,35,46,37,83
02092500,LAUREL TECHNICAL INSTITUTE              ,PA,16146-0000,Proprietary  ,82,98,180,125,187,312
02092502,BUSINESS INSTITUTE OF PENNSYLVANIA      ,PA,16335-0000,Proprietary  ,7,4,11,15,12,27
02104003,HARRIS SCHOOL OF BUSINESS - UPPER DARBY ,PA,19082-2528,Proprietary  ,3,24,27,9,44,53
02107300,PENNSYLVANIA ACADEMY OF FINE ARTS       ,PA,19102-1424,Private      ,57,59,116,271,250,521
02112200,GREAT LAKES INSTITUTE OF TECHNOLOGY     ,PA,16509-0000,Proprietary  ,124,158,282,212,274,486
02114200,JOHNSON COLLEGE                         ,PA,18508-0000,Private      ,172,109,281,400,218,618
02118000,LEVITTOWN BEAUTY ACADEMY LLC            ,PA,19054-1713,Proprietary  ,6,8,14,11,16,27
02119300,PA ACAD OF COSMETOLOGY ARTS & SCI       ,PA,15904-0000,Proprietary  ,14,25,39,26,40,66
02120800,"YORKTOWNE BUSINESS INSTITUTE, INC.      ",PA,17404-0000,Proprietary  ,21,34,55,55,88,143
02127400,YORK TECHNICAL INSTITUTE                ,PA,17402-0000,Proprietary  ,435,399,834,802,893,1695
02129000,TRIANGLE TECH                           ,PA,15601-0000,Proprietary  ,114,106,220,157,166,323
02129001,TRIANGLE TECH - BUSINESS CAREERS INSTITU,PA,15601-3304,Proprietary  ,6,4,10,9,5,14
02144000,TONI & GUY  HAIRDRESSING ACADEMY        ,PA,18109-1629,Proprietary  ,25,47,72,30,57,87
02151500,CENTRAL SUSQUEHANNA LPN CENTER          ,PA,17837-8818,Public       ,30,53,83,52,115,167
02158300,JUNIATA-MIFFLIN CO AREA VOC TECH        ,PA,17044-0000,Public       ,5,11,16,10,33,43
02161400,NORTHEASTERN HOSP SCH OF NRSG           ,PA,19134-0000,Private      ,15,60,75,34,126,160
02169600,CLEARFIELD CTY CAREER AND TECH CNTR     ,PA,16830-0000,Public       ,15,27,42,37,71,108
02174400,TRIANGLE TECH                           ,PA,15801-0000,Proprietary  ,98,68,166,200,127,327
02178900,ACADEMY OF HAIR DESIGN                  ,PA,18202-1465,Proprietary  ,37,101,138,50,133,183
02183000,ORLEANS TECHNICAL INSTITUTE             ,PA,19111-0000,Private      ,46,103,149,101,219,320
02192800,WALNUT HILL COLLEGE                     ,PA,19104-0000,Proprietary  ,147,112,259,433,274,707
02202300,PITTSBURGH CAREER INSTITUTE             ,PA,15219-1907,Proprietary  ,49,140,189,97,232,329
02203900,ERIE INSTITUTE OF TECHNOLOGY            ,PA,16565-1002,Proprietary  ,63,81,144,128,191,319
02206200,TONI & GUY HAIRDRESSING ACADEMY         ,PA,19002-4527,Proprietary  ,49,62,111,65,84,149
02206300,STROUDSBURG SCHOOL OF COSMETOLOGY       ,PA,18360-0000,Proprietary  ,22,18,40,31,27,58
02212700,LANCASTER SCHOOL OF COSMETOLOGY         ,PA,17602-0000,Proprietary  ,24,39,63,34,66,100
02234200,ACADEMY OF MEDICAL ARTS & BUSINESS      ,PA,17112-0000,Proprietary  ,77,124,201,149,227,376
02251200,SCHUYLKILL COUNTY AREA VOC TECH SCH     ,PA,17931-0000,Public       ,9,26,35,17,48,65
02251202,SCHUYLKILL COUNTY AREA VOC TECH SCH     ,PA,17931-0000,Public       ,0,4,4,1,14,15
02253900,BERKS TECHNICAL INSTITUTE               ,PA,19610-1168,Proprietary  ,352,755,1107,588,1109,1697
02269900,PENNSYLVANIA COLLEGE OF ART & DESIGN    ,PA,17603-3528,Private      ,93,30,123,394,90,484
02270500,BUCKS COUNTY SCHOOL OF BEAUTY CULT      ,PA,19053-0000,Proprietary  ,11,17,28,17,29,46
02273400,RECONSTRUCTIONIST RABBINICAL COLLEG     ,PA,19095-0000,Private      ,0,24,24,0,34,34
02276600,HANOVER PUBLIC SCH DIST PRAC NURSG      ,PA,17331-0000,Public       ,0,0,0,0,1,1
02282500,LENAPE SCHOOL OF PRACTICAL NURSING      ,PA,16226-0000,Public       ,16,51,67,48,123,171
02289500,PACE INSTITUTE                          ,PA,19601-0000,Proprietary  ,0,0,0,2,0,2
02289600,CONSOLIDATED SCHOOL OF BUSINESS         ,PA,17404-0000,Proprietary  ,30,42,72,54,101,155
02289700,ACADEMY OF CREATIVE HAIR DESIGN         ,PA,18702-0000,Proprietary  ,38,86,124,51,100,151
02289800,CHI INSTITUTE - FRANKLIN MILLS          ,PA,19154-0000,Proprietary  ,129,284,413,184,418,602
02290400,"ALTOONA BEAUTY SCHOOL, INC              ",PA,16602-0000,Proprietary  ,12,18,30,20,26,46
02292700,LANSDALE SCHOOL OF COSMETOLOGY          ,PA,19446-0000,Proprietary  ,3,5,8,9,14,23
02299300,TRINITY EPISCOPAL SCHOOL MINISTRY       ,PA,15003-0000,Private      ,0,42,42,1,68,69
02301300,PRISM CAREER INSTITUTE                  ,PA,19082-2448,Proprietary  ,19,57,76,38,128,166
02306200,VENANGO COUNTY AREA VOC TECH SCHOOL     ,PA,16301-0000,Public       ,17,27,44,26,40,66
02310800,LANCASTER COUNTY CAREER & TECH CTR      ,PA,17584-0000,Public       ,61,180,241,125,332,457
02323000,BIBLICAL THEOLOGICAL SEMINARY           ,PA,19440-2421,Private      ,1,30,31,1,56,57
02330300,LEBANON CO CAREER & TECHNOLOGY CTR      ,PA,17042-0000,Public       ,25,107,132,53,167,220
02330600,PENNSYLVANIA GUNSMITH SCHOOL            ,PA,15202-0000,Proprietary  ,21,32,53,47,60,107
02350100,WESTERN AREA CAREER & TECHNOLOGY CT     ,PA,15317-0000,Public       ,9,31,40,15,41,56
02350200,INDIANA COUNTY TECH CTR SCH PR NSG      ,PA,15701-1465,Public       ,27,48,75,38,84,122
02353100,NORTHERN TIER CAREER CENTER             ,PA,18848-0000,Public       ,7,23,30,16,40,56
02362300,MERCER COUNTY AREA VOC TECH SCHOOL      ,PA,16137-0000,Public       ,6,16,22,9,32,41
02492600,EASTERN CTR ARTS AND TECH PR NSG        ,PA,19090-0000,Public       ,4,39,43,17,64,81
02495500,ALL-STATE CAREER SCHOOL                 ,PA,19029-0000,Proprietary  ,58,260,318,94,418,512
02529800,WILKES BARRE AREA CAREER AND TECHNICAL C,PA,18705-0000,Public       ,33,80,113,61,155,216
02536600,COMMONWEALTH TECH INSTIT @ HIRAM G      ,PA,15905-0000,Public       ,65,19,84,115,37,152
02544300,BUTLER BEAUTY SCHOOL                    ,PA,16001-0000,Proprietary  ,12,15,27,15,28,43
02546200,LAUREL BUSINESS INSTITUTE               ,PA,15401-0877,Proprietary  ,68,68,136,118,125,243
02550000,CLARION CO AREA VOC-TECH PRAC NRSG      ,PA,16254-4637,Public       ,10,22,32,19,38,57
02554500,HAZLETON AREA CAREER CENTER PRACTICAL NU,PA,18201-0000,Public       ,19,32,51,29,55,84
02557800,ART INSTITUTE OF YORK (THE) - PENNSYLVAN,PA,17402-9012,Proprietary  ,148,71,219,324,135,459
02574800,PENNSYLVANIA INSTITUTE OF TAXIDERMY     ,PA,15931-0000,Proprietary  ,2,1,3,5,10,15
02609500,CAREER TRAINING ACADEMY                 ,PA,15068-6308,Proprietary  ,26,106,132,44,131,175
02609501,CAREER TRAINING ACADEMY                 ,PA,15146-0000,Proprietary  ,13,13,26,18,26,44
02616100,JEAN MADELINE ED CTR FOR COSM           ,PA,19147-1542,Proprietary  ,63,91,154,126,182,308
02617507,EVEREST COLLEGE - EVEREST INSTITUTE - BE,PA,19020-2062,Proprietary  ,4,13,17,11,43,54
03010800,FORTIS INSTITUTE                        ,PA,16506-1013,Proprietary  ,193,561,754,351,1067,1418
03011500,FORTIS INSTITUTE                        ,PA,18702-0000,Proprietary  ,19,67,86,38,99,137
03011600,FORTIS INSTITUTE                        ,PA,18509-2903,Proprietary  ,85,163,248,136,331,467
03029900,CONSOLIDATED SCHOOL OF BUSINESS         ,PA,17603-2389,Proprietary  ,46,43,89,73,85,158
03067000,ANTONELLI MEDICAL & PROF INST           ,PA,19464-9244,Proprietary  ,19,71,90,29,88,117
03072600,DCI CAREER INSTITUTE                    ,PA,15061-2307,Proprietary  ,7,26,33,15,41,56
03081900,YTI CAREER INSTITUTE - ALTOONA          ,PA,16602-4457,Proprietary  ,83,86,169,186,278,464
03090800,LAKE ERIE COLL OF OSTEOPATHIC MED       ,PA,16509-0000,Private      ,13,1394,1407,60,4176,4236
03098600,CAREER TECH CTR OF LACKAWANNA CNTY      ,PA,18508-0000,Public       ,25,59,84,46,113,159
03101400,FORBES ROAD CAREER & TECHNOLOGY CTR     ,PA,15146-1550,Public       ,11,11,22,17,18,35
03101500,BIDWELL TRAINING CENTER                 ,PA,15233-2233,Private      ,7,34,41,22,67,89
03103300,JNA INSTITUTE OF CULINARY ARTS          ,PA,19146-3119,Proprietary  ,24,54,78,58,116,174
03109100,METROPOLITAN CAREER CENTER              ,PA,19144-0000,Private      ,5,49,54,12,66,78
03110700,AVIATION INSTITUTE OF MAINTENANCE       ,PA,19114-1017,Proprietary  ,55,138,193,108,258,366
03120400,REGIONAL CAREER & TECHNICAL CENTER      ,PA,16509-4699,Public       ,2,5,7,10,11,21
03128400,DELAWARE COUNTY TECHNICAL SCHOOL        ,PA,19008-1928,Public       ,13,60,73,32,108,140
03180400,PENNSYLVANIA HIGHLANDS COMMUNITY COLLEGE,PA,15904-2927,Public       ,360,264,624,808,566,1374
03236400,L T INTERNATIONAL BEAUTY SCHOOL         ,PA,19130-2235,Proprietary  ,10,23,33,21,59,80
03353300,ACADEMY OF VOCAL ARTS                   ,PA,19103-6685,Private      ,11,19,30,33,69,102
03380301,STAR CAREER ACADEMY - STAR PHILADELPHIA ,PA,19114-2204,Proprietary  ,93,420,513,188,645,833
03380304,STAR CAREER ACADEMY - STAR NORRISTOWN   ,PA,19403-2422,Proprietary  ,26,81,107,41,138,179
03493302,ALL-STATE CAREER - WEST MIFFLIN CAMPUS  ,PA,15122-0000,Proprietary  ,5,11,16,13,31,44
03535300,HUNTINGDON COUNTY CAREER AND TECHNO     ,PA,17060-0905,Public       ,2,6,8,9,19,28
03561400,SUSQUEHANNA COUNTY CAREER & TECHNOL     ,PA,18816-0100,Public       ,10,19,29,21,31,52
03766300,PENNSYLVANIA SCHOOL OF MUSCLE THERAPY   ,PA,19406-3101,Proprietary  ,21,63,84,31,85,116
03781300,PRINCETON INFORMATION TECHNOLOGY CENTER ,PA,19038-4535,Proprietary  ,5,85,90,15,146,161
03923300,PRECISION MANUFACTURING INSTITUTE       ,PA,16335-8380,Private      ,12,17,29,21,30,51
03948300,HARRISBURG UNIVERSITY OF SCIENCE AND TEC,PA,17101-2116,Private      ,146,86,232,467,186,653
03949300,WON INSTITUTE OF GRADUATE STUDIES       ,PA,19038-4535,Private      ,1,15,16,1,26,27
03950500,NORTHWEST REGIONAL TECHNOLOGY INSTITUTE ,PA,16508-2820,Proprietary  ,2,16,18,14,27,41
03952300,NATIONAL MASSAGE THERAPY INSTITUTE      ,PA,19116-3965,Proprietary  ,9,25,34,18,52,70
04024300,EDUCATION AND TECHNOLOGY INSTITUTE      ,PA,15601-9214,Private      ,3,6,9,8,11,19
04041300,BERKS CAREER & TECHNOLOGY CENTER        ,PA,19533-9112,Public       ,9,25,34,20,39,59
04118000,BYZANTINE CATHOLIC SEMINARY OF SAINTS CY,PA,15214-2229,Private      ,0,2,2,1,7,8
04124600,PROFESSIONAL ACADEMY OF COSMETOLOGY     ,PA,19401-0000,Proprietary  ,0,4,4,1,7,8
04127500,CDE CAREER INSTITUTE                    ,PA,18372-9034,Proprietary  ,13,33,46,33,63,96
04145800,PULSE BEAUTY ACADEMY A PAUL MITCHELL PAR,PA,19335-0000,Proprietary  ,17,10,27,28,33,61
04149800,SOMERSET COUNTY TECHNOLOGY CENTER       ,PA,15501-1444,Public       ,11,37,48,26,66,92
04151700,BELLA CAPELLI ACADEMY                   ,PA,15146-2388,Proprietary  ,38,21,59,48,27,75
04151701,BELLA CAPELLI ACADEMY -                 ,PA,15205-2388,Proprietary  ,40,41,81,64,65,129
04155100,INSTITUTE OF MEDICAL CAREERS            ,PA,15235-3718,Proprietary  ,23,53,76,37,105,142
04158000,METRO BEAUTY ACADEMY                    ,PA,18106-9693,Proprietary  ,47,61,108,71,98,169
04164900,BARONE BEAUTY ACADEMY                   ,PA,17701-5316,Proprietary  ,5,11,16,12,24,36
04167200,COMMONWEALTH MEDICAL COLLEGE (THE)      ,PA,18509-3240,Private      ,4,172,176,10,706,716
04175900,LEWISTOWN HOSPITAL SCHOOL OF NURSING    ,PA,17044-1167,Private      ,4,21,25,13,36,49
04215500,CHAMP'S BARBER SCHOOL                   ,PA,17603-3809,Proprietary  ,3,9,12,8,20,28
04221300,PHILADELPHIA TECHNICIAN TRAINING        ,PA,19138-1324,Private      ,28,126,154,52,238,290
04224600,BARBER SCHOOL OF PITTSBURGH             ,PA,15220-5537,Proprietary  ,13,36,49,23,66,89
04226300,DIVINE CROWN ACADEMY OF COSMETOLOGY     ,PA,17104-2103,Proprietary  ,5,19,24,12,35,47
04232000,STUDIO INCAMMINATI                      ,PA,19107-1105,Private      ,2,4,6,2,8,10
04236800,FOUNTAIN OF YOUTH ACADEMY OF COSMETOLOGY,PA,16046-2430,Proprietary  ,2,4,6,3,4,7
00267813,BRYANT & STRATTON COLLEGE - MIL DOWNTOWN,WI,53203-2608,Proprietary  ,216,717,933,451,1657,2108
00383200,ALVERNO COLLEGE                         ,WI,53234-3922,Private      ,300,691,991,1232,1687,2919
00383500,BELOIT COLLEGE                          ,WI,53511-5595,Private      ,155,24,179,2291,117,2408
00383700,CARDINAL STRITCH UNIVERSITY             ,WI,53217-9884,Private      ,173,750,923,1113,1966,3079
00383800,CARROLL UNIVERSITY                      ,WI,53186-5593,Private      ,516,276,792,3747,733,4480
00383900,CARTHAGE COLLEGE                        ,WI,53141-0000,Private      ,522,198,720,4933,606,5539
00384000,WESTERN TECHNICAL COLLEGE               ,WI,54601-0908,Public       ,638,696,1334,1432,1282,2714
00384200,CONCORDIA UNIVERSITY WISCONSIN          ,WI,53097-2402,Private      ,405,1303,1708,3238,3220,6458
00384800,EDGEWOOD COLLEGE                        ,WI,53711-1958,Private      ,191,276,467,1710,886,2596
00385000,SILVER LAKE COLLEGE                     ,WI,54220-9319,Private      ,61,103,164,190,210,400
00385400,LAKELAND COLLEGE                        ,WI,53082-0000,Private      ,189,602,791,1096,1259,2355
00385600,LAWRENCE UNIVERSITY                     ,WI,54912-0599,Private      ,249,23,272,2338,99,2437
00386100,MARIAN UNIVERSITY                       ,WI,54935-4699,Private      ,272,280,552,1403,683,2086
00386300,MARQUETTE UNIVERSITY                    ,WI,53201-1881,Private      ,408,557,965,15324,3240,18564
00386600,MILWAUKEE AREA TECH COLLEGE             ,WI,53233-1443,Public       ,1826,4394,6220,4323,9222,13545
00386800,MILWAUKEE SCHOOL OF ENGINEERING         ,WI,53202-3109,Private      ,258,175,433,2914,673,3587
00386900,MOUNT MARY UNIVERSITY                   ,WI,53222-4597,Private      ,139,274,413,859,955,1814
00387400,NASHOTAH HOUSE                          ,WI,53058-0000,Private      ,0,30,30,0,39,39
00387500,NORTHLAND COLLEGE                       ,WI,54806-3999,Private      ,173,38,211,699,93,792
00388400,RIPON COLLEGE                           ,WI,54971-0248,Private      ,127,14,141,1353,68,1421
00389200,ST. NORBERT COLLEGE                     ,WI,54115-2099,Private      ,196,38,234,3006,103,3109
00389500,UNIVERSITY OF WISCONSIN-MADISON         ,WI,53715-1382,Public       ,4416,2401,6817,24323,7529,31852
00389600,UNIVERSITY OF WISCONSIN-MILWAUKEE       ,WI,53201-3165,Public       ,3339,3261,6600,15839,9603,25442
00389700,UNIVERSITY OF WISCONSIN COLLEGES        ,WI,53708-8680,Public       ,639,601,1240,3890,1634,5524
00389701,UNIVERSITY OF WISCONSIN-BARABOO         ,WI,53913-1098,Public       ,94,51,145,327,115,442
00389702,UNIVERSITY OF WISCONSIN-BARRON          ,WI,54868-2497,Public       ,100,65,165,325,128,453
00389703,UNIVERSITY OF WISCONSIN-FOND DU LAC     ,WI,54935-2998,Public       ,144,72,216,385,146,531
00389704,UNIVERSITY OF WISCONSIN-FOX VALLEY      ,WI,54952-1297,Public       ,300,124,424,856,276,1132
00389705,UNIVERSITY OF WISCONSIN-MANITOWOC       ,WI,54220-6699,Public       ,88,32,120,235,83,318
00389706,UNIVERSITY OF WISCONSIN-MARATHON        ,WI,54401-5396,Public       ,208,87,295,562,181,743
00389707,UNIVERSITY OF WISCONSIN-MARINETTE       ,WI,54143-4299,Public       ,75,43,118,263,89,352
00389708,UNIVERSITY OF WISCONSIN-MARSHFIELD      ,WI,54449-3310,Public       ,88,46,134,250,102,352
00389709,UNIVERSITY OF WISCONSIN-RICHLAND        ,WI,53581-1399,Public       ,73,36,109,203,79,282
00389710,UNIVERSITY OF WISCONSIN COLLEGES - ROCK ,WI,53546-5699,Public       ,220,176,396,573,362,935
00389711,UNIVERSITY OF WISCONSIN-SHEBOYGAN       ,WI,53081-4789,Public       ,133,88,221,375,189,564
00389712,UNIVERSITY OF WISCONSIN-WASHINGTON      ,WI,53095-3699,Public       ,151,81,232,456,161,617
00389713,UNIVERSITY OF WISCONSIN-WAUKESHA        ,WI,53188-2799,Public       ,435,193,628,1378,442,1820
00389900,UNIVERSITY OF WISCONSIN-GREEN BAY       ,WI,54311-7001,Public       ,904,820,1724,3877,1972,5849
00391100,VITERBO UNIVERSITY                      ,WI,54601-4777,Private      ,175,272,447,1595,861,2456
00391500,UNIVERSITY OF WISCONSIN-STOUT           ,WI,54751-0790,Public       ,1616,739,2355,5533,1534,7067
00391700,UNIVERSITY OF WISCONSIN-EAU CLAIRE      ,WI,54702-4004,Public       ,2235,568,2803,8165,1290,9455
00391900,UNIVERSITY OF WISCONSIN-LA CROSSE       ,WI,54601-3742,Public       ,1557,443,2000,8406,1305,9711
00392000,UNIVERSITY OF WISCONSIN-OSHKOSH         ,WI,54901-8604,Public       ,1824,967,2791,7711,2261,9972
00392100,UNIVERSITY OF WISCONSIN-PLATTEVILLE     ,WI,53818-3099,Public       ,1463,514,1977,6739,1161,7900
00392300,UNIVERSITY OF WISCONSIN-RIVER FALLS     ,WI,54022-5013,Public       ,1359,451,1810,3938,878,4816
00392400,UNIVERSITY OF WISCONSIN-STEVENS POINT   ,WI,54481-3897,Public       ,1939,658,2597,7383,1502,8885
00392500,UNIVERSITY OF WISCONSIN-SUPERIOR        ,WI,54880-2898,Public       ,423,435,858,1286,946,2232
00392600,UNIVERSITY OF WISCONSIN-WHITEWATER      ,WI,53190-1792,Public       ,2045,815,2860,9368,2005,11373
00400700,MADISON AREA TECHNICAL COLLEGE          ,WI,53704-2599,Public       ,1619,2371,3990,3554,4586,8140
00501500,UNIVERSITY OF WISCONSIN-PARKSIDE        ,WI,53141-2000,Public       ,944,691,1635,3136,1605,4741
00529400,WAUKESHA COUNTY TECHNICAL COLLEGE       ,WI,53072-4696,Public       ,478,1008,1486,1116,2015,3131
00530100,NORTHEAST WISCONSIN TECHNICAL COLLEGE   ,WI,54307-9042,Public       ,974,1556,2530,2142,2900,5042
00530400,CHIPPEWA VALLEY TECHNICAL COLLEGE       ,WI,54701-6162,Public       ,929,1175,2104,1718,2045,3763
00538000,MID-STATE TECHNICAL COLLEGE             ,WI,54494-5512,Public       ,295,695,990,617,1150,1767
00538400,NICOLET AREA TECHNICAL COLLEGE          ,WI,54501-0000,Public       ,118,184,302,311,384,695
00538700,NORTHCENTRAL TECHNICAL COLLEGE          ,WI,54401-1899,Public       ,527,994,1521,1038,1715,2753
00538900,GATEWAY TECHNICAL COLLEGE               ,WI,53144-1690,Public       ,724,1684,2408,1672,4244,5916
00539000,BLACKHAWK TECHNICAL COLLEGE             ,WI,53547-5009,Public       ,331,715,1046,723,1571,2294
00663900,BELLIN COLLEGE                          ,WI,54305-0000,Private      ,57,72,129,276,157,433
00732934,ITT TECHNICAL INSTITUTE                 ,WI,53220-4612,Proprietary  ,65,405,470,115,655,770
00766900,SOUTHWEST WISCONSIN TECH COLLEGE        ,WI,53809-0000,Public       ,262,326,588,587,573,1160
00821700,PAUL MITCHELL THE SCHOOL GREEN BAY      ,WI,54324-0257,Proprietary  ,25,44,69,56,60,116
00869405,RASMUSSEN COLLEGE - WAUSAU              ,WI,54401-7804,Proprietary  ,32,182,214,59,372,431
00869414,RASMUSSEN COLLEGE - GREEN BAY           ,WI,54303-2349,Proprietary  ,44,237,281,98,464,562
00869419,RASMUSSEN COLLEGE - APPLETON            ,WI,54915-7305,Proprietary  ,21,173,194,43,374,417
00919400,LAKESHORE TECHNICAL COLLEGE             ,WI,53015-1412,Public       ,209,473,682,466,934,1400
00925600,MORAINE PARK TECHNICAL COLLEGE          ,WI,54936-0000,Public       ,371,792,1163,789,1696,2485
00941900,STATE CLG OF BEAUTY CULT-WAUSAU         ,WI,54403-4667,Proprietary  ,6,6,12,20,24,44
00962100,HERZING UNIVERSITY                      ,WI,53718-4236,Proprietary  ,340,3211,3551,667,7240,7907
00974400,FOX VALLEY TECHNICAL COLLEGE            ,WI,54913-0000,Public       ,946,1514,2460,2144,3125,5269
01091300,MADISON MEDIA INSTITUTE                 ,WI,53718-6787,Proprietary  ,190,138,328,344,259,603
01148400,ADVANCED INSTITUTE OF HAIR DESIGN       ,WI,53225-0000,Proprietary  ,53,57,110,112,99,211
01182400,WISCONSIN INDIANHEAD TECH CLG WITC      ,WI,54871-9300,Public       ,354,725,1079,740,1283,2023
02077100,MILWAUKEE INST OF ART & DESIGN          ,WI,53202-0000,Private      ,196,72,268,864,232,1096
02078000,SACRED HEART SCHOOL OF THEOLOGY         ,WI,53130-0000,Private      ,0,1,1,0,2,2
02136600,WISCONSIN LUTHERAN COLLEGE              ,WI,53226-0000,Private      ,241,109,350,1136,257,1393
02271300,WI SCH OF PROFESSIONAL PSYCHOLOGY       ,WI,53225-0000,Private      ,7,48,55,19,101,120
02317200,MARANATHA BAPTIST UNIVERSITY            ,WI,53094-7638,Private      ,260,57,317,589,113,702
02453500,MEDICAL COLLEGE OF WISCONSIN            ,WI,53226-0000,Private      ,22,143,165,76,1067,1143
02494300,GILL-TECH ACADEMY OF HAIR DESIGN        ,WI,54911-0000,Proprietary  ,7,11,18,14,25,39
02532200,LAC COURTE OREILLES OJIBWA CMTY CLG     ,WI,54843-0000,Public       ,12,67,79,22,137,159
03061200,MIDWEST COLLEGE OF ORIENTAL MEDICINE    ,WI,53403-9747,Proprietary  ,4,80,84,11,135,146
03125100,COLLEGE OF MENOMINEE NATION             ,WI,54135-0000,Private      ,24,106,130,45,176,221
03125102,COLLEGE OF  THE MENOMINEE NATION - GREEN,WI,54304-4964,Private      ,9,55,64,24,108,132
03220300,"SALON PROFESSIONAL ACADEMY, THE         ",WI,54701-7633,Proprietary  ,11,20,31,21,30,51
03309300,MONTESSORI INSTITUTE OF MILWAUKEE       ,WI,53207-0000,Private      ,2,12,14,6,24,30
03808300,INSTITUTE OF BEAUTY AND WELLNESS (AIM)  ,WI,53202-5715,Proprietary  ,63,96,159,136,161,297
03822300,PAUL MITCHELL THE SCHOOL - MONROE       ,WI,53566-0000,Proprietary  ,19,24,43,28,34,62
03872500,NORTHLAND INTERNATIONAL UNIVERSITY      ,WI,54119-9285,Private      ,8,4,12,43,9,52
03925300,BLUE SKY SCHOOL OF PROFESSIONAL MASSAGE ,WI,53024-9699,Private      ,0,1,1,1,4,5
03925301,BLUE SKY SCHOOL OF PROFESSIONAL MASSAGE ,WI,54115-7407,Private      ,1,1,2,3,6,9
03925303,BLUE SKY SCHOOL OF PROFESSIONAL MASSAGE ,WI,53713-2366,Private      ,2,8,10,8,19,27
04117400,MILWAUKEE CAREER COLLEGE                ,WI,53222-4305,Proprietary  ,69,120,189,158,267,425
04118600,ACADEMY OF COSMETOLOGY                  ,WI,53548-3307,Proprietary  ,14,26,40,31,42,73
04124800,VISIONS IN HAIR DESIGN INSTITUTE OF COSM,WI,53210-1120,Proprietary  ,0,0,0,0,1,1
04132600,WISCONSIN ACADEMY (THE)                 ,WI,54157-1726,Proprietary  ,14,15,29,22,21,43
04137900,BRENSTEN EDUCATION                      ,WI,53186-0000,Proprietary  ,15,141,156,22,212,234
04138200,SALON PROFESSIONAL ACADEMY (THE)        ,WI,54914-3921,Proprietary  ,12,17,29,30,33,63
04157700,SALON PROFESSIONAL ACADEMY (THE)        ,WI,54650-8699,Proprietary  ,19,18,37,36,36,72
04159400,COLUMBIA COLLEGE OF NURSING             ,WI,53211-2952,Private      ,58,85,143,186,206,392
04165300,ACADEMY WAUKESHA (THE)                  ,WI,53072-5524,Proprietary  ,33,42,75,57,63,120
04179200,ADVANCED COLLEGE OF COSMETOLOGY         ,WI,53963-0000,Proprietary  ,12,8,20,18,15,33
04182100,FIRST CLASS COSMETOLOGY SCHOOL          ,WI,52511-0000,Proprietary  ,14,19,33,29,39,68
04183600,SALON PROFESSIONAL ACADEMY OF KENOSHA (T,WI,53142-4950,Proprietary  ,22,32,54,46,73,119
04193800,SHEPHERDS COLLEGE                       ,WI,53182-1527,Private      ,15,8,23,22,17,39
04202800,PANACHE ACADEMY OF BEAUTY               ,WI,53913-2596,Proprietary  ,10,24,34,15,36,51
04219300,EAST-WEST HEALING ARTS INSTITUTE        ,WI,53719-1133,Proprietary  ,4,26,30,14,56,70
04231400,BELLA ACADEMY OF COSMETOLOGY            ,WI,54901-4738,Proprietary  ,5,6,11,16,18,34
04237400,WRIGHT GRADUATE UNIVERSITY FOR THE REALI,WI,53121-2556,Private      ,4,9,13,10,21,31
00290500,NORTH CAROLINA A&T STATE UNIV           ,NC,27411-0001,Public       ,3352,2168,5520,14203,5303,19506
00290600,APPALACHIAN STATE UNIVERSITY            ,NC,28608-2059,Public       ,2757,1370,4127,16485,4144,20629
00290700,UNIVERSITY OF NC AT ASHEVILLE           ,NC,28804-3299,Public       ,781,539,1320,4282,1449,5731
00290800,BARTON COLLEGE                          ,NC,27893-3104,Private      ,366,272,638,1367,579,1946
00291000,BELMONT ABBEY COLLEGE                   ,NC,28012-1802,Private      ,309,289,598,1389,672,2061
00291100,BENNETT COLLEGE                         ,NC,27401-3239,Private      ,202,131,333,882,319,1201
00291200,BREVARD COLLEGE                         ,NC,28712-3306,Private      ,305,64,369,1178,150,1328
00291300,CAMPBELL UNIVERSITY                     ,NC,27506-0036,Private      ,1050,1570,2620,4946,3608,8554
00291400,CATAWBA COLLEGE                         ,NC,28144-2488,Private      ,394,204,598,1816,471,2287
00291500,CENTRAL PIEDMONT COMMUNITY COLLEGE      ,NC,28204-2297,Public       ,3588,5617,9205,7704,10669,18373
00291600,CHOWAN UNIVERSITY                       ,NC,27855-1850,Private      ,441,125,566,2239,378,2617
00291700,COLLEGE OF THE ALBEMARLE                ,NC,27909-2327,Public       ,253,437,690,630,961,1591
00291800,DAVIDSON COLLEGE                        ,NC,28035-7157,Private      ,397,79,476,3492,189,3681
00291900,DAVIDSON COUNTY COMMUNITY COLLEGE       ,NC,27293-0000,Public       ,708,1537,2245,1423,2962,4385
00292000,DUKE UNIVERSITY                         ,NC,27708-0397,Private      ,1635,685,2320,16964,2405,19369
00292001,DUKE UNIV - SCHOOL OF MEDICINE          ,NC,27710-0000,Private      ,36,246,282,200,871,1071
00292002,DUKE UNIV - SCHOOL OF LAW               ,NC,27708-0000,Private      ,9,161,170,64,1782,1846
00292003,DUKE UNIV - GRAD SCH ARTS & SCIENCE     ,NC,27708-0000,Private      ,20,152,172,189,574,763
00292004,DUKE UNIV - FUQUA SCH OF BUSINESS       ,NC,27708-0000,Private      ,22,332,354,157,841,998
00292005,DUKE UNIV/NICHOLAS SCH OF ENVIRON.      ,NC,27708-0000,Private      ,5,57,62,43,312,355
00292006,DUKE UNIV - DIVINITY SCHOOL             ,NC,27708-0000,Private      ,43,272,315,755,700,1455
00292007,DUKE UNIV - SCHOOL OF NURSING           ,NC,27710-0000,Private      ,34,428,462,157,1237,1394
00292010,DUKE UNIVERSITY - SCHOOL OF PUBLIC POLIC,NC,27708-0239,Private      ,6,40,46,28,198,226
00292300,EAST CAROLINA UNIVERSITY                ,NC,27858-1818,Public       ,4954,4018,8972,23248,10150,33398
00292600,ELIZABETH CITY STATE UNIVERSITY         ,NC,27909-7806,Public       ,470,303,773,2022,838,2860
00292700,ELON UNIVERSITY                         ,NC,27244-2010,Private      ,747,331,1078,7087,1011,8098
00292800,FAYETTEVILLE STATE UNIVERSITY           ,NC,28301-4298,Public       ,1343,2513,3856,4593,5329,9922
00292900,GARDNER-WEBB UNIVERSITY                 ,NC,28017-0000,Private      ,599,1118,1717,2499,2361,4860
00293000,GREENSBORO COLLEGE                      ,NC,27401-1875,Private      ,357,375,732,1558,820,2378
00293100,GUILFORD COLLEGE                        ,NC,27410-4171,Private      ,496,724,1220,2396,1625,4021
00293300,HIGH POINT UNIVERSITY                   ,NC,27262-4221,Private      ,750,194,944,6805,560,7365
00293400,ISOTHERMAL COMMUNITY COLLEGE            ,NC,28160-0804,Public       ,339,423,762,689,745,1434
00293500,LAUREL UNIVERSITY                       ,NC,27265-3197,Private      ,28,60,88,71,137,208
00293600,JOHNSON C SMITH UNIVERSITY              ,NC,28216-5398,Private      ,514,471,985,2310,1291,3601
00293700,KING'S COLLEGE-CHARLOTTE                ,NC,28204-2435,Proprietary  ,237,187,424,575,417,992
00293900,LEES MCRAE COLLEGE                      ,NC,28604-0000,Private      ,272,200,472,1082,424,1506
00294000,LENOIR COMMUNITY COLLEGE                ,NC,28502-0188,Public       ,294,734,1028,699,1432,2131
00294100,LENOIR-RHYNE UNIVERSITY                 ,NC,28603-0000,Private      ,516,454,970,2759,1005,3764
00294200,LIVINGSTONE COLLEGE                     ,NC,28144-5298,Private      ,572,201,773,1764,494,2258
00294300,LOUISBURG COLLEGE                       ,NC,27549-2398,Private      ,379,89,468,978,182,1160
00294400,MARS HILL COLLEGE                       ,NC,28754-0000,Private      ,507,163,670,2006,392,2398
00294500,MEREDITH COLLEGE                        ,NC,27607-5298,Private      ,433,320,753,2032,804,2836
00294600,METHODIST UNIVERSITY                    ,NC,28311-1420,Private      ,710,601,1311,2785,1367,4152
00294700,MITCHELL COMMUNITY COLLEGE              ,NC,28677-5264,Public       ,415,684,1099,865,1280,2145
00294800,MONTREAT COLLEGE                        ,NC,28757-1267,Private      ,164,215,379,541,515,1056
00294900,UNIVERSITY OF MOUNT OLIVE               ,NC,28365-1299,Private      ,399,1221,1620,1345,2546,3891
00295000,NORTH CAROLINA CENTRAL UNIVERSITY       ,NC,27707-3198,Public       ,1932,2208,4140,9347,6026,15373
00295100,NORTH CAROLINA WESLEYAN COLLEGE         ,NC,27804-8699,Private      ,440,740,1180,1470,1444,2914
00295300,WILLIAM PEACE UNIVERSITY                ,NC,27604-1194,Private      ,292,254,546,1287,554,1841
00295400,UNIV OF NORTH CAROLINA AT PEMBROKE      ,NC,28372-1510,Public       ,1721,1384,3105,6464,3188,9652
00295500,PFEIFFER UNIVERSITY                     ,NC,28109-0000,Private      ,214,369,583,890,815,1705
00295600,PIEDMONT INTERNATIONAL UNIVERSITY       ,NC,27101-5025,Private      ,69,147,216,135,291,426
00295700,QUEENS UNIVERSITY OF CHARLOTTE          ,NC,28274-0001,Private      ,469,676,1145,2064,1466,3530
00295800,ROCKINGHAM COMMUNITY COLLEGE            ,NC,27375-0000,Public       ,222,450,672,633,916,1549
00296000,SALEM COLLEGE                           ,NC,27108-0000,Private      ,215,228,443,941,531,1472
00296100,SANDHILLS COMMUNITY COLLEGE             ,NC,28374-8283,Public       ,489,931,1420,1122,1788,2910
00296200,SHAW UNIVERSITY                         ,NC,27601-2393,Private      ,756,624,1380,2240,1362,3602
00296300,SOUTHEASTERN BAPTIST THEOL SEMINARY     ,NC,27588-0000,Private      ,47,104,151,133,202,335
00296400,SOUTHEASTERN COMMUNITY COLLEGE          ,NC,28472-5422,Public       ,214,310,524,435,578,1013
00296800,ST AUGUSTINES COLLEGE                   ,NC,27610-2298,Private      ,377,229,606,1287,508,1795
00297000,SURRY COMMUNITY COLLEGE                 ,NC,27017-0304,Public       ,483,551,1034,1072,1071,2143
00297200,NORTH CAROLINA STATE UNIV-RALEIGH       ,NC,27695-7001,Public       ,2536,2473,5009,26979,8854,35833
00297300,GASTON COLLEGE                          ,NC,28034-1499,Public       ,735,1371,2106,1649,2687,4336
00297400,UNIVERSITY OF N C-CHAPEL HILL           ,NC,27514-0000,Public       ,1685,2700,4385,25826,10801,36627
00297500,UNIVERSITY OF NC AT CHARLOTTE           ,NC,28223-0001,Public       ,4424,3959,8383,24838,10914,35752
00297600,UNIVERSITY OF N C - GREENSBORO          ,NC,27412-0001,Public       ,3187,3124,6311,16208,8747,24955
00297800,WAKE FOREST UNIV - UNDERGRADUATE        ,NC,27109-7246,Private      ,332,121,453,7771,376,8147
00297801,WAKE FOREST UNIV - SCH OF MEDICINE      ,NC,27157-1090,Private      ,22,76,98,96,1173,1269
00297803,WAKE FOREST GRAD SCHOOLS OF BUSINESS    ,NC,27109-7659,Private      ,4,233,237,57,547,604
00297805,WAKE FOREST UNIV - SCH OF LAW           ,NC,27109-7206,Private      ,4,202,206,33,1076,1109
00297806,WAKE FOREST UNIV - GRAD A&S/DIVINITY    ,NC,27109-7246,Private      ,6,216,222,36,598,634
00297900,WARREN WILSON COLLEGE                   ,NC,28815-0000,Private      ,260,90,350,1073,279,1352
00298000,WAYNE COMMUNITY COLLEGE                 ,NC,27533-0000,Public       ,480,864,1344,942,1675,2617
00298100,WESTERN CAROLINA UNIVERSITY             ,NC,28723-9731,Public       ,1779,1194,2973,9874,3453,13327
00298200,WESTERN PIEDMONT COMMUNITY COLLEGE      ,NC,28655-4504,Public       ,341,464,805,742,938,1680
00298300,WILKES COMMUNITY COLLEGE                ,NC,28697-2100,Public       ,411,460,871,859,900,1759
00298400,UNIVERSITY OF N C-WILMINGTON            ,NC,28403-3297,Public       ,2651,1955,4606,14110,4932,19042
00298500,WINGATE UNIVERSITY                      ,NC,28174-0159,Private      ,757,460,1217,4359,1235,5594
00298600,WINSTON-SALEM STATE UNIVERSITY          ,NC,27102-0000,Public       ,1492,1466,2958,7051,3779,10830
00398100,UNC SCHOOL OF THE ARTS                  ,NC,27127-2188,Public       ,229,133,362,1417,397,1814
00403300,ASHEVILLE BUNCOMBE TECH CMTY CLG        ,NC,28801-4897,Public       ,752,1522,2274,1682,2970,4652
00406200,PITT COMMUNITY COLLEGE                  ,NC,28590-0000,Public       ,1618,2752,4370,3367,5162,8529
00483500,CALDWELL COMMUNITY CLG & TECH INST      ,NC,28638-2626,Public       ,476,678,1154,1089,1406,2495
00483800,GUILFORD TECHNICAL COMMUNITY CLG        ,NC,27282-0309,Public       ,2138,4262,6400,4662,8583,13245
00484400,WAKE TECHNICAL COMMUNITY COLLEGE        ,NC,27603-5696,Public       ,4095,7014,11109,8371,13074,21445
00484500,WILSON COMMUNITY COLLEGE                ,NC,27893-3310,Public       ,236,601,837,451,1146,1597
00499201,MILLER-MOTTE TECHNICAL COLLEGE - MILLER-,NC,27511-9209,Proprietary  ,23,194,217,45,313,358
00499202,MILLER-MOTTE TECHNICAL COLLEGE - MILLER-,NC,27604-6072,Proprietary  ,87,420,507,191,760,951
00499203,MILLER-MOTTE TECHNICAL COLLEGE - FAYETTE,NC,28311-7651,Proprietary  ,76,583,659,147,1004,1151
00499205,MILLER-MOTTE TECHNICAL COLLEGE - MILLER-,NC,28540-5901,Proprietary  ,47,384,431,77,625,702
00531600,COASTAL CAROLINA COMMUNITY COLLEGE      ,NC,28546-6816,Public       ,492,1493,1985,1111,2823,3934
00531700,FORSYTH TECHNICAL COMMUNITY COLLEGE     ,NC,27103-5197,Public       ,1300,2554,3854,2966,5384,8350
00531800,CATAWBA VALLEY COMMUNITY COLLEGE        ,NC,28602-8302,Public       ,779,1081,1860,1884,2192,4076
00532000,CAPE FEAR COMMUNITY COLLEGE             ,NC,28401-3910,Public       ,1403,2048,3451,3040,3745,6785
00544700,RANDOLPH COMMUNITY COLLEGE              ,NC,27204-1009,Public       ,435,690,1125,932,1366,2298
00544800,DURHAM TECHNICAL CMNTY COLLEGE          ,NC,27703-5023,Public       ,692,1949,2641,1541,3772,5313
00544900,CENTRAL CAROLINA COMMUNITY COLLEGE      ,NC,27330-9000,Public       ,545,1301,1846,1238,2507,3745
00546300,ALAMANCE COMMUNITY COLLEGE              ,NC,27253-0000,Public       ,554,1035,1589,1277,2205,3482
00546400,RICHMOND COMMUNITY COLLEGE              ,NC,28345-4522,Public       ,262,638,900,524,1088,1612
00575400,ROWAN-CABARRUS COMMUNITY COLLEGE        ,NC,28146-8357,Public       ,709,1538,2247,1436,2828,4264
00647700,CABARRUS COLLEGE OF HEALTH SCIENCES     ,NC,28025-0000,Private      ,114,251,365,305,569,874
00647800,MERCY HOSP SCH OF NURSING               ,NC,28207-0000,Public       ,34,140,174,91,318,409
00648300,WATTS SCHOOL OF NURSING                 ,NC,27704-0000,Private      ,26,114,140,67,234,301
00679900,CRAVEN COMMUNITY COLLEGE                ,NC,28562-0000,Public       ,328,1046,1374,683,1984,2667
00703100,PAMLICO COMMUNITY COLLEGE               ,NC,28529-0000,Public       ,16,94,110,40,193,233
00764000,FAYETTEVILLE TECHNICAL CMTY COLLEGE     ,NC,28303-0236,Public       ,1281,4530,5811,2549,8723,11272
00768700,JAMES SPRUNT COMMUNITY COLLEGE          ,NC,28349-0398,Public       ,143,334,477,303,651,954
00781400,BROOKSTONE COLLEGE OF BUSINESS          ,NC,28262-1294,Proprietary  ,26,131,157,64,280,344
00781401,BROOKSTONE COLLEGE OF BUSINESS          ,NC,27409-0000,Proprietary  ,12,74,86,33,174,207
00789200,SAMPSON COMMUNITY COLLEGE               ,NC,28328-0000,Public       ,213,377,590,417,733,1150
00798500,SOUTH PIEDMONT COMMUNITY COLLEGE        ,NC,28135-9703,Public       ,254,491,745,536,983,1519
00798600,HALIFAX COMMUNITY COLLEGE               ,NC,27890-0089,Public       ,159,279,438,344,552,896
00798700,BLADEN COMMUNITY COLLEGE                ,NC,28332-0266,Public       ,160,379,539,293,701,994
00798800,MARTIN COMMUNITY COLLEGE                ,NC,27892-8307,Public       ,79,207,286,169,358,527
00808100,CARTERET COMMUNITY COLLEGE              ,NC,28557-2989,Public       ,178,455,633,406,913,1319
00808200,CLEVELAND COMMUNITY COLLEGE             ,NC,28150-0000,Public       ,281,664,945,587,1254,1841
00808300,HAYWOOD COMMUNITY COLLEGE               ,NC,28721-0000,Public       ,175,418,593,361,824,1185
00808500,MCDOWELL TECHNICAL COMMUNITY CLG        ,NC,28752-8728,Public       ,99,215,314,200,392,592
00808700,MONTGOMERY COMMUNITY COLLEGE            ,NC,27371-0787,Public       ,100,220,320,206,405,611
00846600,SOUTHWESTERN COMMUNITY COLLEGE          ,NC,28779-8581,Public       ,331,525,856,675,1053,1728
00855700,NASH COMMUNITY COLLEGE                  ,NC,27804-0488,Public       ,435,972,1407,912,1902,2814
00855800,BEAUFORT COUNTY COMMUNITY COLLEGE       ,NC,27889-7889,Public       ,224,544,768,466,1056,1522
00861200,ROBESON COMMUNITY COLLEGE               ,NC,28359-2151,Public       ,394,825,1219,719,1496,2215
00861300,ROANOKE-CHOWAN COMMUNITY COLLEGE        ,NC,27910-9522,Public       ,82,203,285,191,362,553
00885500,EDGECOMBE COMMUNITY COLLEGE             ,NC,27886-9399,Public       ,222,1016,1238,449,1870,2319
00933600,JOHNSTON COMMUNITY COLLEGE              ,NC,27577-0000,Public       ,587,1045,1632,1220,1970,3190
00943000,TRI-COUNTY COMMUNITY COLLEGE            ,NC,28906-7919,Public       ,87,230,317,199,391,590
00964600,PIEDMONT COMMUNITY COLLEGE              ,NC,27573-1197,Public       ,161,297,458,311,541,852
00968400,BLUE RIDGE COMMUNITY COLLEGE            ,NC,28731-9624,Public       ,230,462,692,478,885,1363
00974701,GORDON-CONWELL THEO SEM - CHARLOTTE     ,NC,28273-0000,Private      ,1,83,84,5,154,159
00990300,VANCE-GRANVILLE CMTY COLLEGE            ,NC,27536-0917,Public       ,314,780,1094,666,1435,2101
01019804,ECPI UNIVERSITY - GREENSBORO            ,NC,27409-9048,Proprietary  ,58,250,308,170,575,745
01019805,ECPI UNIVERSITY - CHARLOTTE             ,NC,28208-5886,Proprietary  ,96,559,655,224,1106,1330
01019810,ECPI UNIVERSITY - RALEIGH               ,NC,27613-7387,Proprietary  ,129,502,631,222,854,1076
01019812,ECPI UNIVERSITY - CONCORD               ,NC,28262-0000,Proprietary  ,33,164,197,81,325,406
01026400,SOUTH COLLEGE                           ,NC,28803-3152,Proprietary  ,54,255,309,104,411,515
01119400,STANLY COMMUNITY COLLEGE                ,NC,28001-7458,Public       ,244,661,905,544,1326,1870
01119700,MAYLAND COMMUNITY COLLEGE               ,NC,28777-2777,Public       ,132,153,285,269,281,550
01179900,PAUL MITCHELL THE SCHOOL FAYETTEVILLE   ,NC,28303-5364,Proprietary  ,37,149,186,72,288,360
01192600,LEON'S BEAUTY SCHOOL                    ,NC,27403-2812,Proprietary  ,37,107,144,92,194,286
01303918,SOUTH UNIVERSITY - THE ART INSTITUTE OF ,NC,28217-4536,Proprietary  ,357,347,704,840,686,1526
02056500,MITCHELL'S HAIR STYLING ACADEMY         ,NC,27893-0000,Proprietary  ,14,28,42,24,47,71
02056501,MITCHELL'S HAIR STYLING ACADEMY - MITCHE,NC,27606-3326,Proprietary  ,15,61,76,40,124,164
02158414,HARRISON COLLEGE - THE CHEF'S ACADEMY - ,NC,27560-0000,Proprietary  ,45,93,138,97,181,278
02170700,BRUNSWICK COMMUNITY COLLEGE             ,NC,28422-0000,Public       ,199,340,539,457,664,1121
02205000,COLLEGE OF WILMINGTON                   ,NC,28403-0000,Proprietary  ,69,189,258,195,346,541
02210400,FAYETTEVILLE BEAUTY COLLEGE             ,NC,28303-0000,Proprietary  ,22,146,168,51,260,311
02227800,MITCHELL'S HAIR STYLING ACADEMY         ,NC,27534-0000,Proprietary  ,10,18,28,18,47,65
02280900,MID-ATLANTIC CHRISTIAN UNIVERSITY       ,NC,27909-0000,Private      ,61,45,106,166,87,253
02326203,KAPLAN CAREER INSTITUTE - KAPLAN COLLEGE,NC,28212-6830,Proprietary  ,59,385,444,134,850,984
02560600,PINNACLE INSTITUTE OF COSMETOLOGY       ,NC,28115-8020,Proprietary  ,10,19,29,21,49,70
02614201,MILLER-MOTTE BUSINESS COLLEGE           ,NC,28403-0000,Proprietary  ,138,1503,1641,245,2755,3000
02614205,MILLER - MOTTE TECHNICAL COLLEGE - MILLE,NC,27834-5052,Proprietary  ,56,282,338,110,510,620
03009500,WINSTON-SALEM BARBER SCHOOL             ,NC,27107-0000,Proprietary  ,12,33,45,45,62,107
03064400,REGENCY BEAUTY INSTITUTE                ,NC,27127-0000,Proprietary  ,34,102,136,66,176,242
03089300,HERITAGE BIBLE COLLEGE                  ,NC,28335-0000,Private      ,8,32,40,15,54,69
03104200,CAROLINAS COLLEGE OF HEALTH SCIENCE     ,NC,28232-2861,Public       ,129,404,533,377,906,1283
03109000,LIVING ARTS COLLEGE                     ,NC,27614-7076,Proprietary  ,117,200,317,296,364,660
03361300,MEDICAL ARTS MASSAGE SCHOOL             ,NC,27616-6453,Proprietary  ,15,124,139,29,213,242
03513400,APEX SCHOOL OF THEOLOGY                 ,NC,27703-8024,Private      ,5,490,495,11,776,787
03555300,SOUTHEASTERN INSTITUTE                  ,NC,28217-0000,Proprietary  ,29,161,190,53,308,361
03570300,CAROLINA CHRISTIAN COLLEGE              ,NC,27105-3241,Private      ,7,46,53,26,83,109
03663300,HOOD THEOLOGICAL SEMINARY               ,NC,28144-5768,Private      ,1,61,62,3,102,105
03748500,DURHAM BEAUTY ACADEMY                   ,NC,27707-3569,Proprietary  ,14,53,67,37,85,122
03777300,PAUL MITCHELL THE SCHOOL GASTONIA       ,NC,28054-0460,Proprietary  ,74,133,207,134,218,352
03827300,CHARLOTTE CHRISTIAN COLLEGE AND THEOLOGI,NC,28205-1648,Private      ,9,80,89,23,169,192
04073300,JUNG TAO SCHOOL OF CLASSICAL CHINESE MED,NC,28679-9657,Private      ,0,30,30,0,47,47
04101300,CAROLINA SCHOOL OF BROADCASTING         ,NC,28214-8085,Proprietary  ,31,91,122,84,199,283
04115700,REGINA'S COLLEGE OF BEAUTY              ,NC,28110-2831,Proprietary  ,21,57,78,26,86,112
04120300,HEALTH AND STYLE INSTITUTE              ,NC,27265-3114,Proprietary  ,40,129,169,65,196,261
04129400,CENTER FOR MASSAGE & NATURAL HEALTH     ,NC,28787-8331,Proprietary  ,8,21,29,12,50,62
04140700,AVEDA INSTITUTE CHAPEL HILL             ,NC,27516-2559,Proprietary  ,71,102,173,132,179,311
04143500,CHARLOTTE SCHOOL OF LAW                 ,NC,28208-2816,Proprietary  ,19,502,521,68,1352,1420
04146400,DAOIST TRADITIONS COLLEGE OF CHINESE MED,NC,28801-1060,Proprietary  ,8,33,41,9,58,67
04149300,PARK WEST BARBER SCHOOL                 ,NC,27701-4022,Proprietary  ,51,236,287,101,460,561
04154200,CAROLINA COLLEGE OF BIBLICAL STUDIES    ,NC,29303-5157,Private      ,7,70,77,13,172,185
04172800,BODY THERAPY INSTITUTE                  ,NC,27344-6728,Proprietary  ,6,23,29,12,32,44
04173000,SHEPHERDS THEOLOGICAL SEMINARY          ,NC,27518-9316,Private      ,0,9,9,1,17,18
04173700,GRACE COLLEGE OF DIVINITY               ,NC,28314-2343,Private      ,15,56,71,26,104,130
04178100,CAROLINA COLLEGE OF HAIR DESIGN         ,NC,28802-1232,Proprietary  ,11,43,54,22,81,103
04204700,PAUL MITCHELL THE SCHOOL RALEIGH        ,NC,27612-7358,Proprietary  ,38,77,115,79,142,221
04206500,MYCOMPUTERCAREER.COM                    ,NC,27606-3365,Proprietary  ,30,324,354,50,431,481
04214600,GRACE COLLEGE OF BARBERING              ,NC,28513-7178,Private      ,4,15,19,7,22,29
04219100,ALEXANDER PAUL INSTITUTE OF HAIR DESIGN ,NC,27858-3344,Proprietary  ,17,27,44,27,46,73
04227600,SHERRILL'S UNIVERSITY OF BARBER & COSMET,NC,27610-2431,Proprietary  ,8,61,69,32,129,161
04228400,BEYOND MEASURE BARBERING INSTITUTE      ,NC,27302-2323,Proprietary  ,5,26,31,9,40,49
00298800,BISMARCK STATE COLLEGE                  ,ND,58501-1299,Public       ,720,462,1182,1314,832,2146
00298900,DICKINSON STATE UNIVERSITY              ,ND,58601-4896,Public       ,290,192,482,655,356,1011
00299000,UNIVERSITY OF JAMESTOWN                 ,ND,58405-3401,Private      ,213,74,287,896,147,1043
00299100,LAKE REGION STATE COLLEGE               ,ND,58301-1598,Public       ,173,149,322,301,264,565
00299200,UNIVERSITY OF MARY                      ,ND,58504-9652,Private      ,545,425,970,1512,845,2357
00299300,MAYVILLE STATE UNIVERSITY               ,ND,58257-1299,Public       ,245,96,341,588,233,821
00299400,MINOT STATE UNIVERSITY                  ,ND,58707-0001,Public       ,530,451,981,1241,978,2219
00299500,DAKOTA COLLEGE AT BOTTINEAU             ,ND,58318-1159,Public       ,134,89,223,258,149,407
00299600,NORTH DAKOTA STATE CLG OF SCIENCE       ,ND,58076-0002,Public       ,630,220,850,1241,395,1636
00299700,NORTH DAKOTA STATE UNIV - FARGO         ,ND,58102-0000,Public       ,3406,1097,4503,8786,2245,11031
00299702,NORTH DAKOTA STATE UNIV NURSING         ,ND,58501-4425,Public       ,0,0,0,3,4,7
00300500,UNIVERSITY OF NORTH DAKOTA              ,ND,58202-8193,Public       ,2955,2019,4974,7142,4049,11191
00300700,WILLISTON STATE COLLEGE                 ,ND,58802-1326,Public       ,99,145,244,234,282,516
00300800,VALLEY CITY STATE UNIVERSITY            ,ND,58072-0000,Public       ,295,129,424,662,239,901
00775600,JOSEF'S SCHOOL OF HAIR DESIGN INC       ,ND,58102-4977,Proprietary  ,30,24,54,41,39,80
00869408,RASMUSSEN COLLEGE - FARGO               ,ND,58103-7196,Proprietary  ,49,196,245,77,346,423
00869415,RASMUSSEN COLLEGE - BISMARCK            ,ND,58503-0000,Proprietary  ,13,48,61,22,144,166
01040600,JOSEF'S SCHOOL OF HAIR DESIGN           ,ND,58201-6394,Proprietary  ,16,29,45,28,56,84
01205900,TRINITY BIBLE COLLEGE                   ,ND,58436-7150,Private      ,52,25,77,192,62,254
01229500,JZ TREND ACADEMY PAUL MITCHELL PARTNER S,ND,58501-0000,Proprietary  ,10,17,27,14,27,41
02188200,SITTING BULL COLLEGE                    ,ND,58538-9701,Public       ,32,93,125,42,154,196
02236500,LITTLE HOOP COMMUNITY COLLEGE           ,ND,58335-0000,Public       ,10,33,43,17,69,86
02242900,UNITED TRIBES TECHNICAL COLLEGE         ,ND,58504-0000,Private      ,64,180,244,137,354,491
02298200,HEADQUARTERS ACADEMY OF HAIR DESIGN     ,ND,58701-0000,Proprietary  ,4,23,27,14,40,54
02301100,TURTLE MTN CMNTY COLG-FIN AID OFC       ,ND,58316-0000,Private      ,79,121,200,141,218,359
02553700,FORT BERTHOLD COMMUNITY COLLEGE         ,ND,58763-0000,Public       ,11,25,36,26,60,86
03087200,MOLER BARBER CLG OF HAIRSTYLING         ,ND,58103-0000,Proprietary  ,1,10,11,3,16,19
04031300,SALON PROFESSIONAL ACADEMY (THE)        ,ND,58103-3337,Proprietary  ,34,19,53,53,44,97
04139400,HAIR ACADEMY (THE)                      ,ND,58501-4929,Proprietary  ,20,15,35,35,23,58
04223500,LYNNES WELDING TRAINING                 ,ND,58102-4018,Proprietary  ,13,18,31,20,36,56
00301005,ANTIOCH UNIV/SEATTLE                    ,WA,98121-0000,Private      ,13,369,382,78,970,1048
00376900,BELLEVUE COLLEGE                        ,WA,98007-6484,Public       ,965,1792,2757,4587,5623,10210
00377000,BIG BEND COMMUNITY COLLEGE              ,WA,98837-3299,Public       ,187,422,609,1017,1216,2233
00377100,CENTRAL WASHINGTON UNIVERSITY           ,WA,98926-7495,Public       ,1386,1292,2678,12132,5554,17686
00377200,CENTRALIA COLLEGE                       ,WA,98531-4099,Public       ,233,501,734,1074,1585,2659
00377300,CLARK COLLEGE                           ,WA,98663-3598,Public       ,1071,2019,3090,4245,6074,10319
00377400,COLUMBIA BASIN COLLEGE                  ,WA,99301-3379,Public       ,631,1035,1666,2983,3344,6327
00377500,EASTERN WASHINGTON UNIVERSITY           ,WA,99004-2447,Public       ,957,1080,2037,12947,6604,19551
00377600,EVERETT COMMUNITY COLLEGE               ,WA,98201-1352,Public       ,720,1517,2237,3309,5077,8386
00377700,HERITAGE UNIVERSITY                     ,WA,98948-9562,Private      ,97,356,453,727,1217,1944
00377800,GONZAGA UNIVERSITY                      ,WA,99258-0083,Private      ,389,823,1212,7824,2852,10676
00377900,GRAYS HARBOR COLLEGE                    ,WA,98520-7599,Public       ,167,396,563,679,1206,1885
00378000,GREEN RIVER COMMUNITY COLLEGE           ,WA,98092-3622,Public       ,725,1286,2011,2936,3870,6806
00378100,HIGHLINE COMMUNITY COLLEGE              ,WA,98198-9800,Public       ,828,1759,2587,3177,4701,7878
00378200,LOWER COLUMBIA COLLEGE                  ,WA,98632-0310,Public       ,249,785,1034,1020,2219,3239
00378300,NORTHWEST UNIVERSITY                    ,WA,98083-0000,Private      ,211,405,616,1383,997,2380
00378400,OLYMPIC COLLEGE                         ,WA,98337-1600,Public       ,517,1423,1940,1751,4076,5827
00378500,PACIFIC LUTHERAN UNIVERSITY             ,WA,98447-0003,Private      ,409,500,909,4645,2089,6734
00378600,PENINSULA COLLEGE                       ,WA,98362-6660,Public       ,148,455,603,574,1309,1883
00378700,SEATTLE CENTRAL COMMUNITY COLLEGE       ,WA,98122-2413,Public       ,596,1874,2470,2973,5535,8508
00378703,SEATTLE VOCATIONAL INSTITUTE            ,WA,98144-0000,Public       ,23,181,204,107,430,537
00378800,SEATTLE PACIFIC UNIVERSITY              ,WA,98119-1997,Private      ,918,771,1689,7622,2657,10279
00379000,SEATTLE UNIVERSITY                      ,WA,98122-1090,Private      ,676,1223,1899,9516,5810,15326
00379100,SHORELINE COMMUNITY COLLEGE             ,WA,98133-5696,Public       ,533,1151,1684,2410,3742,6152
00379200,SKAGIT VALLEY COLLEGE                   ,WA,98273-5899,Public       ,375,846,1221,1576,2514,4090
00379300,SPOKANE COMMUNITY COLLEGE               ,WA,99207-5399,Public       ,763,2096,2859,3681,7000,10681
00379400,ST MARTIN'S UNIVERSITY                  ,WA,98503-7500,Private      ,218,325,543,1412,1106,2518
00379600,TACOMA COMMUNITY COLLEGE                ,WA,98466-6100,Public       ,922,2556,3478,3807,7809,11616
00379700,UNIVERSITY OF PUGET SOUND               ,WA,98416-1039,Private      ,359,400,759,5338,1579,6917
00379800,UNIVERSITY OF WASHINGTON                ,WA,98195-1122,Public       ,2324,4042,6366,41150,26475,67625
00379900,WALLA WALLA UNIVERSITY                  ,WA,99324-1198,Private      ,424,183,607,1712,616,2328
00380000,WASHINGTON STATE UNIVERSITY             ,WA,99164-1035,Public       ,1856,2209,4065,29291,12698,41989
00380100,WENATCHEE VALLEY COLLEGE                ,WA,98801-1799,Public       ,296,532,828,1532,1652,3184
00380200,WESTERN WASHINGTON UNIVERSITY           ,WA,98225-5946,Public       ,1370,878,2248,17801,4765,22566
00380300,WHITMAN COLLEGE                         ,WA,99362-2067,Private      ,270,34,304,2841,140,2981
00380400,WHITWORTH UNIVERSITY                    ,WA,99251-0001,Private      ,482,402,884,4286,1288,5574
00380500,YAKIMA VALLEY COMMUNITY COLLEGE         ,WA,98907-2520,Public       ,419,936,1355,2573,3558,6131
00499900,BELLINGHAM TECHNICAL COLLEGE            ,WA,98225-0000,Public       ,258,791,1049,1024,2156,3180
00500000,PIERCE COLLEGE                          ,WA,98498-1919,Public       ,794,2229,3023,3062,6144,9206
00500100,EDMONDS COMMUNITY COLLEGE               ,WA,98036-5999,Public       ,557,1168,1725,2318,3645,5963
00500600,WALLA WALLA COMMUNITY COLLEGE           ,WA,99362-9267,Public       ,260,503,763,1703,1898,3601
00530600,BATES TECHNICAL COLLEGE                 ,WA,98405-0000,Public       ,257,1026,1283,926,2720,3646
00537200,SOUTH PUGET SOUND COMMUNITY COLLEGE     ,WA,98512-6292,Public       ,544,1200,1744,1980,3612,5592
00537300,LAKE WASHINGTON TECHNICAL COLLEGE       ,WA,98034-8505,Public       ,205,673,878,711,1831,2542
00575200,CLOVER PARK TECHNICAL COLLEGE           ,WA,98499-0000,Public       ,393,1395,1788,1317,4283,5600
00815500,EVERGREEN STATE COLLEGE (THE)           ,WA,98505-0002,Public       ,425,755,1180,3726,3723,7449
00907901,EVEREST COLLEGE                         ,WA,98684-6950,Proprietary  ,60,159,219,157,321,478
00938700,PERRY TECHNICAL INSTITUTE               ,WA,98903-1239,Private      ,217,310,527,733,827,1560
00954400,SPOKANE FALLS COMMUNITY COLLEGE         ,WA,99224-5204,Public       ,818,1582,2400,4010,4966,8976
00970400,NORTH SEATTLE COMMUNITY COLLEGE         ,WA,98103-3599,Public       ,363,1375,1738,1704,4142,5846
00970600,SOUTH SEATTLE COMMUNITY COLLEGE         ,WA,98106-1499,Public       ,463,1253,1716,2150,3503,5653
00973900,GLEN DOW ACAD OF HAIR DESIGN            ,WA,99201-0209,Proprietary  ,22,53,75,93,162,255
01036400,WHATCOM COMMUNITY COLLEGE               ,WA,98226-8003,Public       ,386,705,1091,1948,2394,4342
01043400,RENTON TECHNICAL COLLEGE                ,WA,98056-0000,Public       ,314,952,1266,1034,2482,3516
01148100,DIVERS INSTITUTE OF TECHNOLOGY          ,WA,98107-0000,Proprietary  ,47,169,216,152,382,534
01231500,CORNISH COLLEGE OF THE ARTS             ,WA,98121-4604,Private      ,131,114,245,1394,446,1840
01249600,TONI & GUY HAIRDRESSING ACADEMY         ,WA,98133-5615,Proprietary  ,16,40,56,30,54,84
01302200,CITY UNIVERSITY OF SEATTLE              ,WA,98005-0000,Private      ,70,632,702,292,1588,1880
01309400,BELLINGHAM BEAUTY SCHOOL                ,WA,98226-5515,Proprietary  ,0,0,0,15,11,26
02105300,EVERGREEN BEAUTY AND BARBER COLLEGE     ,WA,98007-3722,Proprietary  ,17,66,83,53,127,180
02106700,TRINITY LUTHERAN COLLEGE                ,WA,98201-3569,Private      ,45,29,74,324,109,433
02180000,NORTHWEST INDIAN COLLEGE                ,WA,98226-9278,Public       ,45,211,256,129,552,681
02184200,PAROBA COLLEGE OF COSMETOLOGY           ,WA,98208-0000,Proprietary  ,14,61,75,37,113,150
02202200,STYLEMASTERS COLLEGE OF HAIR DESIGN     ,WA,98632-0000,Proprietary  ,6,41,47,22,92,114
02203300,GENE JUAREZ BEAUTY SCHOOLS              ,WA,98043-5427,Proprietary  ,98,155,253,226,294,520
02222900,INTERNATIONAL AIR & HOSPITALITY ACADEMY ,WA,98661-4835,Proprietary  ,71,198,269,206,432,638
02236800,PROFESSIONAL BEAUTY SCHOOL              ,WA,98902-0000,Proprietary  ,14,39,53,45,92,137
02242500,BASTYR UNIVERSITY                       ,WA,98028-0000,Private      ,40,591,631,214,1648,1862
02291300,ART INSTITUTE OF SEATTLE                ,WA,98121-1622,Proprietary  ,326,480,806,1523,1371,2894
02300100,EVEREST COLLEGE                         ,WA,98367-1835,Proprietary  ,29,106,135,78,252,330
02300103,EVEREST COLLEGE - EVERETT               ,WA,98208-2610,Proprietary  ,43,198,241,130,417,547
02300104,EVEREST COLLEGE - TACOMA                ,WA,98402-3004,Proprietary  ,87,423,510,278,920,1198
02326500,INTERFACE COLLEGE                       ,WA,99201-4326,Proprietary  ,11,40,51,39,130,169
02331400,NORTHWEST HAIR ACADEMY                  ,WA,98273-0000,Proprietary  ,7,31,38,22,57,79
02331402,NORTHWEST HAIR ACADEMY - EVERETT        ,WA,98204-0000,Proprietary  ,7,27,34,24,54,78
02331404,NORTHWEST HAIR ACADEMY - YAKIMA         ,WA,98901-2305,Proprietary  ,18,39,57,43,83,126
02504900,ACADEMY OF HAIR DESIGN (THE)            ,WA,98801-0000,Proprietary  ,6,19,25,25,59,84
02541900,BJ'S BEAUTY AND BARBER COLLEGE          ,WA,98409-0000,Proprietary  ,9,85,94,47,215,262
02602100,NORTHWEST COLLEGE OF ART & DESIGN       ,WA,98370-8625,Proprietary  ,28,22,50,178,66,244
02606200,EVEREST COLLEGE                         ,WA,98055-2990,Proprietary  ,57,182,239,153,396,549
02617500,EVEREST COLLEGE                         ,WA,98133-9018,Proprietary  ,39,110,149,159,300,459
03031406,INTERNATIONAL ACADEMY OF DESIGN & TECH  ,WA,98188-3319,Proprietary  ,46,107,153,154,280,434
03065000,LUCAS MARC ACADEMY                      ,WA,99352-9700,Proprietary  ,18,51,69,49,103,152
03071800,ITT TECHNICAL INSTITUTE                 ,WA,99216-1589,Proprietary  ,67,457,524,237,828,1065
03071805,ITT TECHNICAL INSTITUTE - SEATTLE       ,WA,98168-3346,Proprietary  ,113,653,766,363,1235,1598
03099000,CORTIVA INSTITUTE - SEATTLE             ,WA,98109-5474,Proprietary  ,33,122,155,71,214,285
03110800,BAKKE GRADUATE UNIVERSITY               ,WA,98104-1222,Private      ,2,20,22,13,55,68
03139500,MONTESSORI SCHOOLS OF WASHINGTON        ,WA,98203-6600,Private      ,1,6,7,4,15,19
03280300,SEATTLE INST OF ORIENTAL MEDICINE       ,WA,98115-0000,Proprietary  ,7,39,46,39,114,153
03283300,NORTHWEST HVAC/R ASSOCIATION & TRAINING ,WA,99207-2125,Private      ,7,31,38,25,80,105
03466400,SEATTLE SCHOOL OF THEOLOGY AND PSYCHOLOG,WA,98121-1177,Private      ,19,147,166,78,359,437
03483500,CASCADIA COMMUNITY COLLEGE              ,WA,98011-9510,Public       ,283,364,647,1241,1094,2335
03490400,EMIL FRIES PIANO HOSPITAL & TRAININ     ,WA,98661-4323,Private      ,1,7,8,4,14,18
03670301,TONI&GUY HAIRDRESSING ACADEMY -         ,WA,98225-4526,Proprietary  ,24,43,67,54,89,143
03689400,FAITH EVANGELICAL COLLEGE & SEMINARY    ,WA,98407-2607,Private      ,6,97,103,19,275,294
03724300,DIGIPEN INSTITUTE OF TECHNOLOGY         ,WA,98052-5170,Proprietary  ,192,126,318,1178,411,1589
03917300,EVERGREEN BEAUTY AND BARBER COLLEGE     ,WA,98208-3759,Proprietary  ,40,163,203,95,270,365
03932500,TOTAL COSMETOLOGY TRAINING CENTER       ,WA,99217-6231,Proprietary  ,12,60,72,43,116,159
04120000,SUNNYSIDE BEAUTY ACADEMY                ,WA,98944-8711,Proprietary  ,2,16,18,7,27,34
04127200,VICTORIA'S ACADEMY OF COSMETOLOGY       ,WA,99336-3826,Proprietary  ,16,50,66,52,113,165
04130500,PACIFIC NORTHWEST UNIV OF HEALTH SCIENCE,WA,98901-1471,Private      ,5,254,259,43,621,664
04130800,CASCADE BEAUTY COLLEGE                  ,WA,98002-5504,Proprietary  ,7,28,35,31,79,110
04132800,INLAND MASSAGE INSTITUTE                ,WA,99218-5016,Proprietary  ,9,34,43,33,96,129
04149400,GARY MANUEL AVEDA INSTITUTE             ,WA,98122-3807,Proprietary  ,56,121,177,140,259,399
04155000,NORTHWEST SCHOOL OF WOODEN BOAT BUILDING,WA,98339-8706,Private      ,4,39,43,11,74,85
04161200,PINCHOT UNIVERSITY                      ,WA,98104-2617,Private      ,3,38,41,13,81,94
04170100,SALON PROFESSIONAL ACADEMY (THE)        ,WA,98409-7360,Proprietary  ,28,94,122,87,218,305
04172900,ACADEMY OF COSMETOLOGY                  ,WA,99354-2651,Proprietary  ,7,11,18,39,55,94
04188900,NORTHWEST INSTITUTE OF LITERARY ARTS    ,WA,98249-0000,Private      ,1,9,10,4,29,33
04191900,PAUL MITCHELL THE SCHOOL SPOKANE        ,WA,99037-5041,Proprietary  ,35,64,99,125,175,300
04223600,ACADEMY OF INTERACTIVE ENTERTAINMENT    ,WA,98109-4623,Private      ,81,74,155,246,189,435
04231000,STUDIO BEAUTY SCHOOL                    ,WA,99205-3357,Proprietary  ,11,31,42,45,76,121
00340100,BROWN UNIVERSITY                        ,RI,02912-9127,Private      ,1098,93,1191,18296,844,19140
00340101,BROWN UNIVERSITY - GRADUATE SCHOOL      ,RI,02912-1827,Private      ,4,139,143,61,1233,1294
00340102,BROWN MEDICAL SCHOOL                    ,RI,02912-0000,Private      ,4,74,78,51,577,628
00340200,BRYANT UNIVERSITY                       ,RI,02917-1284,Private      ,344,103,447,5709,446,6155
00340400,JOHNSON & WALES UNIVERSITY              ,RI,02903-3703,Private      ,2542,1003,3545,17965,4028,21993
00340600,PROVIDENCE COLLEGE                      ,RI,02918-0001,Private      ,796,186,982,8058,762,8820
00340700,RHODE ISLAND COLLEGE                    ,RI,02908-1991,Public       ,591,841,1432,7963,4110,12073
00340800,COMMUNITY COLLEGE OF RI - WARWICK       ,RI,02906-0000,Public       ,1404,2432,3836,7142,8325,15467
00340900,RHODE ISLAND SCHOOL OF DESIGN           ,RI,02903-2784,Private      ,313,115,428,2612,884,3496
00341000,ROGER WILLIAMS UNIVERSITY               ,RI,02809-2921,Private      ,258,308,566,8647,1387,10034
00341100,SALVE REGINA UNIVERSITY                 ,RI,02840-4192,Private      ,198,129,327,4162,527,4689
00341400,UNIVERSITY OF RHODE ISLAND              ,RI,02881-0000,Public       ,1617,714,2331,22741,3494,26235
00659100,ST. JOSEPH HOSP SCH OF NURSING          ,RI,02904-5199,Private      ,8,65,73,60,252,312
00784500,NEW ENGLAND INSTITUTE OF TECHNOLOGY     ,RI,02886-0000,Private      ,485,640,1125,2224,2200,4424
01246116,LINCOLN TECHNICAL INSTITUTE - LINCOLN   ,RI,02865-4211,Proprietary  ,75,177,252,274,561,835
02531802,PAUL MITCHELL THE SCHOOL-CRANSTON       ,RI,02920-0000,Proprietary  ,28,41,69,69,88,157
02584400,NEW ENGLAND TRACTOR TRAILER TRAINING SCH,RI,02860-1752,Proprietary  ,32,379,411,45,430,475
03080000,NEWPORT SCHOOL OF HAIRDRESSING          ,RI,02860-4038,Proprietary  ,2,11,13,4,26,30
03732300,INTERNATIONAL YACHT RESTORATION SCH     ,RI,02840-6720,Private      ,13,15,28,34,33,67
04141200,TONI & GUY HAIRDRESSING ACADEMY         ,RI,02920-0000,Proprietary  ,38,47,85,76,72,148
04246000,MKG BEAUTY & BUSINESS                   ,RI,02920-4358,Proprietary  ,6,12,18,17,30,47
00294102,LENOIR-RHYNE UNIVERSITY - LUTHERAN THEOL,SC,29203-5863,Private      ,4,35,39,15,69,84
00341700,ALLEN UNIVERSITY                        ,SC,29204-1085,Private      ,345,212,557,758,420,1178
00341800,ANDERSON UNIVERSITY                     ,SC,29621-4035,Private      ,785,448,1233,3316,1053,4369
00341900,CHARLESTON SOUTHERN UNIVERSITY          ,SC,29406-2160,Private      ,1314,937,2251,4416,1962,6378
00342000,BENEDICT COLLEGE                        ,SC,29204-1086,Private      ,1104,611,1715,2905,1272,4177
00342100,BOB JONES UNIVERSITY                    ,SC,29614-1000,Proprietary  ,858,122,980,2329,284,2613
00342200,SOUTHERN WESLEYAN UNIVERSITY            ,SC,29630-1020,Private      ,397,683,1080,889,1141,2030
00342300,THE CITADEL                             ,SC,29409-0002,Public       ,633,389,1022,2720,867,3587
00342400,CLAFLIN UNIVERSITY                      ,SC,29115-4498,Private      ,1078,496,1574,2507,873,3380
00342500,CLEMSON UNIVERSITY                      ,SC,29634-0001,Public       ,4096,1410,5506,20535,3268,23803
00342600,UNIV OF SC AT SUMTER                    ,SC,29150-2498,Public       ,263,245,508,638,462,1100
00342700,COKER COLLEGE                           ,SC,29550-3797,Private      ,420,370,790,1102,690,1792
00342800,COLLEGE OF CHARLESTON                   ,SC,29424-0100,Public       ,2345,1023,3368,11254,2377,13631
00342900,COLUMBIA INTERNATIONAL UNIVERSITY       ,SC,29203-1599,Private      ,216,230,446,554,441,995
00343000,COLUMBIA COLLEGE                        ,SC,29203-5998,Private      ,421,790,1211,1077,1487,2564
00343100,CONVERSE COLLEGE                        ,SC,29302-1931,Private      ,367,253,620,1134,492,1626
00343200,ERSKINE COLLEGE                         ,SC,29639-0000,Private      ,246,17,263,773,44,817
00343201,ERSKINE THEOLOGICAL SEMINARY            ,SC,29639-0000,Private      ,0,47,47,4,71,75
00343400,FURMAN UNIVERSITY                       ,SC,29613-5253,Private      ,513,169,682,3539,349,3888
00343500,LANDER UNIVERSITY                       ,SC,29649-2099,Public       ,671,223,894,3342,635,3977
00343600,LIMESTONE COLLEGE                       ,SC,29340-3799,Private      ,806,1211,2017,2013,2278,4291
00343800,MEDICAL UNIV OF SOUTH CAROLINA - FA     ,SC,29425-1760,Public       ,122,1036,1158,343,3099,3442
00343900,MORRIS COLLEGE                          ,SC,29150-3599,Private      ,431,191,622,888,374,1262
00344000,NEWBERRY COLLEGE                        ,SC,29108-2197,Private      ,392,97,489,1725,265,1990
00344100,NORTH GREENVILLE COLLEGE                ,SC,29688-1892,Private      ,1103,315,1418,2489,518,3007
00344500,PRESBYTERIAN COLLEGE                    ,SC,29325-2503,Private      ,369,170,539,1595,362,1957
00344600,SOUTH CAROLINA STATE UNIVERSITY         ,SC,29117-4427,Public       ,1490,807,2297,3455,1428,4883
00344700,SPARTANBURG METHODIST COLLEGE           ,SC,29301-5899,Private      ,585,91,676,1221,184,1405
00344800,UNIVERSITY OF SOUTH CAROLINA            ,SC,29208-3999,Public       ,6120,4263,10383,28544,10459,39003
00344900,UNIVERSITY OF SOUTH CAROLINA AIKEN      ,SC,29801-6399,Public       ,1075,613,1688,3171,1264,4435
00345000,UNIV OF SC AT BEAUFORT                  ,SC,29902-0000,Public       ,715,409,1124,2094,935,3029
00345100,COASTAL CAROLINA UNIVERSITY             ,SC,29528-0000,Public       ,3014,926,3940,13782,2405,16187
00345300,UNIV OF SC AT LANCASTER                 ,SC,29721-0889,Public       ,356,256,612,830,481,1311
00345400,UNIV OF SC SYSTEM SALKEHATCHIE          ,SC,29810-0617,Public       ,239,166,405,507,349,856
00345500,VOORHEES COLLEGE                        ,SC,29042-0000,Private      ,314,107,421,625,210,835
00345600,WINTHROP UNIVERSITY                     ,SC,29733-0001,Public       ,1611,763,2374,6111,1735,7846
00345700,WOFFORD COLLEGE                         ,SC,29303-3663,Private      ,331,70,401,2601,166,2767
00399000,FLORENCE-DARLINGTON TECH COLLEGE        ,SC,29501-0548,Public       ,1095,1921,3016,2056,3531,5587
00399100,GREENVILLE TECHNICAL COLLEGE            ,SC,29607-2439,Public       ,2799,3595,6394,5110,6477,11587
00399200,PIEDMONT TECHNICAL COLLEGE              ,SC,29648-1467,Public       ,902,1663,2565,1530,2799,4329
00399300,MIDLANDS TECHNICAL COLLEGE              ,SC,29202-0000,Public       ,2890,3930,6820,5337,7287,12624
00399400,SPARTANBURG COMMUNITY COLLEGE           ,SC,29305-0000,Public       ,1306,1492,2798,2291,2625,4916
00399500,CENTRAL CAROLINA TECHNICAL COLLEGE      ,SC,29150-2499,Public       ,576,1177,1753,1123,2175,3298
00399600,YORK TECHNICAL COLLEGE                  ,SC,29730-3395,Public       ,1115,1506,2621,2001,2734,4735
00492000,TRIDENT TECHNICAL COLLEGE               ,SC,29423-8067,Public       ,1991,3777,5768,4049,7863,11912
00492300,CLINTON JR COLLEGE                      ,SC,29730-5152,Private      ,48,61,109,87,98,185
00492400,FORREST COLLEGE                         ,SC,29624-2405,Proprietary  ,21,98,119,28,143,171
00492500,HORRY-GEORGETOWN TECH COLLEGE           ,SC,29526-9521,Public       ,1386,1865,3251,2910,4232,7142
00492600,TRI-COUNTY TECHNICAL COLLEGE            ,SC,29670-9133,Public       ,1619,1121,2740,3412,2163,5575
00492700,UNIV OF SC AT UNION                     ,SC,29379-0729,Public       ,94,94,188,193,193,386
00499204,MILLER-MOTTE TECHNICAL COLLEGE - CONWAY ,SC,29526-9508,Proprietary  ,81,353,434,145,612,757
00536300,DENMARK TECHNICAL COLLEGE               ,SC,29042-0000,Public       ,171,636,807,281,914,1195
00681500,ORANGEBURG-CALHOUN TECHNICAL COLG       ,SC,29118-8299,Public       ,577,896,1473,1055,1518,2573
00695100,UNIVERSITY OF SOUTH CAROLINA UPSTATE    ,SC,29303-9972,Public       ,2014,1182,3196,5356,2405,7761
00760200,NORTHEASTERN TECHNICAL COLLEGE          ,SC,29520-7015,Public       ,262,376,638,428,647,1075
00922600,FRANCIS MARION UNIVERSITY               ,SC,29501-0000,Public       ,1403,733,2136,3914,1440,5354
00932200,WILLIAMSBURG TECHNICAL COLLEGE          ,SC,29556-4197,Public       ,82,158,240,158,304,462
00991000,TECHNICAL COLLEGE OF THE LOWCOUNTRY     ,SC,29902-5441,Public       ,383,896,1279,763,1752,2515
00991100,UNIV OF SC-REGIONAL CAMPUSES ADMIN      ,SC,29208-0001,Public       ,60,103,163,193,214,407
01005600,AIKEN TECHNICAL COLLEGE                 ,SC,29802-0696,Public       ,642,1146,1788,1158,1994,3152
01019806,ECPI UNIVERSITY - GREENVILLE            ,SC,29615-4232,Proprietary  ,50,293,343,75,480,555
01019809,ECPI UNIVERSITY - CHARLESTON            ,SC,29420-4264,Proprietary  ,35,217,252,64,411,475
01019811,ECPI UNIVERSITY - COLUMBIA              ,SC,29210-6467,Proprietary  ,19,159,178,39,298,337
01179901,PAUL MITCHELL THE SCHOOL COLUMBIA       ,SC,29201-3126,Proprietary  ,61,107,168,108,191,299
01179902,PAUL MITCHELL THE SCHOOL CHARLESTON     ,SC,29418-6993,Proprietary  ,57,74,131,85,125,210
01179903,PAUL MITCHELL THE SCHOOL FAYETTEVILLE - ,SC,29607-0000,Proprietary  ,39,52,91,72,102,174
01209200,KENNETH SHULER SCHOOL OF COSMETOLOGY    ,SC,29732-2169,Proprietary  ,65,171,236,97,273,370
01303907,SOUTH UNIVERSITY                        ,SC,29203-6400,Proprietary  ,126,842,968,296,1655,1951
02063700,SHERMAN CLG STRAIGHT CHIROPRACTIC       ,SC,29316-0000,Private      ,4,251,255,15,435,450
02338600,CHARZANNE BEAUTY COLLEGE                ,SC,29649-0000,Proprietary  ,7,20,27,12,36,48
02341100,KENNETH SHULER SCHOOL OF COSMETOLOGY & N,SC,29210-0000,Proprietary  ,100,279,379,150,423,573
02356600,CHARLESTON COSMETOLOGY INSTITUTE        ,SC,29420-0000,Proprietary  ,22,43,65,34,70,104
02552400,ACADEMY OF HAIR TECHNOLOGY              ,SC,29615-2363,Proprietary  ,19,57,76,31,105,136
02567600,SUMTER BEAUTY COLLEGE                   ,SC,29150-0000,Proprietary  ,10,30,40,16,58,74
02614202,MILLER - MOTTE TECHNICAL COLLEGE - NORTH,SC,29406-9239,Proprietary  ,57,351,408,106,580,686
03010614,VIRGINIA COLLEGE - GOLF ACADEMY OF AMERI,SC,29579-0000,Proprietary  ,32,44,76,69,95,164
03010617,VIRGINIA COLLEGE - GREENVILLE           ,SC,29607-7200,Proprietary  ,47,199,246,92,410,502
03010620,VIRGINIA COLLEGE - CHARLESTON           ,SC,29406-4999,Proprietary  ,50,137,187,92,339,431
03010621,VIRGINIA COLLEGE - COLUMBIA             ,SC,29223-7527,Proprietary  ,54,244,298,95,499,594
03052300,KENNETH SHULER SCH COSM & HAIR DESG     ,SC,29841-2013,Proprietary  ,73,193,266,98,260,358
03293300,STRAND COLLEGE OF HAIR DESIGN           ,SC,29572-4310,Proprietary  ,11,33,44,19,54,73
03304300,CENTURA COLLEGE                         ,SC,29406-9235,Proprietary  ,30,168,198,52,285,337
03555400,SOUTHEASTERN INSTITUTE                  ,SC,29406-0000,Proprietary  ,26,71,97,41,149,190
03709301,EDWARD VIA VIRGINIA COLLEGE OF OSTEOPATH,SC,29303-3639,Private      ,6,409,415,10,667,677
03746300,LEGRAND INSTITUTE OF COSMETOLOGY        ,SC,29020-0000,Proprietary  ,6,7,13,10,12,22
03746400,SOUTHEASTERN INSTITUTE                  ,SC,29210-0000,Proprietary  ,26,116,142,40,194,234
03768400,STYLETRENDS BARBER AND HAIRSTYLING ACADE,SC,29730-4511,Proprietary  ,4,17,21,6,23,29
04083300,MARION COUNTY TECHNICAL EDUCATION CENTER,SC,29571-0000,Public       ,9,60,69,23,113,136
04096300,CHARLESTON SCHOOL OF LAW                ,SC,29402-0535,Proprietary  ,2,225,227,23,595,618
04158100,AIKEN SCHOOL OF COSMETOLOGY             ,SC,29801-4554,Proprietary  ,12,38,50,30,67,97
04166900,COSMETIC ARTS INSTITUTE                 ,SC,29488-4216,Proprietary  ,5,11,16,15,18,33
04172600,SALON 496 BARBER ACADEMY                ,SC,29607-2548,Proprietary  ,10,30,40,13,55,68
04192600,PALMETTO BEAUTY SCHOOL                  ,SC,29307-1424,Proprietary  ,12,31,43,19,45,64
04202900,JOLEI'S HAIR INSTITUTE                  ,SC,29114-9337,Proprietary  ,0,1,1,0,9,9
00345800,AUGUSTANA COLLEGE                       ,SD,57197-0001,Private      ,386,92,478,1335,193,1528
00345900,BLACK HILLS STATE UNIVERSITY            ,SD,57799-9670,Public       ,564,489,1053,1718,1055,2773
00346100,DAKOTA WESLEYAN UNIVERSITY              ,SD,57301-4398,Private      ,192,116,308,657,255,912
00346300,DAKOTA STATE UNIVERSITY                 ,SD,57042-1799,Public       ,375,349,724,1141,711,1852
00346500,MOUNT MARTY COLLEGE                     ,SD,57078-3724,Private      ,103,135,238,418,240,658
00346600,NORTHERN STATE UNIVERSITY               ,SD,57401-7198,Public       ,229,179,408,1325,530,1855
00346700,PRESENTATION COLLEGE                    ,SD,57401-1299,Private      ,123,172,295,429,398,827
00346900,UNIVERSITY OF SIOUX FALLS               ,SD,57105-1699,Private      ,205,161,366,1255,421,1676
00347000,SOUTH DAKOTA SCH OF MINES & TECH        ,SD,57701-3995,Public       ,487,215,702,1840,438,2278
00347100,SOUTH DAKOTA STATE UNIVERSITY           ,SD,57007-2298,Public       ,2281,1014,3295,6880,2025,8905
00347400,UNIVERSITY OF SOUTH DAKOTA              ,SD,57069-2390,Public       ,1439,1399,2838,4538,2993,7531
00405600,SIOUX FALLS SEMINARY                    ,SD,57105-2729,Private      ,0,19,19,1,38,39
00405700,NATIONAL AMERICAN UNIVERSITY            ,SD,57701-3692,Proprietary  ,212,4776,4988,293,6394,6687
00405707,NATIONAL AMERICAN UNIVERSITY - SIOUX FAL,SD,57108-4293,Proprietary  ,13,231,244,37,485,522
00492900,MCKENNAN HOSP-RADOLOGICAL TECH          ,SD,57101-0000,Private      ,2,8,10,12,15,27
00530900,LAKE AREA TECHNICAL INSTITUTE           ,SD,57201-0730,Public       ,405,188,593,1043,408,1451
00598700,AVERA SACRED HEART HOSPITAL SCHOOL OF RA,SD,57078-3899,Private      ,3,3,6,13,5,18
00776400,SOUTHEAST TECHNICAL INST                ,SD,57107-0000,Public       ,419,401,820,941,833,1774
00828400,MITCHELL TECHNICAL INSTITUTE            ,SD,57301-9931,Public       ,250,152,402,596,247,843
01013800,STEWART SCHOOL                          ,SD,57104-0000,Proprietary  ,34,24,58,69,52,121
01014804,COLORADO TECHNICAL UNIVERSITY           ,SD,57108-2272,Proprietary  ,11,33,44,26,81,107
01017000,WESTERN DAKOTA TECHNICAL INSTITUTE      ,SD,57701-4018,Public       ,126,285,411,318,524,842
01147700,SANFORD MEDICAL CENTER                  ,SD,57117-5039,Private      ,4,14,18,17,23,40
01465900,OGLALA LAKOTA COLLEGE                   ,SD,57752-0490,Public       ,98,460,558,161,682,843
02137100,BLACK HILLS BEAUTY COLLEGE              ,SD,57701-0000,Proprietary  ,32,29,61,57,62,119
02143700,SINTE GLESKA UNIVERSITY                 ,SD,57570-0000,Public       ,22,65,87,45,169,214
02144600,KILIAN COMMUNITY COLLEGE                ,SD,57103-7020,Private      ,24,76,100,47,131,178
02277300,SISSETON WAHPETON COLLEGE               ,SD,57262-0000,Public       ,4,15,19,9,31,40
02297800,HEADLINES ACADEMY                       ,SD,57701-2733,Proprietary  ,19,38,57,39,72,111
00347700,AQUINAS COLLEGE                         ,TN,37205-2086,Private      ,43,172,215,285,416,701
00347800,AUSTIN PEAY STATE UNIVERSITY            ,TN,37044-0002,Public       ,1201,2283,3484,8280,5861,14141
00347900,BELMONT UNIVERSITY                      ,TN,37212-3757,Private      ,890,960,1850,7860,2811,10671
00348000,BETHEL UNIVERSITY                       ,TN,38201-1705,Private      ,260,1383,1643,1991,5020,7011
00348100,CARSON - NEWMAN UNIVERSITY              ,TN,37760-2204,Private      ,289,347,636,3632,978,4610
00348200,CHRISTIAN BROTHERS UNIVERSITY           ,TN,38104-5581,Private      ,271,427,698,2449,1410,3859
00348300,COLUMBIA STATE COMMUNITY COLLEGE        ,TN,38401-5653,Public       ,529,932,1461,3985,2249,6234
00348500,CUMBERLAND UNIVERSITY                   ,TN,37087-3554,Private      ,210,396,606,1504,900,2404
00348600,LIPSCOMB UNIVERSITY                     ,TN,37204-3951,Private      ,541,846,1387,3833,2005,5838
00348700,EAST TENNESSEE STATE UNIV - MAIN CAMPUS ,TN,37614-2857,Public       ,1864,2202,4066,11844,6289,18133
00348701,EAST TENNESSEE STATE UNIV - MEDICINE    ,TN,37614-1708,Public       ,42,176,218,329,604,933
00348709,EAST TENNESSEE STATE UNIV - PHARMACY    ,TN,37614-1704,Public       ,12,148,160,135,384,519
00349000,FISK UNIVERSITY                         ,TN,37208-3045,Private      ,221,187,408,1863,601,2464
00349200,FREED-HARDEMAN UNIVERSITY               ,TN,38340-2399,Private      ,331,334,665,1530,709,2239
00349400,HIWASSEE COLLEGE                        ,TN,37354-4001,Private      ,66,45,111,450,160,610
00349500,JOHNSON UNIVERSITY                      ,TN,37998-9775,Private      ,250,253,503,1055,548,1603
00349600,KING UNIVERSITY                         ,TN,37620-2699,Private      ,287,737,1024,1349,2355,3704
00349900,LANE COLLEGE                            ,TN,38301-4598,Private      ,338,208,546,1797,765,2562
00350000,LEE UNIVERSITY                          ,TN,37320-0000,Private      ,772,609,1381,3888,1295,5183
00350100,LEMOYNE-OWEN COLLEGE                    ,TN,38126-6510,Private      ,189,479,668,1640,1724,3364
00350200,LINCOLN MEMORIAL UNIVERSITY             ,TN,37752-7920,Private      ,235,1217,1452,1840,3275,5115
00350400,MARTIN METHODIST COLLEGE                ,TN,38478-2799,Private      ,187,115,302,1062,362,1424
00350500,MARYVILLE COLLEGE                       ,TN,37804-5907,Private      ,227,82,309,1838,297,2135
00350600,MEHARRY MEDICAL COLLEGE                 ,TN,37208-0000,Private      ,20,365,385,124,1187,1311
00350700,MEMPHIS COLLEGE OF ART                  ,TN,38104-2764,Private      ,150,127,277,857,397,1254
00350900,UNIVERSITY OF MEMPHIS (THE)             ,TN,38152-4611,Public       ,2680,4574,7254,17034,13174,30208
00351000,MIDDLE TENNESSEE STATE UNIV             ,TN,37130-0000,Public       ,3311,3714,7025,21088,9975,31063
00351100,MILLIGAN COLLEGE                        ,TN,37682-4001,Private      ,116,164,280,1088,497,1585
00351700,SOUTHERN COLLEGE OF OPTOMETRY           ,TN,38104-2222,Private      ,8,120,128,56,628,684
00351800,SOUTHERN ADVENTIST UNIVERSITY           ,TN,37315-0370,Private      ,635,315,950,2470,883,3353
00351900,RHODES COLLEGE                          ,TN,38112-1690,Private      ,306,135,441,3120,490,3610
00352200,TENNESSEE STATE UNIVERSITY              ,TN,37209-1561,Public       ,1601,2550,4151,11022,6911,17933
00352300,TENNESSEE TECHNOLOGICAL UNIV            ,TN,38505-0001,Public       ,1275,929,2204,10138,2710,12848
00352400,TENNESSEE TEMPLE UNIVERSITY             ,TN,37404-3587,Private      ,16,73,89,247,277,524
00352500,TENNESSEE WESLEYAN COLLEGE              ,TN,37371-0040,Private      ,100,124,224,1176,519,1695
00352600,TREVECCA NAZARENE UNIVERSITY            ,TN,37210-2877,Private      ,241,592,833,1762,1466,3228
00352700,TUSCULUM COLLEGE                        ,TN,37743-0001,Private      ,210,311,521,1802,1115,2917
00352800,UNION UNIVERSITY                        ,TN,38305-3697,Private      ,338,848,1186,2422,2255,4677
00352900,UNIVERSITY OF TENNESSEE-CHATTANOOGA     ,TN,37403-2598,Public       ,2064,1514,3578,14022,4174,18196
00353000,UNIVERSITY OF TENNESSEE-KNOXVILLE       ,TN,37996-0150,Public       ,2619,2301,4920,28064,8247,36311
00353006,UNIVERSITY OF TENNESSEE-HEALTH SCI CTR  ,TN,38103-0000,Public       ,117,923,1040,647,3490,4137
00353100,UNIVERSITY OF TENNESSEE-MARTIN          ,TN,38238-0002,Public       ,767,766,1533,6761,2650,9411
00353400,UNIVERSITY OF THE SOUTH                 ,TN,37383-1000,Private      ,110,26,136,2633,118,2751
00353500,VANDERBILT UNIVERSITY                   ,TN,37240-0001,Private      ,1152,1317,2469,19389,6202,25591
00353501,VANDERBILT UNIV MED CTR ALLIEDHEAL      ,TN,37232-5510,Private      ,27,138,165,228,507,735
00353600,BRYAN COLLEGE                           ,TN,37321-7000,Private      ,128,221,349,963,619,1582
00399800,CHATTANOOGA STATE COMMUNITY COLLEGE     ,TN,37406-1097,Public       ,1334,2902,4236,6361,6322,12683
00399900,CLEVELAND STATE COMMUNITY COLLEGE       ,TN,37312-2858,Public       ,302,774,1076,2437,1869,4306
00402500,TENNESSEE COLLEGE OF APPLIED TECHNOLOGY ,TN,37919-2327,Public       ,201,896,1097,1144,1764,2908
00402600,TENNESSEE COLLEGE OF APPLIED TECHNOLOGY ,TN,38555-4142,Public       ,50,176,226,349,403,752
00461700,NATIONAL COLLEGE                        ,TN,37211-6605,Proprietary  ,43,264,307,164,888,1052
00493400,DAYMAR INSTITUTE                        ,TN,37217-1056,Proprietary  ,21,159,180,71,325,396
00493401,DAYMAR INSTITUTE - CLARKSVILLE          ,TN,37040-6718,Proprietary  ,51,370,421,176,746,922
00493404,DAYMAR INSTITUTE - MURFREESBORO         ,TN,37128-5508,Proprietary  ,24,124,148,98,294,392
00493700,JACKSON STATE COMMUNITY COLLEGE         ,TN,38301-3797,Public       ,425,910,1335,3663,2725,6388
00493800,SOUTH COLLEGE                           ,TN,37909-3323,Proprietary  ,93,741,834,686,1782,2468
00494700,WEST TENNESSEE BUSINESS COLLEGE         ,TN,38301-3256,Proprietary  ,29,155,184,115,381,496
00528000,TENNESSEE COLLEGE OF APPLIED TECHNOLOGY ,TN,38019-0249,Public       ,38,115,153,181,298,479
00528100,TENNESSEE COLLEGE OF APPLIED TECHNOLOGY ,TN,37643-6054,Public       ,78,295,373,468,653,1121
00528200,TENNESSEE COLLEGE OF APPLIED TECHNOLOGY-,TN,37074-2032,Public       ,64,127,191,335,272,607
00528300,TENNESSEE COLLEGE OF APPLIED TECHNOLOGY ,TN,38059-1198,Public       ,41,110,151,233,370,603
00530700,TENNESSEE COLLEGE OF APPLIED TECHNOLOGY-,TN,37110-1322,Public       ,34,116,150,281,288,569
00535100,TENNESSEE COLLEGE OF APPLIED TECHNOLOGY ,TN,37813-2094,Public       ,89,398,487,618,836,1454
00535200,TENNESSEE COLLEGE OF APPLIED TECHNOLOGY-,TN,38201-1620,Public       ,18,65,83,175,204,379
00535300,TENNESSEE COLLEGE OF APPLIED TECHNOLOGY-,TN,38570-1291,Public       ,56,129,185,401,324,725
00535400,TENNESSEE COLLEGE OF APPLIED TECHNOLOGY-,TN,38301-9609,Public       ,82,315,397,542,861,1403
00535600,TENNESSEE COLLEGE OF APPLIED TECHNOLOGY ,TN,38462-2201,Public       ,51,133,184,330,306,636
00535700,TENNESSEE COLLEGE OF APPLIED TECHNOLOGY ,TN,38327-3402,Public       ,29,85,114,184,259,443
00535800,TENNESSEE COLLEGE OF APPLIED TECHNOLOGY ,TN,37371-0848,Public       ,52,139,191,389,338,727
00535900,TENNESSEE COLLEGE OF APPLIED TECHNOLOGY ,TN,37209-4515,Public       ,182,896,1078,871,1565,2436
00536000,TENNESSEE COLLEGE OF APPLIED TECHNOLOGY-,TN,38105-3604,Public       ,191,875,1066,1233,2099,3332
00537800,NORTHEAST STATE COMMUNITY COLLEGE       ,TN,37617-0246,Public       ,559,1148,1707,3772,3010,6782
00537900,TENNESSEE COLLEGE OF APPLIED TECHNOLOGY-,TN,37160-3697,Public       ,91,243,334,477,508,985
00683500,DYERSBURG STATE COMMUNITY COLLEGE       ,TN,38024-0000,Public       ,228,568,796,1886,1695,3581
00683600,MOTLOW STATE COMMUNITY COLLEGE          ,TN,37388-7972,Public       ,649,963,1612,4624,2285,6909
00732941,ITT TECHNICAL INSTITUTE                 ,TN,37932-3343,Proprietary  ,221,1357,1578,639,2071,2710
00732958,ITT TECHNICAL INSTITUTE                 ,TN,37214-3717,Proprietary  ,154,810,964,497,1494,1991
00743900,FOUNTAINHEAD COLLEGE OF TECHNOLOGY      ,TN,37918-0000,Proprietary  ,25,159,184,175,352,527
00778200,TENNESSEE COLLEGE OF APPLIED TECHNOLOGY ,TN,37055-2556,Public       ,71,268,339,541,691,1232
00778300,MIDDLE TENNESSEE SCH OF ANESTHESIA      ,TN,37116-0000,Private      ,2,50,52,24,130,154
00793803,NASHVILLE AUTO DIESEL COLLEGE - NASHVILL,TN,37206-3210,Proprietary  ,797,279,1076,1590,568,2158
00814500,NASHVILLE STATE TECH CMNTY COLLEGE      ,TN,37209-0000,Public       ,1231,3289,4520,6252,7305,13557
00865500,GENESIS CAREER COLLEGE                  ,TN,38501-1959,Proprietary  ,43,110,153,96,193,289
00885900,JOHN A GUPTON COLLEGE                   ,TN,37203-2934,Private      ,15,55,70,99,145,244
00886300,WALTERS STATE COMMUNITY COLLEGE         ,TN,37813-6899,Public       ,542,1033,1575,4863,2881,7744
00946400,TENNESSEE COLLEGE OF APPLIED TECHNOLOGY-,TN,38478-4541,Public       ,42,134,176,257,248,505
00956700,TENNESSEE SCHOOL OF BEAUTY              ,TN,37921-3303,Proprietary  ,39,103,142,175,251,426
00971000,TENNESSEE COLLEGE OF APPLIED TECHNOLOGY ,TN,37756-4149,Public       ,22,60,82,117,145,262
00991200,VOLUNTEER STATE COMMUNITY COLLEGE       ,TN,37066-3188,Public       ,716,1361,2077,5413,3288,8701
00991400,ROANE STATE COMMUNITY COLLEGE           ,TN,37748-8664,Public       ,431,1262,1693,4544,3346,7890
01032600,TENNESSEE COLLEGE OF APPLIED TECHNOLOGY ,TN,37748-5849,Public       ,46,143,189,277,315,592
01043900,SOUTHWEST TENNESSEE COMMUNITY COLLG     ,TN,38104-3322,Public       ,1197,3133,4330,8683,9097,17780
01046000,AMERICAN BAPTIST THEOLOGICAL SEMINA     ,TN,37207-4994,Private      ,13,58,71,57,172,229
01052900,MEMPHIS THEOLOGICAL SEMINARY            ,TN,38104-0000,Private      ,4,105,109,29,238,267
01070000,TENNESSEE COLLEGE OF APPLIED TECHNOLOGY-,TN,37757-2461,Public       ,24,96,120,211,253,464
01155300,WM R MOORE COLLEGE OF TECHNOLOGY        ,TN,38104-0000,Private      ,18,92,110,166,274,440
01216400,TENNESSEE COLLEGE OF APPLIED TECHNOLOGY ,TN,38063-7359,Public       ,16,49,65,77,164,241
01254700,EMMANUEL SCHOOL OF RELIGION             ,TN,37601-0000,Private      ,0,11,11,4,29,33
01269300,PELLISSIPPI STATE COMMUNITY COLLEGE     ,TN,37933-0990,Public       ,837,1777,2614,7607,4508,12115
02069303,VATTEROTT COLLEGE -                     ,TN,38016-5877,Proprietary  ,43,211,254,96,386,482
02092800,TENNESSEE COLLEGE OF APPLIED TECHNOLOGY ,TN,38075-0489,Public       ,36,81,117,170,212,382
02103500,TENNESSEE COLLEGE OF APPLIED TECHNOLOGY ,TN,37129-3311,Public       ,125,437,562,691,787,1478
02106400,O'MORE COLLEGE OF DESIGN                ,TN,37064-0000,Private      ,39,32,71,160,71,231
02125300,NASHVILLE CLG OF MEDICAL CAREERS        ,TN,37115-0000,Proprietary  ,8,59,67,35,120,155
02153100,JON NAVE UNIVERSITY OF COSMETOLOGY      ,TN,37013-3347,Proprietary  ,37,98,135,71,156,227
02157100,CONCORDE CAREER COLLEGE                 ,TN,38137-0000,Proprietary  ,198,824,1022,638,1986,2624
02160307,INTERNATIONAL ACADEMY OF DESIGN & TECH  ,TN,37212-0000,Proprietary  ,14,35,49,99,107,206
02188300,PENTECOSTAL THEOLOGICAL SEMINARY        ,TN,37320-0000,Private      ,1,131,132,6,227,233
02204200,"CHATTANOOGA COLLEGE - MEDICAL, DENTAL AN",TN,37411-0000,Proprietary  ,55,276,331,214,566,780
02237900,TENNESSEE COLLEGE OF APPLIED TECHNOLOGY-,TN,38242-5023,Public       ,40,137,177,196,382,578
02255000,KNOXVILLE INSTITUTE OF HAIR DESIGN      ,TN,37917-0000,Proprietary  ,12,54,66,67,136,203
02257400,ARNOLD'S BEAUTY SCHOOL                  ,TN,38358-0000,Proprietary  ,12,28,40,41,62,103
02275500,REUBEN-ALLEN COLLEGE                    ,TN,37922-0000,Proprietary  ,29,106,135,73,171,244
02278700,MR WAYNES SCH OF UNISEX HAIR DESIGN     ,TN,38501-0000,Proprietary  ,11,20,31,33,37,70
02293900,VOLUNTEER BEAUTY ACADEMY-NASHVILLE      ,TN,37115-2112,Proprietary  ,3,17,20,12,32,44
02294000,VOLUNTEER BEAUTY ACADEMY-DYERSBURG      ,TN,38024-1622,Proprietary  ,9,20,29,26,48,74
02326200,KAPLAN CAREER INSTITUTE                 ,TN,37212-5318,Proprietary  ,51,340,391,160,765,925
02326300,MEDVANCE INSTITUTE                      ,TN,38501-4305,Proprietary  ,24,79,103,62,168,230
02335900,VOLUNTEER BEAUTY ACADEMY-NASHVILLE      ,TN,37209-3033,Proprietary  ,9,30,39,64,95,159
02539800,QUEEN CITY COLLEGE                      ,TN,37042-0000,Proprietary  ,11,108,119,57,220,277
02540000,TENNESSEE ACADEMY OF COSMETOLOGY        ,TN,38133-0000,Proprietary  ,24,100,124,154,252,406
02578200,NOSSI COLLEGE OF ART                    ,TN,37115-5138,Proprietary  ,62,78,140,373,248,621
02595000,FAYETTEVILLE BEAUTY SCHOOL              ,TN,37334-2909,Proprietary  ,4,21,25,25,33,58
02599710,VATTEROTT COLLEGE - MEMPHIS             ,TN,38132-1714,Proprietary  ,74,365,439,309,1133,1442
02609204,VATTEROTT COLLEGE - VATTEROTT CAREER COL,TN,38133-4727,Proprietary  ,55,243,298,242,624,866
02614200,MILLER MOTTE BUSINESS COLLEGE           ,TN,37040-6023,Proprietary  ,63,328,391,155,603,758
02614203,MILLER - MOTTE TECHNICAL COLLEGE - CHATT,TN,37421-7220,Proprietary  ,69,293,362,191,562,753
02614204,MILLER - MOTTE TECHNICAL COLLEGE - MADIS,TN,37072-1870,Proprietary  ,33,224,257,80,313,393
03001800,FREE WILL BAPTIST BIBLE COLLEGE         ,TN,37205-2498,Private      ,57,31,88,197,86,283
03008800,FRANKLIN ACADEMY                        ,TN,37312-3939,Private      ,11,27,38,24,59,83
03010606,VIRGINIA COLLEGE - SCH OF BUSNSS & HLTH ,TN,37411-5600,Proprietary  ,50,267,317,170,709,879
03024900,TENNESSEE ACADEMY OF COSMETOLOGY        ,TN,38125-3442,Proprietary  ,25,104,129,201,287,488
03026517,REMINGTON COLLEGE - MEMPHIS             ,TN,38132-2107,Private      ,61,260,321,335,755,1090
03061100,GENESIS CAREER COLLEGE OF LEBANON       ,TN,37087-2718,Proprietary  ,17,61,78,47,107,154
03079100,NORTH CENTRAL INSTITUTE                 ,TN,37042-3116,Proprietary  ,4,58,62,50,132,182
03088800,"WATKINS COLLEGE OF ART, DESIGN & FILM   ",TN,37228-1306,Private      ,94,72,166,515,207,722
03126900,STYLES & PROFILES BEAUTY COLLEGE        ,TN,38375-2109,Proprietary  ,2,3,5,10,17,27
03253300,PAUL MITCHELL THE SCHOOL MEMPHIS        ,TN,38133-4067,Proprietary  ,34,61,95,103,129,232
03355400,RICHMONT GRADUATE UNIVERSITY            ,TN,37404-0000,Private      ,2,97,99,11,177,188
03440300,BAPTIST MEMORIAL COLLEGE OF HEALTH      ,TN,38104-3104,Private      ,122,470,592,1056,1802,2858
03480303,FORTIS INSTITUTE - NASHVILLE            ,TN,37211-1536,Proprietary  ,39,194,233,75,359,434
03513500,WILLIAMSON CHRISTIAN COLLEGE            ,TN,37067-8237,Private      ,19,15,34,36,42,78
03647300,NEW CONCEPTS SCHOOL OF COSMETOLOGY      ,TN,37311-7373,Proprietary  ,5,21,26,22,38,60
03683300,INTERNATIONAL BARBER & STYLE COLLEGE    ,TN,37209-2205,Proprietary  ,5,32,37,35,74,109
03701300,MEMPHIS INSTITUTE OF BARBERING          ,TN,38107-4334,Proprietary  ,26,111,137,146,263,409
03774400,SHEAR ACADEMY                           ,TN,38555-4177,Proprietary  ,4,23,27,20,38,58
03830300,SAE INSTITUTE OF TECHNOLOGY             ,TN,37203-4310,Proprietary  ,72,132,204,193,273,466
03840300,OXFORD GRADUATE SCHOOL                  ,TN,37321-6736,Private      ,1,13,14,7,25,32
03841300,CAREER BEAUTY COLLEGE                   ,TN,38464-3634,Proprietary  ,2,26,28,13,40,53
03920300,INSTITUTE OF HAIR DESIGN                ,TN,38310-1801,Proprietary  ,3,11,14,21,29,50
03930300,BUCHANAN BEAUTY COLLEGE                 ,TN,37160-2741,Proprietary  ,11,22,33,29,48,77
03982300,VISIBLE SCHOOL - MUSIC AND WORSHIPS ARTS,TN,38104-5814,Private      ,37,41,78,132,94,226
04035300,TENNESSEE CAREER INSTITUTE              ,TN,38401-6335,Proprietary  ,20,62,82,91,120,211
04124100,ELITE COLLEGE OF COSMETOLOGY            ,TN,38351-1431,Proprietary  ,10,21,31,22,42,64
04142000,AUSTIN'S BEAUTY COLLEGE                 ,TN,37040-3107,Proprietary  ,9,32,41,14,47,61
04157200,LOVE BEAUTY SCHOOL                      ,TN,37355-2950,Proprietary  ,2,11,13,24,25,49
04165000,MERIDIAN INSTITUTE OF SURGICAL ASSISTING,TN,37080-0758,Proprietary  ,3,200,203,10,284,294
04174600,NASHVILLE BARBER AND STYLE ACADEMY      ,TN,37208-2826,Proprietary  ,4,38,42,46,99,145
04210200,MID-SOUTH CHRISTIAN COLLEGE             ,TN,38118-3151,Private      ,9,26,35,62,124,186
04213800,SALON PROFESSIONAL ACADEMY (THE)        ,TN,37214-2163,Proprietary  ,20,18,38,68,72,140
04215200,VIBE BARBER COLLEGE                     ,TN,38107-2538,Proprietary  ,8,50,58,53,114,167
04223900,MIND BODY INSTITUTE                     ,TN,37214-1012,Proprietary  ,5,44,49,21,96,117
04236400,SANDRA ACADEMY OF SALON SERVICES        ,TN,37825-7239,Proprietary  ,2,17,19,9,33,42
04238600,GOULD'S ACADEMY                         ,TN,38119-5317,Proprietary  ,20,47,67,80,129,209
00353700,ABILENE CHRISTIAN UNIVERSITY            ,TX,79699-3701,Private      ,1209,502,1711,5805,1150,6955
00353900,ALVIN COMMUNITY COLLEGE                 ,TX,77511-4807,Public       ,510,873,1383,1064,1671,2735
00354000,AMARILLO COLLEGE                        ,TX,79109-2446,Public       ,1440,2219,3659,2624,3586,6210
00354100,ANGELO STATE UNIVERSITY                 ,TX,76909-5069,Public       ,1569,1093,2662,5435,2330,7765
00354300,AUSTIN COLLEGE                          ,TX,75090-4440,Private      ,421,94,515,2088,220,2308
00354400,AUSTIN PRESBYTERIAN THEOLOGICAL SEM     ,TX,78705-5797,Private      ,0,75,75,2,123,125
00354500,BAYLOR UNIVERSITY                       ,TX,76798-7048,Private      ,2404,1102,3506,24113,4057,28170
00354600,COASTAL BEND COLLEGE                    ,TX,78102-2197,Public       ,614,700,1314,1211,1209,2420
00354900,BLINN COLLEGE                           ,TX,77833-4098,Public       ,4809,1981,6790,12491,3814,16305
00355300,CISCO JUNIOR COLLEGE                    ,TX,76437-9803,Public       ,659,807,1466,1326,1391,2717
00355400,CLARENDON COLLEGE                       ,TX,79226-0000,Public       ,148,218,366,328,341,669
00355600,COMMONWEALTH INST OF FUNERAL SVC        ,TX,77090-5918,Private      ,29,156,185,56,312,368
00355700,CONCORDIA UNIVERSITY TEXAS              ,TX,78726-4141,Private      ,426,977,1403,1460,1795,3255
00355800,NORTH CENTRAL TEXAS COLLEGE             ,TX,76240-4699,Public       ,1398,1865,3263,2715,3346,6061
00356000,DALLAS BAPTIST UNIVERSITY               ,TX,75211-9299,Private      ,952,1319,2271,2941,2455,5396
00356100,CEDAR VALLEY COLLEGE                    ,TX,75134-0000,Public       ,804,1493,2297,1614,2710,4324
00356200,DALLAS THEOLOGICAL SEM                  ,TX,75204-0000,Private      ,7,292,299,21,626,647
00356300,DEL MAR COLLEGE                         ,TX,78404-3897,Public       ,1852,2704,4556,3821,4908,8729
00356400,EAST TEXAS BAPTIST UNIVERSITY           ,TX,75670-1423,Private      ,597,171,768,1591,367,1958
00356500,TEXAS A&M UNIVERSITY - COMMERCE         ,TX,75429-3011,Public       ,2056,3065,5121,6418,5878,12296
00356600,EPISCOPAL THEOLOGICAL SEMINARY OF THE SO,TX,78705-3128,Private      ,0,22,22,1,41,42
00356800,FRANK PHILLIPS COLLEGE                  ,TX,79008-0000,Public       ,120,170,290,253,282,535
00357000,GRAYSON COUNTY COLLEGE                  ,TX,75020-8299,Public       ,519,1006,1525,1068,1783,2851
00357100,HARDIN-SIMMONS UNIVERSITY               ,TX,79698-6050,Private      ,548,354,902,1691,706,2397
00357200,TRINITY VALLEY COMMUNITY COLLEGE        ,TX,75751-2734,Public       ,905,1470,2375,1835,2617,4452
00357300,HILL COLLEGE                            ,TX,76645-2711,Public       ,389,447,836,797,781,1578
00357301,HILL COLLEGE                            ,TX,76031-0000,Public       ,359,613,972,709,1082,1791
00357400,HOWARD COUNTY JUNIOR COLLEGE DISTRICT   ,TX,79720-0213,Public       ,476,783,1259,942,1316,2258
00357500,HOWARD PAYNE UNIVERSITY                 ,TX,76801-2715,Private      ,410,163,573,1350,297,1647
00357600,HOUSTON BAPTIST UNIVERSITY              ,TX,77074-3298,Private      ,1170,1180,2350,5180,2639,7819
00357700,HUSTON - TILLOTSON UNIVERSITY           ,TX,78702-2795,Private      ,356,404,760,970,837,1807
00357800,UNIVERSITY OF THE INCARNATE WORD        ,TX,78209-6398,Private      ,1648,2459,4107,6235,5381,11616
00357900,JACKSONVILLE COLLEGE                    ,TX,75766-4759,Private      ,139,85,224,219,143,362
00358000,KILGORE COLLEGE                         ,TX,75662-3299,Public       ,1086,1470,2556,2128,2482,4610
00358100,LAMAR UNIVERSITY-BEAUMONT               ,TX,77710-0042,Public       ,2251,3939,6190,7422,7111,14533
00358200,LAREDO COMMUNITY COLLEGE                ,TX,78040-4395,Public       ,1638,1087,2725,4365,2006,6371
00358300,LEE COLLEGE                             ,TX,77520-4796,Public       ,705,1378,2083,1476,2431,3907
00358400,LETOURNEAU UNIVERSITY                   ,TX,75607-0000,Private      ,372,648,1020,1387,1427,2814
00358600,LUBBOCK CHRISTIAN UNIVERSITY            ,TX,79407-2099,Private      ,562,529,1091,1345,1038,2383
00358800,UNIVERSITY OF MARY HARDIN-BAYLOR        ,TX,76513-2599,Private      ,716,500,1216,5180,1423,6603
00359000,MCLENNAN COMMUNITY COLLEGE              ,TX,76708-1498,Public       ,1498,2378,3876,3469,4225,7694
00359100,MCMURRY UNIVERSITY                      ,TX,79697-0001,Private      ,434,214,648,1215,431,1646
00359200,MIDWESTERN STATE UNIVERSITY             ,TX,76308-2099,Public       ,1276,1105,2381,4639,2223,6862
00359300,NAVARRO COLLEGE                         ,TX,75110-4818,Public       ,1552,1895,3447,3366,3364,6730
00359400,UNIVERSITY OF NORTH TEXAS               ,TX,76203-5017,Public       ,7635,6002,13637,30102,13805,43907
00359412,UNIVERSITY OF NORTH TEXAS AT DALLAS     ,TX,75241-4605,Public       ,1103,2181,3284,4033,4772,8805
00359500,OBLATE SCHOOL OF THEOLOGY               ,TX,78216-0000,Private      ,2,14,16,9,35,44
00359600,ODESSA COLLEGE                          ,TX,79764-7127,Public       ,590,926,1516,1102,1681,2783
00359800,OUR LADY OF THE LAKE UNIVERSITY         ,TX,78207-4689,Private      ,870,1367,2237,3765,2882,6647
00359900,UNIVERSITY OF TEXAS - PAN AMERICAN      ,TX,78541-2999,Public       ,3622,3332,6954,20914,10241,31155
00360000,PANOLA COLLEGE                          ,TX,75633-2397,Public       ,350,738,1088,777,1228,2005
00360100,PARIS JR COLLEGE                        ,TX,75460-6298,Public       ,665,963,1628,1373,1604,2977
00360200,PAUL QUINN COLLEGE                      ,TX,75241-4398,Private      ,189,228,417,588,477,1065
00360300,RANGER COLLEGE                          ,TX,76470-3298,Public       ,270,252,522,544,474,1018
00360305,RANGER COLLEGE-STEPHENVILE BEAUTY COLLEG,TX,76401-5136,Public       ,53,44,97,113,82,195
00360400,RICE UNIVERSITY                         ,TX,77251-1892,Private      ,993,795,1788,10876,2300,13176
00360600,SAM HOUSTON STATE UNIVERSITY            ,TX,77340-0000,Public       ,5201,3380,8581,20089,7952,28041
00360700,ALAMO CMTY CLG DISTRICT PROGRAM         ,TX,78207-0000,Public       ,470,765,1235,1230,1556,2786
00360800,ST PHILLIPS COLLEGE                     ,TX,78203-2098,Public       ,2239,3485,5724,4567,6656,11223
00360900,SAN JACINTO CLG-CENTRAL-NORTH-SOUTH     ,TX,77501-0000,Public       ,3773,5348,9121,7925,9512,17437
00361000,SCHREINER UNIVERSITY                    ,TX,78028-5697,Private      ,389,156,545,1378,380,1758
00361100,SOUTH PLAINS COLLEGE                    ,TX,79336-6504,Public       ,1897,2037,3934,3818,3429,7247
00361200,UNIV OF HOUSTON-DOWNTOWN                ,TX,77002-1001,Public       ,3541,6631,10172,10791,13957,24748
00361300,SOUTHERN METHODIST UNIVERSITY           ,TX,75275-0181,Private      ,1066,1571,2637,7789,3945,11734
00361400,SOUTHWEST TEXAS JR COLLEGE              ,TX,78801-6221,Public       ,847,887,1734,1828,1534,3362
00361500,TEXAS STATE UNIVERSITY--SAN MARCOS      ,TX,78666-4602,Public       ,7291,3778,11069,36997,12421,49418
00361600,SOUTHWESTERN ASSEMBLIES OF GOD UNIV     ,TX,75165-2397,Private      ,597,450,1047,1308,785,2093
00361800,SOUTHWESTERN CHRISTIAN COLLEGE          ,TX,75160-3400,Private      ,45,42,87,99,80,179
00361900,SOUTHWESTERN ADVENTIST UNIVERSITY       ,TX,76059-1922,Private      ,245,121,366,699,278,977
00362000,SOUTHWESTERN UNIVERSITY                 ,TX,78626-6111,Private      ,233,71,304,2393,271,2664
00362100,ST EDWARDS UNIVERSITY                   ,TX,78704-0000,Private      ,1114,797,1911,5831,1855,7686
00362300,ST MARY'S UNIV OF SAN ANTONIO           ,TX,78228-8500,Private      ,741,929,1670,4575,2581,7156
00362400,STEPHEN F AUSTIN STATE UNIVERSITY       ,TX,75962-0001,Public       ,3279,1701,4980,13276,3702,16978
00362500,SUL ROSS STATE UNIVERSITY               ,TX,79832-0113,Public       ,481,592,1073,1703,1255,2958
00362600,TARRANT COUNTY COLLEGE                  ,TX,76102-6599,Public       ,7585,11414,18999,15019,20438,35457
00362700,TEMPLE COLLEGE                          ,TX,76504-7435,Public       ,727,1586,2313,1670,3023,4693
00362800,TEXARKANA COLLEGE                       ,TX,75599-0001,Public       ,520,1203,1723,937,1904,2841
00363000,PRAIRIE VIEW A&M UNIVERSITY             ,TX,77446-2967,Public       ,2776,1943,4719,10292,4490,14782
00363100,TARLETON STATE UNIVERSITY               ,TX,76402-0000,Public       ,2290,1886,4176,9408,4762,14170
00363200,TEXAS A&M UNIVERSITY                    ,TX,77843-1246,Public       ,7840,4292,12132,47572,12509,60081
00363208,TEXAS A&M UNIVERSITY - BRYAN            ,TX,77807-3260,Public       ,0,0,0,45,49,94
00363400,TEXAS STATE TECHNICAL CLG AT WACO       ,TX,76705-1695,Public       ,1422,1558,2980,2779,2627,5406
00363500,TEXAS CHIROPRACTIC COLLEGE              ,TX,77505-1699,Private      ,3,163,166,10,272,282
00363600,TEXAS CHRISTIAN UNIVERSITY              ,TX,76129-0001,Private      ,1863,1299,3162,12798,3311,16109
00363700,JARVIS CHRISTIAN COLLEGE                ,TX,75765-1470,Private      ,339,165,504,575,255,830
00363800,TEXAS COLLEGE                           ,TX,75702-4500,Private      ,373,332,705,778,583,1361
00363900,TEXAS A&M UNIVERSITY-KINGSVILLE         ,TX,78363-8203,Public       ,2067,2485,4552,10058,5864,15922
00364100,TEXAS LUTHERAN UNIVERSITY               ,TX,78155-5999,Private      ,438,132,570,1780,281,2061
00364200,TEXAS SOUTHERN UNIVERSITY               ,TX,77004-4598,Public       ,2948,4101,7049,9725,9035,18760
00364400,TEXAS TECH UNIVERSITY                   ,TX,79409-2011,Public       ,6254,3890,10144,27173,9194,36367
00364500,TEXAS WESLEYAN UNIVERSITY               ,TX,76105-1536,Private      ,570,1116,1686,1931,2401,4332
00364600,TEXAS WOMAN'S UNIVERSITY                ,TX,76204-5587,Public       ,2446,4435,6881,9052,10336,19388
00364700,TRINITY UNIVERSITY                      ,TX,78212-7200,Private      ,535,314,849,3428,751,4179
00364800,TYLER JUNIOR COLLEGE                    ,TX,75701-3436,Public       ,2879,2543,5422,6616,4732,11348
00365100,UNIVERSITY OF DALLAS                    ,TX,75062-4799,Private      ,290,482,772,2422,1036,3458
00365200,UNIVERSITY OF HOUSTON                   ,TX,77204-2010,Public       ,8205,8855,17060,31271,20860,52131
00365400,UNIVERSITY OF ST THOMAS                 ,TX,77006-4626,Private      ,410,907,1317,1628,1794,3422
00365600,UNIVERSITY OF TEXAS-ARLINGTON           ,TX,76019-0000,Public       ,5933,11330,17263,21925,24217,46142
00365800,UNIVERSITY OF TEXAS-AUSTIN              ,TX,78713-7758,Public       ,5440,4402,9842,45351,16027,61378
00365900,UT HEALTH CENTER-SAN ANTONIO            ,TX,78229-3900,Public       ,373,1588,1961,1210,3686,4896
00366100,UNIVERSITY OF TEXAS-EL PASO             ,TX,79968-0629,Public       ,4802,4739,9541,16310,10654,26964
00366200,VICTORIA COLLEGE                        ,TX,77901-4494,Public       ,613,948,1561,1238,1646,2884
00366300,WAYLAND BAPTIST UNIVERSITY              ,TX,79072-6998,Private      ,451,1213,1664,1064,2345,3409
00366400,WEATHERFORD COLLEGE                     ,TX,76086-5699,Public       ,934,1265,2199,1874,2264,4138
00366500,WEST TEXAS A&M UNIVERSITY               ,TX,79016-0000,Public       ,2079,1790,3869,5831,3280,9111
00366800,WHARTON COUNTY JR COLLEGE               ,TX,77488-3298,Public       ,1238,1057,2295,2711,1941,4652
00366900,WILEY COLLEGE                           ,TX,75670-5199,Private      ,309,263,572,686,494,1180
00400300,CENTRAL TEXAS COLLEGE                   ,TX,76540-4199,Public       ,1007,5497,6504,2141,10984,13125
00407221,NORTHWOOD UNIVERSITY                    ,TX,75104-0000,Private      ,39,180,219,70,347,417
00445300,EL CENTRO COLLEGE                       ,TX,75202-3604,Public       ,1904,4010,5914,4002,7469,11471
00450303,EVEREST COLLEGE - FORT WORTH SOUTH      ,TX,76115-1407,Proprietary  ,111,401,512,171,648,819
00494900,BAYLOR COLLEGE OF MEDICINE              ,TX,77030-0000,Private      ,211,461,672,737,1749,2486
00495100,UNIV OF TEXAS HEALTH SCIENCE CENTER     ,TX,77225-0000,Public       ,328,1460,1788,1046,3742,4788
00495200,UNIV OF TEXAS MEDICAL BRANCH            ,TX,77550-0000,Public       ,248,1070,1318,811,2502,3313
00497200,GALVESTON COLLEGE                       ,TX,77550-7447,Public       ,355,668,1023,742,1123,1865
00497700,SOUTH TEXAS COLLEGE OF LAW              ,TX,77002-0000,Private      ,27,629,656,92,1596,1688
00660600,BAPTIST HS SCHOOL OF HEALTH PROFESSIONS ,TX,78229-3234,Proprietary  ,94,420,514,250,1083,1333
00661200,COVENANT SCH OF NSG & ALLIED HEALTH     ,TX,79410-0000,Private      ,72,203,275,149,345,494
00666100,ANGELINA COLLEGE                        ,TX,75902-0000,Public       ,721,1130,1851,1672,2022,3694
00694100,DALLAS CHRISTIAN COLLEGE                ,TX,75234-7229,Private      ,123,190,313,272,360,632
00709600,COLLEGE OF THE MAINLAND                 ,TX,77591-2499,Public       ,432,1103,1535,875,1892,2767
00728700,BRAZOSPORT COLLEGE                      ,TX,77566-3199,Public       ,558,770,1328,1039,1311,2350
00732907,ITT TECHNICAL INSTITUTE                 ,TX,77063-3751,Proprietary  ,110,359,469,278,746,1024
00732913,ITT TECHNICAL INSTITUTE                 ,TX,76011-3919,Proprietary  ,135,601,736,238,951,1189
00732975,ITT TECHNICAL INSTITUTE                 ,TX,78249-3303,Proprietary  ,117,350,467,259,679,938
00793804,LINCOLN COLLEGE OF TECHNOLOGY - GRAND PR,TX,75052-7605,Proprietary  ,379,302,681,551,451,1002
00849800,MIMS CLASSIC BEAUTY COLLEGE             ,TX,78216-0000,Proprietary  ,16,29,45,31,46,77
00850300,MOUNTAIN VIEW COLLEGE                   ,TX,75211-6599,Public       ,1595,2239,3834,3304,4018,7322
00850400,RICHLAND COLLEGE                        ,TX,75243-2199,Public       ,2019,3124,5143,4504,5776,10280
00851000,EASTFIELD COLLEGE                       ,TX,75150-2099,Public       ,1787,2641,4428,3708,4968,8676
00907905,EVEREST COLLEGE                         ,TX,75206-5209,Proprietary  ,110,454,564,212,839,1051
00908200,INTERNATIONAL BUSINESS COLLEGE          ,TX,79903-0000,Proprietary  ,34,85,119,90,187,277
00916300,SAN ANTONIO COLLEGE                     ,TX,78212-4299,Public       ,4663,6510,11173,10208,12582,22790
00922500,TEXAS STATE TECHNICAL COLLEGE  HARLINGEN,TX,78550-3697,Public       ,1070,1113,2183,3331,2352,5683
00946600,KAPLAN COLLEGE                          ,TX,78216-1899,Proprietary  ,92,348,440,204,755,959
00946607,KAPLAN COLLEGE - MCALLEN                ,TX,78503-1622,Proprietary  ,138,198,336,273,366,639
00946609,KAPLAN COLLEGE - CAREER CENTERS OF TEXAS,TX,78416-9900,Proprietary  ,68,285,353,122,506,628
00946610,KAPLAN COLLEGE - CAREER CENTERS OF TEXAS,TX,76103-2310,Proprietary  ,79,291,370,123,511,634
00954900,WESTERN TEXAS COLLEGE                   ,TX,79549-9501,Public       ,230,123,353,460,227,687
00965100,TEXAS A&M INTERNATIONAL UNIVERSITY      ,TX,78041-1900,Public       ,1166,979,2145,6109,2330,8439
00974100,UNIVERSITY OF TEXAS AT DALLAS           ,TX,75083-0000,Public       ,2913,3294,6207,13117,7753,20870
00976800,UNIVERSITY OF NORTH TEXAS HEALTH SCIENCE,TX,76107-2699,Public       ,136,1016,1152,415,2634,3049
00979700,MIDLAND COLLEGE                         ,TX,79705-6397,Public       ,604,989,1593,1145,1577,2722
00982802,EVEREST INSTITUTE- AUSTIN               ,TX,78754-0000,Proprietary  ,72,263,335,126,451,577
00993000,UNIVERSITY OF TEXAS-PERMIAN BASIN       ,TX,79762-0001,Public       ,807,1239,2046,1992,2271,4263
00993200,TEXAS STATE TECH CLG-WEST TEXAS         ,TX,79556-4108,Public       ,177,406,583,425,749,1174
01001900,UNIV OF TEXAS SOUTHWESTERN MED CTR      ,TX,75390-9096,Public       ,113,471,584,327,1858,2185
01006000,VERNON COLLEGE                          ,TX,76384-4092,Public       ,465,913,1378,954,1634,2588
01011500,UNIVERSITY OF TEXAS-SAN ANTONIO         ,TX,78249-0600,Public       ,6482,5077,11559,32826,13786,46612
01013000,WADE COLLEGE                            ,TX,75207-3199,Proprietary  ,82,121,203,157,229,386
01038700,EL PASO COMMUNITY COLLEGE               ,TX,79998-0000,Public       ,4830,4729,9559,12555,9921,22476
01050900,HALLMARK COLLEGE OF AERONAUTICS         ,TX,78214-0000,Private      ,98,372,470,164,579,743
01062400,LIGHTHOUSE CAREER INSTITUTE             ,TX,75231-5033,Private      ,2,20,22,4,37,41
01063300,HOUSTON COMMUNITY COLLEGE               ,TX,77002-0000,Public       ,7480,16767,24247,17208,32190,49398
01067400,TEXAS TECH U HEALTH SCIENCES CENTER     ,TX,79430-0000,Public       ,433,2160,2593,1408,4614,6022
01076100,DALLAS INSTITUTE OF FUNERAL SERVICE     ,TX,75227-4314,Private      ,38,130,168,75,241,316
01114500,LONE STAR COLLEGE SYSTEM                ,TX,77073-3499,Public       ,7785,12864,20649,17220,25748,42968
01116100,TEXAS A&M UNIV CORPUS CHRISTI           ,TX,78412-5599,Public       ,3155,2220,5375,12419,4731,17150
01116300,UNIVERSITY OF TEXAS AT TYLER            ,TX,75799-6699,Public       ,1681,2432,4113,4854,4777,9631
01171100,UNIVERSITY OF HOUSTON-CLEAR LAKE        ,TX,77058-1002,Public       ,1021,2645,3666,2986,5871,8857
01201500,AUSTIN COMMUNITY COLLEGE                ,TX,78752-4390,Public       ,4791,6683,11474,13251,14411,27662
01202000,VICTORIA BEAUTY COLLEGE                 ,TX,77901-6233,Proprietary  ,20,49,69,29,75,104
01226800,BALDWIN BEAUTY SCHOOL #5                ,TX,78704-4785,Proprietary  ,32,97,129,91,202,293
01229700,LAREDO BEAUTY COLLEGE                   ,TX,78040-1051,Proprietary  ,43,77,120,79,127,206
01248200,ATI TECHNICAL TRAINING CENTER           ,TX,75235-4622,Proprietary  ,33,93,126,67,181,248
01248209,ATI CAREER TRAINING CENTER - GARLAND    ,TX,75041-2497,Proprietary  ,6,26,32,14,48,62
01248210,ATI CAREER TRAINING CENTER - WACO       ,TX,76711-1682,Proprietary  ,27,38,65,60,95,155
01248300,COSMETOLOGY CAREER CENTER-A PAUL MITCHEL,TX,75006-2567,Proprietary  ,206,262,468,316,410,726
01248800,INTERNATIONAL BEAUTY COLLEGE NO 3       ,TX,75040-0000,Proprietary  ,10,30,40,14,49,63
01276400,METROPLEX BEAUTY SCHOOL                 ,TX,75149-0000,Proprietary  ,10,53,63,16,76,92
01293000,CHARLES & SUE'S SCH OF HAIR DESIGN      ,TX,77801-0000,Proprietary  ,26,32,58,43,63,106
01293200,TINT SCHOOL OF MAKEUP & COSMETOLOGY     ,TX,75061-4235,Proprietary  ,22,46,68,41,96,137
01300300,NEILSON BEAUTY COLLEGE                  ,TX,75208-4637,Proprietary  ,14,37,51,26,64,90
01301600,OGLE SCHOOL HAIR SKIN NAILS             ,TX,76013-7400,Proprietary  ,149,262,411,238,419,657
01303912,SOUTH UNIVERSITY - THE ART INSTITUTE OF ,TX,75231-5993,Proprietary  ,354,313,667,815,573,1388
01303915,SOUTH UNIVERSITY - AUSTIN               ,TX,78729-8101,Proprietary  ,63,312,375,181,564,745
01323100,UNIVERSITY OF HOUSTON-VICTORIA          ,TX,77901-5731,Public       ,677,1331,2008,2771,2820,5591
02058600,CONLEE'S COLLEGE OF COSMETOLOGY         ,TX,78028-0000,Proprietary  ,2,14,16,4,28,32
02077400,NORTH LAKE COLLEGE                      ,TX,75038-0000,Public       ,1125,2083,3208,2404,3799,6203
02081400,ARLINGTON BAPTIST COLLEGE               ,TX,76012-0000,Private      ,103,125,228,194,219,413
02098300,WESTERN TECHNICAL COLLEGE               ,TX,79927-2105,Proprietary  ,377,742,1119,691,1265,1956
02100200,BROOKHAVEN COLLEGE                      ,TX,75244-0000,Public       ,1045,2050,3095,2229,3869,6098
02113610,AMERICAN INTERCONTINENTAL UNIV - HOUSTON,TX,77042-4516,Proprietary  ,53,314,367,142,692,834
02116008,SANFORD-BROWN COLLEGE - HOUSTON         ,TX,77042-8900,Proprietary  ,103,364,467,222,718,940
02117100,ART INSTITUTE OF HOUSTON                ,TX,77056-0000,Proprietary  ,1276,1432,2708,2877,2774,5651
02128302,INSTITUTE FOR BUSINESS & TECHNOLOGY - LA,TX,78230-2520,Proprietary  ,44,140,184,89,236,325
02144800,VET TECH INSTITUTE OF HOUSTON           ,TX,77027-9881,Proprietary  ,157,162,319,323,306,629
02176100,PIPO ACADEMY OF HAIR DESIGN             ,TX,79903-0000,Proprietary  ,16,45,61,39,73,112
02218300,SOUTHWEST SCHOOL OF BUSINESS & TECHNICAL,TX,78221-0000,Proprietary  ,28,88,116,53,141,194
02218305,SOUTHWEST SCHOOL OF BUSINESS AND TECHNIC,TX,78501-6053,Proprietary  ,18,23,41,38,61,99
02224600,TRI-STATE BEAUTY SCHOOL #1              ,TX,79915-0000,Proprietary  ,35,124,159,81,180,261
02230500,OGLE SCHOOL HAIR SKIN NAILS             ,TX,76132-3638,Proprietary  ,131,351,482,232,546,778
02230600,OGLE SCHOOL HAIR SKIN NAILS             ,TX,76053-4650,Proprietary  ,66,197,263,112,269,381
02239100,CENTRAL TEXAS BEAUTY COLLEGE #2         ,TX,78664-4204,Proprietary  ,48,115,163,78,193,271
02248200,MILAN INSTITUTE OF COSMETOLOGY          ,TX,79103-0000,Proprietary  ,165,448,613,253,684,937
02250603,EVEREST COLLEGE - ARLINGTON             ,TX,76011-6630,Proprietary  ,63,294,357,106,482,588
02254800,TEXAS VOCATIONAL SCHOOLS                ,TX,77901-0000,Proprietary  ,13,41,54,20,79,99
02259400,AMBERTON UNIVERSITY                     ,TX,75041-0000,Private      ,10,136,146,30,261,291
02261300,EVEREST INSTITUTE                       ,TX,78213-3841,Proprietary  ,52,250,302,87,427,514
02261302,EVEREST INSTITUTE - HOUSTON GREENSPOINT ,TX,77060-3249,Proprietary  ,83,345,428,147,624,771
02261303,EVEREST INSTITUTE - HOUSTON HOBBY       ,TX,77087-2737,Proprietary  ,66,284,350,106,463,569
02267100,EXPOSITO SCHOOL OF HAIR DESIGN          ,TX,79109-0000,Proprietary  ,8,28,36,14,49,63
02285900,UNIVERSITY OF COSMETOLOGY ARTS&SCI      ,TX,78504-0000,Proprietary  ,92,196,288,169,282,451
02298501,EVEREST COLLEGE- FORT WORTH             ,TX,76137-2472,Proprietary  ,34,139,173,67,292,359
02305300,PARKER COLLEGE OF CHIROPRACTIC          ,TX,75229-0000,Private      ,41,417,458,79,1010,1089
02306700,FORT WORTH BEAUTY SCHOOL                ,TX,76116-3299,Proprietary  ,33,96,129,61,182,243
02306809,SOUTH TEXAS VOCATIONAL TECHNICAL INSTITU,TX,78501-2400,Proprietary  ,129,165,294,275,299,574
02306810,SOUTH TEXAS VOCATIONAL TECHNICAL INSTITU,TX,78416-1141,Proprietary  ,51,205,256,80,313,393
02312200,TEXAS SCHOOL OF BUSINESS                ,TX,77073-6032,Proprietary  ,86,337,423,194,631,825
02312202,TEXAS SCHOOL OF BUSINESS - FRIENDSWOOD C,TX,77546-8938,Proprietary  ,13,69,82,22,155,177
02313901,WESTWOOD COLLEGE - DALLAS               ,TX,75243-0000,Proprietary  ,32,90,122,75,201,276
02315400,NORTHEAST TEXAS COMMUNITY COLLEGE       ,TX,75456-0000,Public       ,524,732,1256,1080,1227,2307
02318200,"KD STUDIO, ACTOR'S CONSERVATORY         ",TX,75207-2111,Proprietary  ,78,78,156,138,144,282
02320200,HOUSTON GRADUATE SCHOOL OF THEOLOGY     ,TX,77092-0000,Private      ,5,99,104,11,159,170
02326000,SAN ANTONIO BEAUTY COLLEGE NO 3         ,TX,78217-0000,Proprietary  ,33,54,87,66,102,168
02331200,BAPTIST MISSIONARY ASSN THEOL SEM       ,TX,75766-0000,Private      ,2,26,28,4,50,54
02331300,INTERACTIVE LEARNING SYSTEMS            ,TX,77502-1201,Proprietary  ,14,110,124,16,121,137
02331301,INTERACTIVE LEARNING SYSTEMS            ,TX,77081-0000,Proprietary  ,39,230,269,54,331,385
02331304,INTERACTIVE LEARNING SYSTEMS            ,TX,77060-0000,Proprietary  ,14,81,95,22,112,134
02341300,PALO ALTO COLLEGE                       ,TX,78224-0000,Public       ,2420,2651,5071,4966,4856,9822
02348500,LAMAR STATE COLLEGE-PORT ARTHUR         ,TX,77640-0000,Public       ,369,540,909,775,1087,1862
02357700,PAUL MITCHELL THE SCHOOL                ,TX,77043-3412,Proprietary  ,109,259,368,241,478,719
02358200,LAMAR STATE COLLEGE-ORANGE              ,TX,77630-0000,Public       ,274,625,899,596,1077,1673
02361400,COLLIN COUNTY COMMUNITY COLLEGE         ,TX,75071-0000,Public       ,2848,3730,6578,6174,7215,13389
02362000,UNIVERSAL TECHNICAL INSTITUTE           ,TX,77073-0000,Proprietary  ,2206,2029,4235,9581,7148,16729
02362800,AUSTIN GRADUATE SCHOOL OF THEOLOGY      ,TX,78752-1333,Private      ,5,34,39,18,65,83
02521200,ARLINGTON CAREER INSTITUTE              ,TX,75050-0000,Proprietary  ,20,134,154,42,236,278
02521800,SEGUIN BEAUTY SCHOOL                    ,TX,78155-0000,Proprietary  ,13,21,34,24,52,76
02527500,HOUSTON TRAINING SCHOOLS                ,TX,77029-0000,Proprietary  ,30,137,167,79,285,364
02530700,SEBRING CAREER SCHOOLS                  ,TX,77083-1510,Proprietary  ,7,17,24,12,32,44
02548800,SOUTH TEXAS VO-TECH INSTITUTE           ,TX,78596-0000,Proprietary  ,72,102,174,164,156,320
02548802,SOUTH TEXAS VOCATIONAL TECHNICAL INSTITU,TX,78520-8710,Proprietary  ,83,112,195,198,188,386
02555400,UNIV OF TX MD ANDERSON CANCER CTR       ,TX,77030-0000,Public       ,77,244,321,225,507,732
02568100,TEXAS BARBER COLLEGE                    ,TX,77063-3949,Proprietary  ,39,147,186,68,266,334
02568101,TEXAS BARBER COLLEGES & HAIRSTYLING SCHO,TX,75228-3841,Proprietary  ,24,90,114,41,172,213
02568106,TEXAS BARBER COLLEGES & HAIRSTYLING SCHO,TX,77009-0000,Proprietary  ,27,105,132,60,206,266
02568107,TEXAS BARBER COLLEGES & HAIRSTYLING SCHO,TX,77063-3951,Proprietary  ,28,103,131,53,207,260
02568108,TEXAS BARBER COLLEGES & HAIRSTYLING SCHO,TX,75241-1327,Proprietary  ,29,103,132,55,188,243
02568109,TEXAS BARBER COLLEGES & HAIRSTYLING SCHO,TX,77301-4407,Proprietary  ,0,0,0,0,4,4
02569300,LE CORDON BLEU COLLEGE OF CULINARY ARTS ,TX,78758-3647,Proprietary  ,359,779,1138,752,1657,2409
02572000,COMPUTER CAREER CENTER                  ,TX,79925-2021,Proprietary  ,262,765,1027,362,999,1361
02572004,COMPUTER CAREER CENTER - AMARILLO CAMPUS,TX,79101-2404,Proprietary  ,26,164,190,31,209,240
02572005,COMPUTER CAREER CENTER - LUBBOCK CAMPUS ,TX,79414-3517,Proprietary  ,47,212,259,55,274,329
02572008,VISTA COLLEGE - BEAUMONT                ,TX,77701-3717,Proprietary  ,63,269,332,90,466,556
02572009,VISTA COLLEGE - LONGVIEW                ,TX,75604-1905,Proprietary  ,40,313,353,68,469,537
02572011,VISTA COLLEGE - KILLEEN                 ,TX,76541-7436,Proprietary  ,77,534,611,124,934,1058
02572012,VISTA COLLEGE - COLLEGE STATION         ,TX,77840-5107,Proprietary  ,88,324,412,171,471,642
02591100,CAREER POINT COLLEGE                    ,TX,78201-2027,Proprietary  ,109,951,1060,178,1326,1504
02591900,KAPLAN COLLEGE                          ,TX,79907-1525,Proprietary  ,122,310,432,274,620,894
02591905,KAPLAN COLLEGE - BROWNSVILLE            ,TX,78521-9905,Proprietary  ,56,131,187,139,243,382
02596500,ATI CAREER TRAINING CENTER              ,TX,76180-1599,Proprietary  ,5,29,34,12,54,66
02596503,ATI- CAREER TRAINING CENTER - HOUSTON (#,TX,77029-1978,Proprietary  ,15,71,86,33,135,168
02596600,ATI-CAREER TRAINING CENTER              ,TX,75220-4443,Proprietary  ,14,69,83,23,119,142
02596601,ATI CAREER TRAINING CENTER - RICHARDSON ,TX,75081-1948,Proprietary  ,4,23,27,11,40,51
02596602,ATI CAREER TRAINING CENTER - DALLAS (STE,TX,75247-6103,Proprietary  ,25,113,138,46,225,271
02600200,OCEAN CORPORATION (THE)                 ,TX,77099-3479,Proprietary  ,54,257,311,106,467,573
02604700,CENTER FOR ADVANCED LEGAL STUDIES       ,TX,77098-4151,Proprietary  ,9,151,160,25,346,371
02606202,EVEREST COLLEGE - EVEREST INSTITUTE - BI,TX,77036-8014,Proprietary  ,111,443,554,204,764,968
02615000,SANFORD-BROWN COLLEGE                   ,TX,75247-6931,Proprietary  ,62,256,318,134,511,645
03009400,SW SCH BUS & TECH CAREERS               ,TX,78212-2840,Proprietary  ,15,47,62,25,78,103
03010604,VIRGINIA COLLEGE - VIRGINIA COLLEGE AT A,TX,78723-0000,Proprietary  ,61,183,244,126,420,546
03011800,UNIVERSITY OF COSMETOLOGY ARTS & SCIENCE,TX,78226-1194,Proprietary  ,33,43,76,87,107,194
03019800,PCI HEALTH TRAINING CENTER              ,TX,75247-4720,Proprietary  ,57,199,256,118,360,478
03019801,PCI HEALTH TRAINING CENTER - RICHARDSON ,TX,75081-2321,Proprietary  ,39,78,117,57,128,185
03021500,SW SCH BUS & TECH CAREERS               ,TX,78852-4859,Proprietary  ,69,95,164,136,143,279
03025000,TEXAS COLLEGE OF COSMETOLOGY            ,TX,79605-2001,Proprietary  ,41,127,168,64,172,236
03025001,TEXAS COLLEGE OF COSMETOLOGY - SAN ANGEL,TX,76903-4708,Proprietary  ,14,46,60,29,80,109
03026500,REMINGTON COLLEGE - HOUSTON CAMPUS      ,TX,77082-1849,Private      ,757,2501,3258,1066,3897,4963
03026501,REMINGTON COLLEGE - NORTH HOUSTON CAMPUS,TX,77067-1849,Private      ,55,213,268,136,419,555
03026506,REMINGTON COLLEGE - FT. WORTH CAMPUS    ,TX,76112-1280,Private      ,137,389,526,206,666,872
03028800,CIRCLE J BEAUTY SCHOOL                  ,TX,77587-3714,Proprietary  ,16,29,45,34,63,97
03030608,UTAH COLLEGE OF MASSAGE THERAPY - TEXAS ,TX,75801-4848,Proprietary  ,36,105,141,48,153,201
03030609,UTAH COLLEGE OF MASSAGE THERAPY - TEXAS ,TX,77040-6307,Proprietary  ,27,100,127,50,183,233
03031408,INTERNATIONAL ACADEMY OF DESIGN & TECHNO,TX,78229-2263,Proprietary  ,50,144,194,105,274,379
03032300,SCHOOL OF AUTOMOTIVE MACHINISTS         ,TX,77055-1803,Proprietary  ,46,104,150,111,218,329
03035200,TINT SCHOOL OF MAKEUP & COSMETOLOGY     ,TX,75229-3734,Proprietary  ,36,121,157,76,209,285
03035300,SOUTHERN CAREERS INSTITUTE              ,TX,78704-5252,Proprietary  ,271,954,1225,341,1251,1592
03035301,SOUTHERN CAREERS INSTITUTE-PHARR        ,TX,78577-2118,Proprietary  ,42,126,168,63,182,245
03035302,SOUTHERN CAREERS INSTITUTE - CORPUS CHRI,TX,78414-2904,Proprietary  ,38,218,256,65,308,373
03035303,SOUTHERN CAREERS INSTITUTE - SAN ANTONIO,TX,78221-4351,Proprietary  ,27,65,92,47,125,172
03035305,SOUTHERN CAREERS INSTITUTE - BROWNSVILLE,TX,78520-8680,Proprietary  ,38,47,85,104,100,204
03035306,SOUTHERN CAREERS INSTITUTE - HARLINGEN  ,TX,78550-7911,Proprietary  ,23,43,66,66,92,158
03035308,SOUTHERN CAREERS INSTITUTE - SAN ANTONIO,TX,78238-4114,Proprietary  ,52,168,220,67,260,327
03061800,STAR COLLEGE OF COSMETOLOGY             ,TX,75702-8214,Proprietary  ,30,102,132,66,166,232
03064600,UNIVERSITY OF TEXAS AT BROWNSVILLE      ,TX,78520-4993,Public       ,1234,1558,2792,5190,3915,9105
03073402,ITT TECHNICAL INSTITUTE                 ,TX,75080-2208,Proprietary  ,0,1,1,0,2,2
03103400,SOUTH TEXAS COLLEGE                     ,TX,78501-6699,Public       ,4160,3854,8014,12674,7696,20370
03108700,ROYAL BEAUTY CAREERS                    ,TX,77069-4611,Proprietary  ,17,89,106,41,166,207
03115800,KAPLAN COLLEGE                          ,TX,78238-4203,Proprietary  ,98,361,459,155,684,839
03115802,KAPLAN COLLEGE - LAREDO                 ,TX,78041-6181,Proprietary  ,88,116,204,128,184,312
03115803,KAPLAN COLLEGE - BEAUMONT               ,TX,77706-3706,Proprietary  ,30,158,188,58,300,358
03115804,KAPLAN COLLEGE - LUBBOCK                ,TX,79401-2601,Proprietary  ,37,181,218,55,294,349
03128100,COLLEGE OF HEALTH CARE PROFESSIONS (THE),TX,77092-8108,Proprietary  ,301,1126,1427,564,2139,2703
03144300,NATIONAL BEAUTY COLLEGE                 ,TX,75043-4046,Proprietary  ,4,23,27,8,44,52
03153300,AMER COLL OF ACUPUNCTURE & O.M.         ,TX,77063-4104,Proprietary  ,5,48,53,15,100,115
03156400,AOMA                                    ,TX,78745-1479,Proprietary  ,7,104,111,15,183,198
03159300,ARLINGTON MEDICAL INSTITUTE             ,TX,76006-2317,Proprietary  ,44,123,167,117,265,382
03170300,TEXAS A&M UNIVERSITY-TEXARKANA          ,TX,75503-5518,Public       ,486,758,1244,1332,1375,2707
03179500,TEXAS HEALTH AND SCIENCE UNIVERSITY     ,TX,78704-6748,Proprietary  ,87,187,274,283,447,730
03237400,FARIS TECHNICAL INSTITUTE               ,TX,77627-3829,Proprietary  ,0,3,3,1,5,6
03272300,KAPLAN COLLEGE                          ,TX,75234-7288,Proprietary  ,115,477,592,196,873,1069
03272303,KAPLAN COLLEGE - ARLINGTON              ,TX,76010-8121,Proprietary  ,67,305,372,114,555,669
03275300,TOUCH OF CLASS SCHOOL OF COSM           ,TX,75402-6314,Proprietary  ,16,52,68,25,87,112
03276300,ACADEMY OF HAIR DESIGN                  ,TX,75901-4900,Proprietary  ,21,72,93,35,121,156
03277300,ACADEMY OF HAIR DESIGN                  ,TX,77701-4650,Proprietary  ,12,51,63,24,87,111
03303300,NORTHWEST EDUCATIONAL CENTER            ,TX,77092-7055,Proprietary  ,13,100,113,23,143,166
03371300,TONI&GUY HAIRDRESSING ACADEMY           ,TX,75006-0000,Proprietary  ,47,72,119,80,120,200
03372300,NORTHWEST VISTA COLLEGE                 ,TX,78251-4217,Public       ,3914,3777,7691,8484,7283,15767
03396500,TEXAS STATE TECHNICAL COLG/MARSHALL     ,TX,75672-7402,Public       ,189,204,393,345,331,676
03400300,CAREER QUEST                            ,TX,78229-3539,Proprietary  ,23,155,178,43,245,288
03412300,ADVANCED BARBER COLLEGE & HAIR DESI     ,TX,78596-0000,Proprietary  ,38,68,106,67,96,163
03416500,DALLAS NURSING INSTITUTE                ,TX,75243-5502,Private      ,106,468,574,220,921,1141
03422300,MILAN INSTITUTE                         ,TX,78238-3327,Proprietary  ,204,550,754,379,991,1370
03422400,COLLEGE OF BIBLICAL STUDIES-HOUSTON     ,TX,77036-3211,Private      ,24,307,331,65,596,661
03424400,MEDVANCE INSTITUTE                      ,TX,77057-7386,Proprietary  ,63,236,299,87,387,474
03426300,COLLEGE OF HEALTH CARE PROFESSIONS (THE),TX,78752-3630,Proprietary  ,104,313,417,196,559,755
03480304,FORTIS COLLEGE - FORTIS INSTITUTE       ,TX,75050-2342,Proprietary  ,27,128,155,39,234,273
03520300,LUBBOCK HAIR ACADEMY                    ,TX,79410-3524,Proprietary  ,16,42,58,29,82,111
03542300,CONCORDE CAREER INSTITUTE               ,TX,76011-4016,Proprietary  ,120,485,605,198,842,1040
03556400,KUSSAD INSTITUTE OF COURT REPORTING     ,TX,78704-5712,Proprietary  ,2,6,8,6,11,17
03573300,AVIATION INSTITUTE OF MAINTENANCE       ,TX,75062-6303,Proprietary  ,62,177,239,92,278,370
03610300,MJ'S BEAUTY ACADEMY INC                 ,TX,75224-0000,Proprietary  ,20,52,72,42,107,149
03612400,VALLEY GRANDE INSTITUTE FOR ACADEMI     ,TX,78596-0000,Private      ,40,105,145,79,196,275
03627300,LAMAR INSTITUTE OF TECHNOLOGY           ,TX,77705-4142,Public       ,629,927,1556,1340,1719,3059
03680300,JAY'S TECHNICAL INSTITUTE               ,TX,77031-3509,Proprietary  ,9,40,49,23,77,100
03682400,DALLAS BARBER & STYLIST COLLEGE         ,TX,75231-0000,Proprietary  ,40,203,243,75,341,416
03714300,TREND BARBER COLLEGE                    ,TX,77071-2104,Proprietary  ,22,90,112,41,178,219
03723300,CULINARY INST ALAIN & MARIE LENOTRE     ,TX,77022-4322,Proprietary  ,71,215,286,177,391,568
03727600,AUGUSTE ESCOFFIER SCHOOL OF CULINARY ART,TX,78752-0000,Proprietary  ,92,139,231,286,256,542
03733300,BAPTIST UNIVERSITY OF THE AMERICAS      ,TX,78224-1336,Private      ,20,94,114,69,202,271
03922300,SOUTH TEXAS BARBER COLLEGE              ,TX,78415-3463,Proprietary  ,10,48,58,26,77,103
03944400,PROFESSIONAL CAREERS INSTITUTE          ,TX,77036-2252,Proprietary  ,5,40,45,19,86,105
03944401,PROFESSIONAL CAREERS INSTITUTE          ,TX,77090-3914,Proprietary  ,8,32,40,18,61,79
03970300,HANDS ON THERAPY                        ,TX,75149-2294,Proprietary  ,21,57,78,23,84,107
03987300,TEXAS HEALTH SCHOOL                     ,TX,77079-2106,Proprietary  ,76,191,267,204,411,615
04036300,SOUTHEAST TEXAS CAREER INSTITUTE        ,TX,77656-8601,Proprietary  ,7,31,38,14,56,70
04045300,NORTHWEST BEAUTY SCHOOL                 ,TX,77091-1208,Proprietary  ,19,59,78,40,120,160
04045400,MAI-TRIX BEAUTY COLLEGE                 ,TX,77040-0000,Proprietary  ,12,57,69,32,100,132
04082300,PROFESSIONAL CAREER TRAINING INSTITUTE  ,TX,77090-0000,Proprietary  ,13,126,139,27,184,211
04089400,CCI TRAINING CENTER                     ,TX,76011-4857,Proprietary  ,12,79,91,20,164,184
04117900,CHAMPION BEAUTY COLLEGE                 ,TX,77069-4611,Proprietary  ,22,88,110,53,183,236
04121800,CRISWELL COLLEGE                        ,TX,75246-1537,Private      ,40,135,175,77,245,322
04125400,ACADEMY AT AUSTIN (THE)                 ,TX,78660-3287,Proprietary  ,36,67,103,59,102,161
04125500,MANUEL AND THERESA'S SCHOOL OF HAIR DESI,TX,77803-3236,Proprietary  ,13,27,40,18,42,60
04129800,MEDIATECH INSTITUTE DALLAS              ,TX,75039-3105,Proprietary  ,68,104,172,107,165,272
04129801,MEDIATECH INSTITUTE - AUSTIN            ,TX,78704-8933,Proprietary  ,34,78,112,61,116,177
04129802,MEDIATECH INSTITUTE - HOUSTON           ,TX,77042-4712,Proprietary  ,25,72,97,50,136,186
04131700,SOUTHWEST CAREER COLLEGE                ,TX,79925-6230,Proprietary  ,364,730,1094,716,1201,1917
04136500,PCCENTER                                ,TX,75115-4214,Proprietary  ,11,27,38,12,38,50
04138500,CARDIOTECH ULTRASOUND SCHOOL            ,TX,77099-1440,Proprietary  ,32,141,173,71,296,367
04142300,AVEDA INSTITUTE SAN ANTONIO             ,TX,78215-1260,Proprietary  ,93,157,250,186,294,480
04146700,AVIATION INSTITUTE OF MAINTENANCE       ,TX,77061-4004,Proprietary  ,45,141,186,89,236,325
04146800,SOUTH TEXAS TRAINING CENTER             ,TX,78586-7721,Proprietary  ,27,69,96,31,88,119
04152700,ASTRODOME CAREER CENTERS                ,TX,77054-2678,Proprietary  ,7,41,48,21,81,102
04154800,DUVALL'S SCHOOL OF COSMETOLOGY          ,TX,76021-4159,Proprietary  ,17,27,44,22,45,67
04155800,ADVANCED BEAUTY COLLEGE                 ,TX,75061-1918,Proprietary  ,9,27,36,19,42,61
04158500,TEXAS BEAUTY COLLEGE                    ,TX,76117-3201,Proprietary  ,3,13,16,6,20,26
04160700,AVENUE FIVE INSTITUTE                   ,TX,78757-7000,Proprietary  ,43,120,163,100,229,329
04165800,SALON PROFESSIONAL ACADEMY (THE)        ,TX,75067-2348,Proprietary  ,9,28,37,21,45,66
04168700,LAWYER'S ASSISTANT SCHOOL OF DALLAS     ,TX,75201-2829,Proprietary  ,22,122,144,44,224,268
04168800,ABC BEAUTY ACADEMY                      ,TX,75042-8682,Proprietary  ,6,22,28,16,49,65
04169000,SALON & SPA INSTITUTE                   ,TX,78521-1727,Proprietary  ,16,41,57,16,41,57
04169100,DIAMONDS COSMETOLOGY COLLEGE            ,TX,75090-2657,Proprietary  ,8,29,37,12,39,51
04177900,BUCKNER BARBER SCHOOL                   ,TX,75217-1775,Proprietary  ,13,58,71,28,102,130
04178200,VOGUE COLLEGE - SAN ANTONIO             ,TX,78201-5035,Proprietary  ,22,65,87,49,102,151
04178300,VOGUE BEAUTY ACADEMY                    ,TX,78238-4402,Proprietary  ,26,48,74,59,93,152
04178400,VOGUE COLLEGE - MCALLEN                 ,TX,78501-1945,Proprietary  ,39,53,92,81,82,163
04179500,NORTH AMERICAN UNIVERSITY               ,TX,77038-1221,Private      ,92,97,189,251,204,455
04184800,EXCEL LEARNING CENTER                   ,TX,79907-1400,Proprietary  ,30,129,159,58,181,239
04187800,CYBERTEX INSTITUTE OF TECHNOLOGY        ,TX,78752-3825,Proprietary  ,19,116,135,39,209,248
04193000,RGV CAREERS AN INSTITUTE FOR HIGHER LEAR,TX,78577-2106,Proprietary  ,19,159,178,38,215,253
04205200,WADE GORDON HAIRDRESSING ACADEMY        ,TX,79121-0548,Proprietary  ,29,53,82,48,93,141
04206501,MYCOMPUTERCAREER.COM - DALLAS           ,TX,75062-8173,Proprietary  ,10,176,186,15,278,293
04206502,MYCOMPUTERCAREER.COM - HOUSTON          ,TX,77056-6764,Proprietary  ,16,158,174,40,243,283
04213300,SPA PROFESSIONALS ACADEMY (THE)         ,TX,78504-2569,Proprietary  ,7,24,31,26,37,63
04215000,TOTAL TRANSFORMATION INSTITUTE OF COSMET,TX,78666-8115,Proprietary  ,17,17,34,39,39,78
04215400,GRACE SCHOOL OF THEOLOGY                ,TX,77384-4894,Private      ,3,34,37,6,71,77
04219700,GEMINI SCHOOL OF VISUAL ARTS & COMMUNICA,TX,78613-2642,Proprietary  ,6,12,18,17,19,36
04222600,HEATHCARE INSTITUTE (THE)               ,TX,78201-5035,Proprietary  ,36,109,145,85,194,279
04224100,COSMETOLOGY ACADEMY OF TEXARKANA        ,TX,75503-4855,Proprietary  ,28,85,113,44,125,169
04226400,MT TRAINING CENTER                      ,TX,75051-3542,Proprietary  ,5,39,44,10,61,71
04229000,BARBER INSTITUTE OF TEXAS               ,TX,75602-3456,Proprietary  ,6,21,27,6,38,44
04229500,TEXAS A&M UNIVERSITY - CENTRAL TEXAS    ,TX,76549-5901,Public       ,442,1693,2135,1453,3348,4801
04231200,NEECEE'S COLLEGE OF COSMETOLOGY         ,TX,79605-4735,Proprietary  ,6,31,37,11,54,65
04231300,YAHWEH BEAUTY ACADEMY                   ,TX,76543-4153,Proprietary  ,11,40,51,24,90,114
04231900,ALAMO CITY BARBER COLLEGE               ,TX,78250-3227,Proprietary  ,66,170,236,115,277,392
04232400,EXCEL LEARNING CENTER - SAN ANTONIO     ,TX,78230-4823,Proprietary  ,12,69,81,19,106,125
04232900,PREPARING PEOPLE BARBER STYLING COLLEGE ,TX,75215-2415,Proprietary  ,4,26,30,8,64,72
04235900,BELLA COSMETOLOGY COLLEGE               ,TX,75494-2408,Proprietary  ,13,39,52,19,51,70
04236900,K&G 5 STAR BARBER COLLEGE               ,TX,77591-3689,Proprietary  ,5,17,22,8,38,46
04238200,LAREDO CHI ACADEMY BEAUTY SCHOOL        ,TX,78041-6540,Proprietary  ,21,37,58,51,73,124
04239700,"VOCATIONAL NURSING INSTITUTE, (THE)     ",TX,77065-5399,Private      ,39,216,255,59,309,368
00367000,BRIGHAM YOUNG UNIVERSITY                ,UT,84602-8406,Private      ,3486,3723,7209,12372,8172,20544
00367100,DIXIE STATE COLLEGE OF UTAH             ,UT,84770-3876,Public       ,1732,1581,3313,4841,2657,7498
00367200,LDS BUSINESS COLLEGE                    ,UT,84101-3500,Private      ,340,373,713,847,692,1539
00367400,STEVENS HENAGER COLLEGE                 ,UT,84401-1420,Proprietary  ,807,6711,7518,1107,10369,11476
00367500,UNIVERSITY OF UTAH                      ,UT,84112-9055,Public       ,3255,4695,7950,13022,12242,25264
00367700,UTAH STATE UNIVERSITY                   ,UT,84322-1400,Public       ,4110,4645,8755,11665,8795,20460
00367800,SOUTHERN UTAH UNIVERSITY                ,UT,84720-2470,Public       ,1546,1284,2830,4649,2249,6898
00367900,SNOW COLLEGE                            ,UT,84627-1299,Public       ,1040,387,1427,2641,718,3359
00368000,WEBER STATE UNIVERSITY                  ,UT,84408-1136,Public       ,2383,4196,6579,6215,8178,14393
00368100,WESTMINSTER COLLEGE                     ,UT,84105-3697,Private      ,503,571,1074,2336,1137,3473
00402700,UTAH VALLEY UNIVERSITY                  ,UT,84058-5999,Public       ,3702,5471,9173,8435,9803,18238
00522000,SALT LAKE COMMUNITY COLLEGE             ,UT,84123-0000,Public       ,2813,5399,8212,5817,9642,15459
00732953,ITT TECHNICAL INSTITUTE                 ,UT,84123-2500,Proprietary  ,110,636,746,183,1077,1260
00943300,SHERMAN KENDALL'S ACADEMY OF BEAUTY     ,UT,84106-1836,Proprietary  ,12,20,32,16,47,63
01009800,NEUMONT UNIVERSITY                      ,UT,84095-0000,Proprietary  ,174,36,210,772,105,877
01116500,UINTAH BASIN APPLIED TECHNOLOGY CLG     ,UT,84066-0000,Public       ,11,37,48,23,76,99
01116600,BROADVIEW UNIVERSITY                    ,UT,84088-4021,Proprietary  ,106,345,451,179,536,715
02078800,SHERMAN KENDALL'S ACADEMY OF BEAUTY     ,UT,84047-0000,Proprietary  ,4,11,15,4,16,20
02115400,BRIDGERLAND APPLIED TECHNOLOGY COLLEGE  ,UT,84321-0000,Public       ,152,275,427,326,545,871
02156600,DAVIS APPLIED TECHNOLOGY COLLEGE        ,UT,84037-0000,Public       ,184,571,755,383,997,1380
02178500,EAGLE GATE COLLEGE                      ,UT,84123-0000,Proprietary  ,49,364,413,69,536,605
02270800,AMERITECH COLLEGE                       ,UT,84604-6927,Proprietary  ,42,201,243,62,327,389
02270802,AMERITECH COLLEGE - DRAPER              ,UT,84020-6545,Proprietary  ,32,213,245,54,385,439
02298500,EVEREST COLLEGE                         ,UT,84119-2668,Proprietary  ,10,95,105,35,205,240
02346500,OGDEN-WEBER APPLIED TECHNOLOGY COLG     ,UT,84404-0000,Public       ,200,677,877,435,1236,1671
02360800,PROVO COLLEGE                           ,UT,84601-0000,Proprietary  ,55,233,288,102,372,474
02531800,PAUL MITCHELL THE SCHOOL - PROVO        ,UT,84606-0000,Proprietary  ,35,29,64,71,63,134
02556800,PAUL MITCHELL THE SCHOOL                ,UT,84117-7204,Proprietary  ,54,109,163,106,171,277
02556801,PAUL MITCHELL THE SCHOOL                ,UT,84780-0000,Proprietary  ,16,30,46,32,46,78
02572700,EVANS HAIRSTYLING COLLEGE               ,UT,84770-0000,Proprietary  ,12,10,22,20,22,42
02572800,VISTA COLLEGE                           ,UT,84015-0000,Proprietary  ,9,201,210,22,291,313
02573100,EVANS HAIRSTYLING COLLEGE OF CEDAR CITY ,UT,84720-0000,Proprietary  ,10,12,22,23,24,47
02612200,MARINELLO SCHOOL OF BEAUTY              ,UT,84604-1585,Proprietary  ,16,27,43,27,50,77
03030600,UTAH COLLEGE OF MASSAGE THERAPY         ,UT,84111-1606,Proprietary  ,39,113,152,80,210,290
03030601,UTAH CLG OF MASSAGE THER-PROVO CMPS     ,UT,84042-0000,Proprietary  ,13,32,45,22,59,81
03082100,MYOTHERAPY COLLEGE OF UTAH              ,UT,84115-2522,Proprietary  ,6,22,28,9,52,61
03108200,FRANCOIS D. COLLEGE OF HAIR SKIN & NAILS,UT,84070-2004,Proprietary  ,9,9,18,12,19,31
03110400,HAIRITAGE HAIR ACADEMY                  ,UT,84770-5233,Proprietary  ,15,8,23,26,17,43
03339400,WESTERN GOVERNORS UNIVERSITY            ,UT,84107-2533,Private      ,690,26681,27371,1529,47960,49489
03413300,MOUNTAINLAND APPLIED TECHNOLOGY COLLEGE ,UT,84043-0000,Public       ,87,223,310,176,417,593
03463300,CAREERS UNLIMITED                       ,UT,84058-0000,Proprietary  ,16,39,55,35,116,151
03467308,MARINELLO SCHOOL OF BEAUTY - OGDEN      ,UT,84405-1501,Proprietary  ,17,58,75,32,87,119
03467309,MARINELLO SCHOOL OF BEAUTY - LAYTON     ,UT,84041-3002,Proprietary  ,26,70,96,32,102,134
03617300,HEALING MOUNTAIN MASSAGE SCHOOL         ,UT,84102-4006,Proprietary  ,11,49,60,25,101,126
03829500,SKINWORKS SCHOOL OF ADVANCED SKINCARE   ,UT,84115-0000,Proprietary  ,12,34,46,21,69,90
03838300,NIGHTINGALE COLL. SCH. OF NURSING SCH. O,UT,84403-0000,Proprietary  ,20,177,197,35,294,329
03909300,PAUL MITCHELL THE SCHOOL LOGAN          ,UT,84323-4679,Proprietary  ,27,32,59,64,63,127
03921300,CAMEO COLLEGE OF ESSENTIAL BEAUTY       ,UT,84115-0000,Proprietary  ,26,78,104,54,143,197
04054300,SOUTHWEST APPLIED TECHNOLOGY COLLEGE    ,UT,84720-6608,Public       ,33,58,91,61,125,186
04072300,AVEDA INSTITUTE PROVO                   ,UT,84604-1008,Proprietary  ,33,27,60,58,57,115
04121700,DIXIE APPLIED TECHNOLOGY COLLEGE        ,UT,84770-3025,Public       ,89,118,207,211,237,448
04145500,SKIN SCIENCE INSTITUTE (THE)            ,UT,84115-0000,Proprietary  ,21,38,59,28,84,112
04153000,RENAISSANCE ACADEMIE                    ,UT,84604-0000,Proprietary  ,6,19,25,16,40,56
04161900,MANDALYN ACADEMY                        ,UT,84003-2161,Proprietary  ,7,18,25,11,35,46
04165500,ACAYDIA SCHOOL OF AESTHETICS            ,UT,84601-0000,Proprietary  ,12,17,29,21,33,54
04169900,AMERICAN BEAUTY ACADEMY                 ,UT,84651-0000,Proprietary  ,12,20,32,18,29,47
04173200,TAYLOR ANDREWS ACADEMY OF HAIR DESIGN   ,UT,84088-6577,Proprietary  ,24,40,64,41,72,113
04173201,TAYLOR ANDREWS ACADEMY -  OREM          ,UT,84004-1872,Proprietary  ,32,36,68,59,60,119
04183000,TOP NAILS & HAIR BEAUTY SCHOOL          ,UT,84118-0000,Proprietary  ,10,24,34,13,45,58
04184200,TAYLOR ANDREWS ACADEMY-ST. GEORGE       ,UT,84790-2139,Proprietary  ,33,26,59,53,56,109
04192700,BARBER SCHOOL (THE)                     ,UT,84047-3723,Proprietary  ,5,32,37,15,81,96
04193200,ROCKY MOUNTAIN UNIVERSITY OF HEALTH PROF,UT,84606-7312,Proprietary  ,9,168,177,23,324,347
04210300,MEDSPA ACADEMIES                        ,UT,84095-3519,Proprietary  ,23,45,68,38,85,123
04211500,BEAUTIFUL YOU SCHOOL OF NAIL TECHNOLOGY ,UT,84720-8360,Proprietary  ,3,13,16,12,21,33
04215700,COLE HOLLAND COLLEGE                    ,UT,84102-2959,Proprietary  ,7,14,21,13,38,51
04216800,BONNIE JOSEPH ACADEMY OF COSMETOLOGY & B,UT,84032-2044,Proprietary  ,1,5,6,2,7,9
04218300,MIDWIVES COLLEGE OF UTAH                ,UT,84106-2671,Private      ,8,110,118,23,217,240
00368200,BENNINGTON COLLEGE                      ,VT,05201-6001,Private      ,143,34,177,973,139,1112
00368300,CASTLETON STATE COLLEGE                 ,VT,05735-0000,Public       ,378,102,480,2652,342,2994
00368400,CHAMPLAIN COLLEGE                       ,VT,05401-3950,Private      ,426,620,1046,4100,1289,5389
00368500,COLLEGE OF ST JOSEPH                    ,VT,05701-3899,Private      ,81,53,134,219,127,346
00368600,GODDARD COLLEGE                         ,VT,05667-0000,Private      ,17,256,273,48,513,561
00368700,GREEN MOUNTAIN COLLEGE                  ,VT,05764-1199,Private      ,170,77,247,684,202,886
00368800,JOHNSON STATE COLLEGE                   ,VT,05656-9898,Public       ,268,264,532,1135,617,1752
00368900,LYNDON STATE COLLEGE                    ,VT,05851-0919,Public       ,210,87,297,1599,249,1848
00369000,MARLBORO COLLEGE                        ,VT,05344-0300,Private      ,60,27,87,288,74,362
00369100,MIDDLEBURY COLLEGE                      ,VT,05753-0000,Private      ,508,129,637,4207,505,4712
00369200,NORWICH UNIVERSITY                      ,VT,05663-1035,Private      ,421,481,902,2906,1032,3938
00369300,SOUTHERN VERMONT COLLEGE                ,VT,05201-6002,Private      ,82,40,122,526,123,649
00369400,ST MICHAELS COLLEGE                     ,VT,05439-0001,Private      ,422,44,466,3981,131,4112
00369600,UNIVERSITY OF VERMONT                   ,VT,05405-0160,Public       ,506,412,918,19323,2699,22022
00369700,VERMONT COLLEGE OF FINE ARTS            ,VT,05602-3128,Private      ,2,110,112,11,279,290
00369800,VERMONT TECHNICAL COLLEGE               ,VT,05061-0000,Public       ,186,215,401,899,689,1588
00865800,O'BRIENS AVEDA INSTITUTE                ,VT,05403-7747,Proprietary  ,16,49,65,41,74,115
00886000,SIT                                     ,VT,05301-4801,Private      ,59,108,167,183,376,559
01116700,COMMUNITY COLLEGE OF VERMONT            ,VT,05676-0000,Public       ,357,948,1305,983,2124,3107
01193400,VERMONT LAW SCHOOL                      ,VT,05068-0000,Private      ,1,253,254,6,746,752
01218300,BURLINGTON COLLEGE                      ,VT,05401-8477,Private      ,32,48,80,161,103,264
02143500,STERLING COLLEGE                        ,VT,05827-0000,Private      ,28,11,39,132,52,184
02254000,NEW ENGLAND CULINARY INSTITUTE          ,VT,05602-0000,Proprietary  ,72,79,151,260,154,414
02532600,LANDMARK COLLEGE                        ,VT,05346-0000,Private      ,83,31,114,407,106,513
04146900,ADVANCED WELDING INSTITUTE              ,VT,05403-0000,Proprietary  ,14,14,28,38,24,62
00392800,CASPER COLLEGE                          ,WY,82601-4612,Public       ,301,469,770,1027,899,1926
00392900,EASTERN WYOMING COLLEGE                 ,WY,82240-1603,Public       ,75,86,161,335,178,513
00393000,SHERIDAN COLLEGE                        ,WY,82801-9133,Public       ,255,358,613,779,646,1425
00393100,NORTHWEST COLLEGE                       ,WY,82435-1895,Public       ,180,173,353,608,317,925
00393200,UNIVERSITY OF WYOMING                   ,WY,82071-2000,Public       ,1374,1292,2666,6295,3253,9548
00393300,WESTERN WYOMING COMMUNITY COLLEGE       ,WY,82902-0000,Public       ,293,337,630,688,646,1334
00728900,CENTRAL WYOMING COLLEGE                 ,WY,82501-0000,Public       ,135,209,344,430,437,867
00915700,WYOTECH                                 ,WY,82072-9519,Proprietary  ,172,135,307,462,298,760
00925900,LARAMIE COUNTY COMMUNITY CLG            ,WY,82007-3299,Public       ,515,781,1296,1261,1520,2781
02211900,CHEEKS INTERNATIONAL ACDMY              ,WY,82001-0000,Proprietary  ,10,44,54,18,77,95
00393500,UNIV OF GUAM                            ,GU,96923-0000,Public       ,962,641,1603,1702,1154,2856
01536100,GUAM COMMUNITY COLLEGE                  ,GU,96921-0000,Public       ,743,614,1357,1087,1022,2109
03438300,PACIFIC ISLANDS UNIVERSITY              ,GU,96913-2619,Private      ,14,31,45,27,68,95
00393600,PONTIFICAL CATHOLIC UNIV OF PR          ,PR,00717-0777,Private      ,3229,1641,4870,4598,2203,6801
00393700,UNIVERSITY OF THE SACRED HEART          ,PR,00914-0383,Private      ,1645,665,2310,2348,1068,3416
00393800,INTER-AMER UNIV PR-CNTRL ADMN           ,PR,00936-0000,Private      ,1659,1927,3586,2067,2515,4582
00393801,INTER-AMER UNIV PR SCHL LAW             ,PR,00936-8351,Private      ,9,168,177,23,236,259
00393802,INTER AMERICAN UNIVERSITY OF PUERTO RICO,PR,00926-0000,Private      ,370,333,703,653,533,1186
00393803,INTER AMERICAN UNIVERSITY OF PR         ,PR,00683-0000,Private      ,2057,581,2638,2635,853,3488
00393804,INTER-AMER UNIV PR-RECINTO AGUADILA     ,PR,00605-2000,Private      ,1980,613,2593,2368,821,3189
00393805,INTER-AMER UNIV PR-ARECIBO CAMPUS       ,PR,00614-4050,Private      ,1752,815,2567,2285,1099,3384
00393806,INTER-AMER UNIV PR-BARRANQUITAS REG     ,PR,00794-0517,Private      ,771,229,1000,1222,346,1568
00393807,INTER-AMER UNIV PR-FAJARDO REGIONAL     ,PR,00738-0000,Private      ,744,286,1030,913,409,1322
00393808,INTER-AMER UNIV PR - GUAYAMA CAMPUS     ,PR,00785-4004,Private      ,585,313,898,849,528,1377
00393809,INTER-AMER UNIV PR-PONCE REGIONAL       ,PR,00715-0000,Private      ,2230,931,3161,2673,1237,3910
00393811,INTER-AMER UNIV PR-BAYAMON REG CLG      ,PR,00959-0000,Private      ,2123,588,2711,2861,821,3682
00394100,UNIVERSIDAD DEL ESTE                    ,PR,00984-2010,Private      ,3944,2979,6923,5024,3807,8831
00394200,UNIVERSITY OF PR-CENTRAL ADMINISTRATION ,PR,00936-4984,Public       ,218,88,306,334,129,463
00394300,UNIVERSITY OF PUERTO RICO - HUMACAO UNIV,PR,00791-4300,Public       ,2489,242,2731,3035,324,3359
00394400,UNIVERSITY OF PUERTO RICO - MAYAGUEZ    ,PR,00680-0000,Public       ,6083,896,6979,8482,1369,9851
00501900,UNIV ADVENTISTA DE LAS ANTILLAS         ,PR,00681-0118,Private      ,534,217,751,715,332,1047
00502200,BAYAMON CENTRAL UNIVERSITY              ,PR,00960-0000,Private      ,622,453,1075,771,564,1335
00710800,UNIVERSITY OF PUERTO RICO - RIO PIEDRAS ,PR,00931-3300,Public       ,6226,1707,7933,8443,2341,10784
00720600,UNIVERSITY OF PUERTO RICO - CAYEY UNIVER,PR,00736-5534,Public       ,2073,155,2228,3169,295,3464
00722800,UNIVERSITY OF PUERTO RICO - ARECIBO     ,PR,00614-4010,Public       ,2496,277,2773,3536,412,3948
00890200,COLUMBIA CENTRO UNIVERSITARIO           ,PR,00726-0000,Proprietary  ,665,486,1151,835,602,1437
00965200,"UNIVERSITY OF PUERTO RICO, PONCE TECH UN",PR,00716-0000,Public       ,1930,176,2106,3209,326,3535
01056700,COLEGIO TECNOLOGICO DE SAN JUAN         ,PR,00918-2973,Public       ,487,472,959,542,540,1082
01072400,CARLOS ALBIZU UNIVERSITY                ,PR,00902-3711,Private      ,133,805,938,183,1033,1216
01081900,CONSERVATORIO DE MUSICA DE PUERTO RICO  ,PR,00907-3373,Public       ,192,51,243,237,63,300
01092200,UNIVERSITY OF PUERTO RICO - UTUADO      ,PR,00641-2500,Public       ,999,96,1095,1234,138,1372
01097500,UNIVERSITY OF PUERTO RICO BAYAMON TECHNI,PR,00959-1911,Public       ,2984,324,3308,4065,479,4544
01120300,RYDER MEMORIAL HOSP SCH OF NURSING      ,PR,00792-0000,Private      ,8,4,12,10,6,16
01171900,UNIVERSIDAD DEL TURABO                  ,PR,00778-0000,Private      ,4808,4276,9084,6168,5504,11672
01194000,ICPR JUNIOR COLLEGE                     ,PR,00919-0000,Proprietary  ,537,521,1058,599,626,1225
01194100,AMERICAN UNIVERSITY OF PUERTO RICO      ,PR,00960-2037,Private      ,321,140,461,434,197,631
01194101,AMERICAN UNIVERSITY OF PUERTO RICO      ,PR,00674-0000,Private      ,300,125,425,469,215,684
01212300,"UNIVERSITY OF PUERTO RICO, AGUADILLA REG",PR,00604-0160,Public       ,2173,224,2397,2671,326,2997
01252500,CARIBBEAN UNIVERSITY                    ,PR,00960-0493,Private      ,1322,1064,2386,1752,1368,3120
02063100,MBTI BUSINESS TRNG INSTITUTE            ,PR,00907-3917,Proprietary  ,411,1002,1413,493,1439,1932
02100000,POLYTECHNIC UNIVERSITY OF PR            ,PR,00917-0000,Private      ,1346,1141,2487,1767,1504,3271
02163300,UNIVERSIDAD CENTRAL DEL CARIBE          ,PR,00960-0000,Private      ,70,185,255,99,260,359
02165100,EDP COLLEGE OF PUERTO RICO              ,PR,00919-0000,Private      ,551,736,1287,596,855,1451
02166000,CENTER FOR ADVANCED STUDIES OF PUER     ,PR,00902-0000,Private      ,5,24,29,8,53,61
02166400,INSTITUTO DE BANCA Y COMERCIO           ,PR,00925-0000,Proprietary  ,2243,3067,5310,3867,5766,9633
02170300,INST EDUC TECNIA OCUP LA REINA          ,PR,00674-0000,Proprietary  ,24,33,57,27,40,67
02189100,CENTRO DE ESTUDIOS MULTIDISCIPLIN       ,PR,00926-0000,Proprietary  ,493,419,912,569,519,1088
02189300,EMMA'S BEAUTY ACADEMY                   ,PR,00680-0000,Proprietary  ,151,55,206,155,57,212
02195400,MODERN HAIRSTYLING INSTITUTE            ,PR,00961-0000,Proprietary  ,240,101,341,247,104,351
02195500,MODERN HAIRSTYLING INSTITUTE            ,PR,00612-0000,Proprietary  ,5,3,8,9,5,14
02195800,LICEO E ARTE Y TECNOLGIA                ,PR,00919-0000,Proprietary  ,420,311,731,623,479,1102
02195900,MODERN HAIRSTYLING INSTITUTE            ,PR,00980-0000,Proprietary  ,4,2,6,6,4,10
02234900,ANTILLES SCHOOL OF TECH CAREERS         ,PR,00909-3006,Proprietary  ,124,122,246,143,165,308
02241904,COMMONWEALTH OF PR DEPT OF EDUC - ITPR R,PR,00655-0000,Public       ,238,131,369,294,184,478
02241907,COMMONWEALTH OF PR DEPT OF EDUC - ITPR R,PR,00928-0000,Public       ,313,148,461,353,183,536
02241908,COMMONWEALTH OF PR DEPT OF EDUC - ITPR R,PR,00732-0000,Public       ,253,114,367,311,158,469
02241909,COMMONWEALTH OF PR DEPT OF EDUC - TROQUE,PR,00959-0000,Public       ,57,9,66,68,11,79
02241910,COMMONWEALTH OF PR DEPT OF EDUC - ITPR R,PR,00701-1091,Public       ,288,94,382,568,200,768
02260600,NATIONAL COLLEGE OF BUSINESS & TECH     ,PR,00960-2036,Proprietary  ,1936,3847,5783,2788,5942,8730
02260800,HUERTAS COLLEGE                         ,PR,00726-0000,Proprietary  ,434,336,770,460,365,825
02297700,AUTOMECA TECHNICAL COLLEGE              ,PR,00957-0000,Proprietary  ,681,374,1055,773,438,1211
02303800,AMERICAN EDUCATIONAL COLLEGE            ,PR,00961-0000,Proprietary  ,103,120,223,108,131,239
02335500,COLEGIO BIBLICO PENTECOSTAL DE PR       ,PR,00978-0000,Private      ,8,97,105,11,115,126
02340600,HUMACAO COMMUNITY COLLEGE               ,PR,00792-0000,Private      ,86,109,195,109,146,255
02343600,INSTITUTE OF BEAUTY CAREERS             ,PR,00613-0000,Proprietary  ,113,66,179,118,72,190
02460000,UNIVERSITY OF PUERTO RICO - MEDICAL SCIE,PR,00936-0000,Public       ,383,1021,1404,539,1193,1732
02482400,PONCE SCHOOL OF MEDICINE AND HEALTH SCIE,PR,00716-2347,Proprietary  ,25,574,599,44,740,784
02504500,INSTITUCION CHAVIANO DE MAYAGUEZ        ,PR,00708-0000,Proprietary  ,2,1,3,2,3,5
02505400,ATLANTIC COLLEGE                        ,PR,00970-0000,Private      ,560,117,677,648,140,788
02534900,PONCE PARAMEDICAL COLLEGE (POPAC)       ,PR,00731-0000,Proprietary  ,486,361,847,598,459,1057
02552300,COLEGIO MAYOR DE TECHNOLOGIA            ,PR,00714-0000,Proprietary  ,117,117,234,125,126,251
02562500,INTERNATIONAL TECHNICAL COLLEGE         ,PR,00918-0000,Proprietary  ,17,36,53,25,54,79
02569400,ESCUELA DE ARTES PLASTICAS              ,PR,00902-1112,Public       ,348,67,415,448,113,561
02570400,EDUCATIONAL TECHNICAL COLLEGE           ,PR,00925-3404,Proprietary  ,183,268,451,189,269,458
02576100,ESCUELA TECNICA DE ELECTRICIDAD         ,PR,00731-0000,Proprietary  ,116,101,217,124,109,233
02587500,UNIVERSIDAD METROPOLITANA               ,PR,00928-0000,Private      ,3329,3238,6567,4842,4323,9165
02588600,SEMINARIO EVANGELICO DE PUERTO RICO     ,PR,00925-0000,Private      ,0,18,18,2,27,29
02593700,HISPANIC AMERICAN COLLEGE               ,PR,00725-0000,Proprietary  ,55,54,109,56,59,115
03016000,UNIVERSITY OF PUERTO RICO CAROLINA REGIO,PR,00985-0000,Public       ,2453,302,2755,3170,421,3591
03021900,EDIC COLLEGE                            ,PR,00726-0000,Proprietary  ,737,672,1409,858,756,1614
03025500,MECH TECH COLLEGE                       ,PR,00725-6118,Proprietary  ,1169,540,1709,1400,659,2059
03025900,"LICEO DE ARTE, DISENOS Y COMERCIO       ",PR,00726-0000,Proprietary  ,114,187,301,118,191,309
03029700,"UNIVERSAL TECHNOLOGY CLG OF PR, INC     ",PR,00605-0000,Private      ,191,318,509,289,484,773
03061900,COLEGIO TECHNOLOGICO Y COMERCIAL        ,PR,00602-0960,Proprietary  ,0,0,0,2,1,3
03068400,STAR BEAUTY ACADEMY                     ,PR,00961-6312,Proprietary  ,2,2,4,4,6,10
03070500,D'MART INSTITUTE                        ,PR,00794-3517,Proprietary  ,167,144,311,365,330,695
03075600,EMMA'S BEAUTY ACADEMY                   ,PR,00795-0000,Proprietary  ,121,61,182,126,66,192
03085700,PROFESSIONAL TECHNICAL INSTITUTION      ,PR,00960-7061,Proprietary  ,116,138,254,123,143,266
03104400,PROFESSIONAL ELECTRIC SCHOOL            ,PR,00674-1797,Proprietary  ,17,6,23,24,6,30
03106900,ESCUELA DE PERITOS ELECTRICITAS         ,PR,00662-0457,Proprietary  ,27,21,48,29,25,54
03112100,JOHN DEWEY COLLEGE                      ,PR,00915-9538,Private      ,453,912,1365,521,1051,1572
03112101,JOHN DEWEY COLLEGE                      ,PR,00986-0000,Private      ,107,253,360,117,276,393
03112102,JOHN DEWEY COLLEGE-BAYAMON CAMPUS       ,PR,00959-0000,Private      ,18,38,56,26,43,69
03112105,JOHN DEWEY COLLEGE - FAJARDO BRANCH     ,PR,00738-0738,Private      ,73,129,202,90,186,276
03112106,JOHN DEWEY COLLEGE - ARROYO BRANCH      ,PR,00714-0714,Private      ,31,40,71,34,57,91
03112107,JOHN DEWEY COLLEGE - JUANA DIAZ BRANCH  ,PR,00795-0000,Private      ,61,82,143,106,137,243
03112108,JOHN DEWEY COLLEGE - HATILLO CAMPUS     ,PR,00659-0000,Private      ,19,47,66,22,48,70
03112109,JOHN DEWEY COLLEGE - MANATI             ,PR,00674-0000,Private      ,158,193,351,166,197,363
03112110,DEWEY UNIVERSITY - MAYAGUEZ             ,PR,00682-0000,Private      ,13,21,34,16,26,42
03115900,TRINITY COLLEGE OF PUERTO RICO          ,PR,00734-0000,Private      ,46,60,106,51,66,117
03122500,ACADEMIA SERRANT INC.                   ,PR,00717-1568,Proprietary  ,87,66,153,111,93,204
03123100,GLOBELLE TECHNICAL INSTITUTE            ,PR,00693-4218,Proprietary  ,29,33,62,29,35,64
03124200,NOVA COLLEGE DE PUERTO RICO             ,PR,00960-4016,Proprietary  ,54,101,155,58,112,170
03157600,"COLEGIO DE CINEMATOGRAFIA, ARTES Y TELEV",PR,00961-6345,Proprietary  ,284,147,431,319,171,490
03177300,SAN JUAN BAUTISTA SCH OF MEDICINE       ,PR,00726-0000,Private      ,15,204,219,25,308,333
03336300,CENTURY COLLEGE                         ,PR,00603-0000,Proprietary  ,79,115,194,83,122,205
03414300,MONTECLARO                              ,PR,00745-9612,Private      ,10,4,14,10,9,19
03452300,INSTITUTO PRE-VOCACIONAL E INDUSTRI     ,PR,00613-1800,Private      ,2,2,4,5,5,10
03469300,IVAEM COLLEGE                           ,PR,00725-0000,Proprietary  ,38,27,65,57,34,91
03531300,UNIVERSIDAD PENTECOSTAL MIZPA           ,PR,00928-0966,Private      ,19,165,184,20,185,205
03544300,ATENAS COLLEGE                          ,PR,00674-0000,Private      ,576,284,860,770,416,1186
03552300,LESTON COLLEGE                          ,PR,00961-6309,Proprietary  ,2,7,9,4,8,12
03608300,CARIBBEAN FORENSIC & TECHNICAL COLL     ,PR,00926-0000,Proprietary  ,8,15,23,11,23,34
03638300,ROSSLYN TRAINING ACADEMY OF COSMETOLOGY ,PR,00602-3225,Proprietary  ,2,4,6,2,5,7
03735400,"CHARLIES GUARD,DETECTIVE BUREAU&ACA     ",PR,00605-0000,Proprietary  ,0,3,3,4,5,9
03751300,ESCUELA HOTELERA DE SAN JUAN            ,PR,00917-0091,Proprietary  ,454,217,671,506,245,751
03758300,BAYAMON COMMUNITY COLLEGE               ,PR,00960-0000,Proprietary  ,11,49,60,15,56,71
03781400,INDUSTRIAL TECHNICAL COLLEGE            ,PR,00792-0000,Proprietary  ,57,80,137,59,82,141
03785300,J.G. GUAYNABO TECHNICAL COLLEGE         ,PR,00960-0000,Proprietary  ,28,63,91,47,116,163
03800300,COLEGIO TECNICO DE ELECTRICIDAD GALLOSA ,PR,00602-0000,Proprietary  ,2,2,4,3,2,5
03800400,INSTITUTE OF BEAUTY OCCUPATIONS AND TECH,PR,00676-5071,Proprietary  ,21,33,54,49,76,125
03849300,AGUADILLA TECHNICAL COLLEGE             ,PR,00603-0000,Proprietary  ,27,38,65,31,44,75
03965400,MYRANGEL BEAUTY INSTITUTE               ,PR,00754-3917,Proprietary  ,49,34,83,49,34,83
04107300,CARIB TECHNOLOGICAL INSTITUTE           ,PR,00960-0000,Proprietary  ,3,0,3,4,3,7
04117200,INSTITUTO EDUCATIVO PREMIER             ,PR,00731-0000,Proprietary  ,70,69,139,75,71,146
04131600,LIBERTY TECHNICAL COLLEGE               ,PR,00737-1298,Proprietary  ,43,55,98,45,61,106
04164300,GLOBAL INSTITUTE                        ,PR,00725-6485,Proprietary  ,3,2,5,4,3,7
04176000,AMERICAN TECHNICAL INSTITUTE            ,PR,00957-0000,Proprietary  ,17,29,46,19,35,54
04240900,PPG TECHNICAL COLLEGE                   ,PR,00726-3164,Proprietary  ,74,27,101,92,49,141
00394600,UNIVERSITY OF THE VIRGIN ISLANDS        ,VI,00802-9990,Public       ,275,197,472,1149,548,1697
00394601,UNIV OF THE VIRGIN ISLANDS-ST CROIX     ,VI,00850-0000,Public       ,134,173,307,452,452,904
00667700,MCGILL UNIVERSITY                       ,CN,00000-0000,Public       ,244,112,356,1369,293,1662
00667900,QUEEN'S UNIVERSITY AT KINGSTON          ,CN,00000-0000,Public       ,14,4,18,87,23,110
00668100,ST FRANCIS XAVIER UNIVERSITY            ,CN,00000-0000,Public       ,4,1,5,20,3,23
00668200,ST THOMAS UNIVERSITY                    ,CN,00000-0000,Public       ,3,3,6,21,6,27
00668300,UNIVERSITY OF GUELPH                    ,CN,00000-0000,Public       ,9,26,35,39,59,98
00668400,UNIVERSITY OF MANITOBA                  ,CN,00000-0000,Public       ,16,12,28,66,21,87
00668500,UNIVERSITY OF NEW BRUNSWICK (THE)       ,CN,00000-0000,Public       ,6,4,10,26,8,34
00668600,UNIVERSITY OF OTTAWA                    ,CN,00000-0000,Public       ,16,15,31,43,38,81
00668800,UNIVERSITY OF TORONTO                   ,CN,00000-0000,Public       ,58,79,137,412,274,686
00668900,UNIVERSITY OF WINDSOR                   ,CN,00000-0000,Public       ,6,8,14,19,19,38
00683700,UNIVERSITE LAVAL                        ,CN,00000-0000,Public       ,1,10,11,8,19,27
00683800,DALHOUSIE UNIVERSITY                    ,CN,00000-0000,Public       ,21,18,39,101,53,154
00685200,BISHOP'S UNIVERSITY                     ,CN,00000-0000,Private      ,4,3,7,41,7,48
00767900,YORK UNIVERSITY                         ,CN,00000-0000,Public       ,12,24,36,68,72,140
00787400,UNIVERSITY AT CALGARY (THE)             ,CN,00000-0000,Public       ,11,18,29,49,50,99
00814800,UNIVERSITY OF WINNIPEG                  ,CN,00000-0000,Public       ,6,6,12,16,10,26
00836300,MOUNT SAINT VINCENT UNIVERSITY          ,CN,00000-0000,Public       ,2,1,3,6,3,9
00836400,SAINT MARY'S UNIVERSITY                 ,CN,00000-0000,Public       ,7,2,9,18,11,29
00836500,CONCORDIA UNIVERSITY - SIR GEORGE W     ,CN,00000-0000,Public       ,51,60,111,295,121,416
00836600,UNIVERSITE DE MONTREAL                  ,CN,00000-0000,Public       ,4,20,24,17,52,69
00836800,CARLETON UNIVERSITY                     ,CN,00000-0000,Public       ,17,12,29,59,31,90
00836900,UNIVERSITY OF BRITISH COLUMBIA          ,CN,00000-0000,Public       ,78,69,147,809,307,1116
00837000,"SAFA, UNIVERSITY OF VICTORIA            ",CN,00000-0000,Public       ,17,19,36,165,63,228
00844400,SIMON FRASER UNIVERSITY                 ,CN,00000-0000,Public       ,20,33,53,127,72,199
00844600,UNIVERSITY OF WESTERN ONTARIO (THE)     ,CN,00000-0000,Public       ,9,17,26,44,45,89
00844900,ACADIA UNIVERSITY                       ,CN,00000-0000,Public       ,7,2,9,19,11,30
00858200,WILFRID LAURIER UNIVERSITY              ,CN,00000-0000,Public       ,4,1,5,13,13,26
00891300,LAKEHEAD UNIVERSITY                     ,CN,00000-0000,Public       ,2,1,3,2,6,8
00936700,UNIVERSITY OF PRINCE EDWARD ISLAND      ,CN,00000-0000,Public       ,1,23,24,14,75,89
00942100,BRANDON UNIVERSITY                      ,CN,00000-0000,Public       ,1,5,6,7,8,15
00948600,TRINITY WESTERN UNIVERSITY              ,CN,00000-0000,Private      ,16,8,24,118,39,157
00950000,MEMORIAL UNIVERSITY OF NEWFOUNDLAND     ,CN,00000-0000,Public       ,10,8,18,22,28,50
00950100,UNIVERSITY OF KING'S COLLEGE            ,CN,00000-0000,Public       ,5,0,5,19,4,23
00950300,MOUNT ALLISON UNIVERSITY                ,CN,00000-0000,Public       ,8,1,9,33,5,38
01022100,SAINT PAUL UNIVERSITY                   ,CN,00000-0000,Public       ,2,2,4,5,5,10
01045800,SHERIDAN COLLEGE OF APPLIED ARTS AN     ,CN,00000-0000,Public       ,10,2,12,53,18,71
01067500,REGENT COLLEGE                          ,CN,00000-0000,Private      ,2,24,26,4,44,48
01072000,RYERSON UNIVERSITY                      ,CN,00000-0000,Public       ,6,15,21,59,45,104
01172200,BRIERCREST BIBLE COLLEGE                ,CN,00000-0000,Private      ,1,1,2,5,1,6
01222800,HUMBER COLLEGE INSTITUTE OF TECHNOLOGY A,CN,00000-0000,Public       ,10,9,19,34,30,64
01227400,PROVIDENCE COLLEGE                      ,CN,00000-0000,Private      ,1,3,4,3,8,11
02102100,KINGSWOOD UNIVERSITY                    ,CN,00000-0000,Private      ,15,1,16,27,6,33
02116600,CANADIAN MEMORIAL CHIROPRACTIC COLL     ,CN,00000-0000,Private      ,0,2,2,0,2,2
02167000,PRAIRIE BIBLE INST                      ,CN,00000-0000,Private      ,6,1,7,15,1,16
02201100,COLUMBIA BIBLE COLLEGE                  ,CN,00000-0000,Private      ,1,2,3,9,8,17
02216400,TYNDALE COLLEGE & SEMINARY              ,CN,00000-0000,Private      ,3,3,6,7,11,18
02219200,UNIVERSITY OF SASKATCHEWAN              ,CN,00000-0000,Public       ,1,10,11,14,16,30
02324900,EMMANUEL BIBLE COLLEGE                  ,CN,00000-0000,Private      ,0,1,1,2,4,6
02338800,EMILY CARR UNIVERSITY OF ART AND DESIGN ,CN,00000-0000,Public       ,14,10,24,59,28,87
02577200,SALVATION ARMY WM & CATHERINE BOOTH     ,CN,00000-0000,Private      ,1,0,1,3,0,3
02593800,CONCORDIA UNIVERSITY COLLEGE            ,CN,00000-0000,Private      ,4,8,12,12,13,25
02611900,THE KING'S UNIVERSITY COLLEGE           ,CN,00000-0000,Private      ,1,6,7,3,6,9
03033800,UNIVERSITY COLLEGE OF CAPE BRETON       ,CN,00000-0000,Public       ,1,0,1,5,0,5
03078300,VANCOUVER SCHOOL OF THEOLOGY            ,CN,00000-0000,Private      ,0,0,0,1,3,4
03273300,CANADIAN COLLEGE OF NATUROPATHIC ME     ,CN,00000-0000,Private      ,2,18,20,6,29,35
03298300,ALBERTA COLLEGE OF ART & DESIGN         ,CN,00000-0000,Public       ,11,8,19,25,19,44
03332500,KWANTLEN UNIVERSITY COLLEGE             ,CN,00000-0000,Public       ,0,8,8,5,13,18
03335400,CANADIAN UNIVERSITY COLLEGE             ,CN,00000-0000,Private      ,6,4,10,30,11,41
03339300,ST. STEPHENS UNIVERSITY                 ,CN,00000-0000,Private      ,0,1,1,2,2,4
03348500,REDEEMER UNIVERSITY COLLEGE             ,CN,00000-0000,Private      ,0,2,2,4,5,9
03420300,HOLLAND COLLEGE                         ,CN,00000-0000,Public       ,4,1,5,9,2,11
03560400,NIAGARA COLLEGE-WELLAND CAMPUS          ,CN,00000-0000,Public       ,2,8,10,12,16,28
03613300,UNIV OF NORTHERN BRITISH COLUMBIA       ,CN,00000-0000,Public       ,2,2,4,10,7,17
03644400,CANADIAN MENNONITE UNIVERSITY           ,CN,00000-0000,Private      ,0,1,1,2,1,3
03846300,PACIFIC LIFE BIBLE COLLEGE              ,CN,00000-0000,Private      ,1,1,2,7,5,12
03847300,CRANDALL UNIVERSITY                     ,CN,00000-0000,Private      ,1,1,2,2,2,4
04075300,QUEST UNIVERSITY CANADA                 ,CN,00000-0000,Private      ,45,5,50,173,15,188
04123100,ATLANTIC SCHOOL OF THEOLOGY             ,CN,00000-0000,Public       ,1,2,3,2,5,7
04156700,AMBROSE UNIVERSITY COLLEGE              ,CN,00000-0000,Private      ,5,3,8,7,13,20
00814700,UNIVERSIDAD AUTONOMA DE GUADALAJARA     ,MX,00000-0000,Private      ,13,479,492,57,856,913
01041800,INST TEC Y DE ESTSUPER DE MONTERRE      ,MX,00000-0000,Private      ,25,18,43,61,47,108
01067600,UNIVERSIDAD DE MONTERREY                ,MX,00000-0000,Private      ,7,4,11,26,17,43
01302100,"UNIVERSIDAD DEL NORESTE, A.C.           ",MX,00000-0000,Private      ,2,2,4,5,14,19
02053300,CENTRO DE ESTUDIOS UNIVERSITARIOS D     ,MX,00000-0000,Private      ,5,7,12,17,30,47
03776500,"UNIVERSIDAD DE LA SALLE BAJIO, A.C.     ",MX,00000-0000,Private      ,4,39,43,4,41,45
04183900,CETYS UNIVERSIDAD                       ,MX,00000-0000,Private      ,34,33,67,107,65,172
01001000,AMERICAN SAMOA CMNTY COLLEGE            ,AS,96799-2609,Public       ,251,78,329,365,146,511
01034300,COLLEGE OF MICRONESIA - FSM             ,FM,96941-0159,Public       ,395,86,481,512,183,695
01100900,PALAU COMMUNITY COLLEGE                 ,PW,96940-0009,Public       ,207,153,360,430,165,595
03022400,COLLEGE OF THE MARSHALL ISLANDS         ,MH,96960-1258,Public       ,32,31,63,47,65,112
03033000,NORTHERN MARIANAS COLLEGE               ,MP,96950-0000,Public       ,432,175,607,559,260,819
