OPE ID,School,State,Zip Code,School Type,20152016Qtr3_Dependent Students,20152016Qtr3_Independent Students,Quarterly Total,YTD_20152016Qtr3_Dependent Students,YTD_20152016Qtr3_Independent Students,Award Year To Date Total
00100200,ALABAMA AGRCLTL & MECHL UNIV            ,AL,35762-1357,Public       ,1009,1070,2079,6385,3449,9834
00100300,FAULKNER UNIVERSITY                     ,AL,36109-3398,Private      ,275,1066,1341,1928,3592,5520
00100400,UNIVERSITY OF MONTEVALLO                ,AL,35115-6000,Public       ,309,272,581,2486,1218,3704
00100500,ALABAMA STATE UNIVERSITY                ,AL,36101-0000,Public       ,1310,1377,2687,8730,4840,13570
00100700,CENTRAL ALABAMA COMMUNITY COLLEGE       ,AL,35011-0000,Public       ,334,446,780,1308,1326,2634
00100800,ATHENS STATE UNIVERSITY                 ,AL,35611-1999,Public       ,170,794,964,853,2848,3701
00100900,AUBURN UNIVERSITY                       ,AL,36849-5113,Public       ,1676,1272,2948,19014,6322,25336
00101200,BIRMINGHAM SOUTHERN COLLEGE             ,AL,35254-0002,Private      ,124,156,280,2213,631,2844
00101300,CALHOUN COMMUNITY COLLEGE               ,AL,35609-0000,Public       ,1303,2002,3305,4880,6189,11069
00101500,ENTERPRISE STATE COMMUNITY COLLEGE      ,AL,36331-1300,Public       ,278,396,674,1049,1119,2168
00101600,UNIVERSITY OF NORTH ALABAMA             ,AL,35632-0001,Public       ,848,711,1559,5379,2645,8024
00101700,GADSDEN STATE COMMUNITY COLLEGE         ,AL,35903-2269,Public       ,822,1465,2287,2913,4151,7064
00101800,GEORGE C WALLACE COMMUNITY COLLEGE      ,AL,36303-0943,Public       ,689,1188,1877,2383,3525,5908
00101900,HUNTINGDON COLLEGE                      ,AL,36106-2148,Private      ,224,216,440,1524,698,2222
00102000,JACKSONVILLE STATE UNIVERSITY           ,AL,36265-1602,Public       ,984,1188,2172,6530,4451,10981
00102100,JEFFERSON DAVIS COMMUNITY COLLEGE       ,AL,36427-2790,Public       ,185,293,478,614,727,1341
00102200,JEFFERSON STATE COMMUNITY COLLEGE       ,AL,35215-3098,Public       ,1233,2035,3268,4637,6658,11295
00102300,JUDSON COLLEGE                          ,AL,36756-2504,Private      ,35,77,112,314,178,492
00102400,UNIVERSITY OF WEST ALABAMA              ,AL,35470-0000,Public       ,419,1308,1727,2520,3477,5997
00102600,MARION MILITARY INSTITUTE               ,AL,36756-3214,Public       ,112,24,136,584,77,661
00102800,MILES COLLEGE                           ,AL,35064-2697,Private      ,604,401,1005,2655,1158,3813
00102900,UNIVERSITY OF MOBILE                    ,AL,36613-0000,Private      ,323,540,863,1798,1672,3470
00103000,BISHOP STATE COMMUNITY COLLEGE          ,AL,36603-5898,Public       ,755,1276,2031,2206,3803,6009
00103100,NORTHEAST ALABAMA STATE CMNTY COLG      ,AL,35986-0159,Public       ,464,596,1060,1246,1350,2596
00103300,OAKWOOD COLLEGE                         ,AL,35896-0001,Private      ,409,270,679,1795,929,2724
00103400,ALABAMA SOUTHERN COMMUNITY COLLEGE      ,AL,36460-5698,Public       ,260,282,542,1104,781,1885
00103600,SAMFORD UNIVERSITY                      ,AL,35229-7000,Private      ,307,598,905,3810,2824,6634
00103800,SNEAD STATE COMMUNITY COLLEGE           ,AL,35957-0734,Public       ,319,529,848,1704,1611,3315
00104000,SOUTHERN UNION STATE COMMUNITY CLG      ,AL,36276-0000,Public       ,704,848,1552,3474,2825,6299
00104100,SPRING HILL COLLEGE                     ,AL,36608-1791,Private      ,181,199,380,2522,759,3281
00104400,STILLMAN COLLEGE                        ,AL,35403-0000,Private      ,300,194,494,1826,651,2477
00104600,TALLADEGA COLLEGE                       ,AL,35160-2354,Private      ,242,167,409,1220,482,1702
00104700,TROY UNIVERSITY                         ,AL,36082-0001,Public       ,1415,4707,6122,8719,14923,23642
00105000,TUSKEGEE UNIVERSITY                     ,AL,36088-1645,Private      ,424,228,652,5192,1382,6574
00105100,UNIVERSITY OF ALABAMA (THE)             ,AL,35487-0120,Public       ,2902,2301,5203,28917,10035,38952
00105200,UNIVERSITY OF ALABAMA AT BIRMINGHAM     ,AL,35294-1150,Public       ,1660,2802,4462,11081,11642,22723
00105500,UNIVERSITY OF ALABAMA IN HUNTSVILLE     ,AL,35899-0001,Public       ,841,1125,1966,5370,3951,9321
00105700,UNIVERSITY OF SOUTH ALABAMA             ,AL,36688-0002,Public       ,1695,2427,4122,10809,9671,20480
00105900,LAWSON STATE COMMUNITY COLLEGE          ,AL,35221-1798,Public       ,772,1140,1912,2340,3036,5376
00105901,LAWSON STATE COMMUNITY COLLEGE - BESSEME,AL,35021-0308,Public       ,274,429,703,824,1239,2063
00106000,FAULKNER STATE COMMUNITY COLLEGE        ,AL,36507-2698,Public       ,831,1039,1870,3501,3196,6697
00526000,J.F. DRAKE STATE TECH COLLEGE           ,AL,35811-1584,Public       ,238,622,860,645,1602,2247
00569100,SHELTON STATE COMMUNITY CLG             ,AL,35405-4017,Public       ,880,1049,1929,3435,3189,6624
00569200,REID STATE TECHNICAL COLLEGE            ,AL,36401-0000,Public       ,104,235,339,246,559,805
00569700,NORTHWEST- SHOALS COMMUNITY COLLEGE     ,AL,35661-0000,Public       ,671,899,1570,2120,2108,4228
00569900,GEORGE C WALLACE STATE CMTY COLLEGE     ,AL,36703-0000,Public       ,398,645,1043,1068,1530,2598
00573300,BEVILL STATE CMTY COLLEGE-WALKER        ,AL,35148-0000,Public       ,574,894,1468,2103,2488,4591
00573400,H. COUNCILL TRENHOLM STATE TECH COLLEGE ,AL,36108-0020,Public       ,302,617,919,791,1688,2479
00573401,H. C. TRENHOLM ST TECH COL-PATTERSON CAM,AL,36116-2612,Public       ,180,321,501,496,980,1476
00787100,GEORGE C WALLACE STATE CMTY CLG         ,AL,35077-2000,Public       ,800,941,1741,3652,3389,7041
00831000,AUBURN UNIVERSITY-MONTGOMERY            ,AL,36124-0000,Public       ,596,926,1522,4715,3920,8635
00898800,LURLEEN B WALLACE COMMUNITY COLLEGE     ,AL,36420-0418,Public       ,245,384,629,1024,1020,2044
01055400,CONCORDIA COLLEGE                       ,AL,36701-3323,Private      ,194,150,344,813,426,1239
01218200,CHATTAHOOCHEE VALLEY CMTY CLG           ,AL,36869-7917,Public       ,291,659,950,1064,1836,2900
01303906,SOUTH UNIVERSITY - MONTGOMERY           ,AL,36116-1120,Proprietary  ,105,394,499,311,1284,1595
02170600,UNITED STATES SPORTS ACADEMY            ,AL,36526-7055,Private      ,5,181,186,27,561,588
02199700,HERITAGE CHRISTIAN UNIVERSITY           ,AL,35630-0000,Private      ,11,42,53,29,86,115
02270400,SOUTHEASTERN BIBLE COLLEGE              ,AL,35244-2083,Private      ,11,57,68,86,216,302
02285000,PAUL MITCHELL THE SCHOOL HUNTSVILLE     ,AL,35758-0000,Proprietary  ,23,49,72,73,156,229
02296000,PRINCE INSTITUTE OF PROFESSIONAL STUDIES,AL,36117-0000,Proprietary  ,2,18,20,16,100,116
02341000,FORTIS COLLEGE                          ,AL,36609-0000,Proprietary  ,187,576,763,585,2055,2640
02503400,AMRIDGE UNIVERSITY                      ,AL,36124-0000,Private      ,25,421,446,87,974,1061
03010600,VIRGINIA COLLEGE                        ,AL,35209-5154,Proprietary  ,1129,4940,6069,3350,17841,21191
03010602,VIRGINIA COLLEGE - HUNTSVILLE           ,AL,35801-5608,Proprietary  ,53,185,238,203,738,941
03010607,VIRGINIA COLLEGE - MOBILE               ,AL,36608-1626,Proprietary  ,51,173,224,160,621,781
03010616,VIRGINIA COLLEGE - MONTGOMERY           ,AL,36117-2802,Proprietary  ,68,225,293,240,832,1072
03026516,REMINGTON COLLEGE - MOBILE              ,AL,36609-5593,Private      ,48,158,206,183,494,677
03032500,ALABAMA STATE CLG BARBER STYLING        ,AL,35215-0000,Proprietary  ,21,40,61,82,148,230
03361400,FORTIS COLLEGE                          ,AL,36535-0000,Proprietary  ,52,162,214,129,530,659
03459300,SOUTHEASTERN SCHOOL OF COSMETOLOGY      ,AL,35228-0000,Private      ,6,51,57,20,102,122
03709302,EDWARD VIA VIRGINIA COLLEGE OF OSTEOPATH,AL,36832-6330,Private      ,2,21,23,2,23,25
03783300,BLUE CLIFF CAREER COLLEGE               ,AL,63306-4749,Proprietary  ,33,86,119,70,250,320
03894300,HUNTSVILLE BIBLE COLLEGE                ,AL,35811-0000,Private      ,9,118,127,27,244,271
04066300,CARDIAC AND VASCULAR INSTITUTE OF ULTRAS,AL,36604-1411,Proprietary  ,14,66,80,57,224,281
04067300,SELMA UNIVERSITY                        ,AL,36701-0000,Private      ,81,192,273,215,414,629
04121500,COLUMBIA SOUTHERN UNIVERSITY            ,AL,36561-3815,Proprietary  ,149,3834,3983,553,15250,15803
04149200,XCELL ACADEMY-A PAUL MITCHELL PARTNER SC,AL,35216-4990,Proprietary  ,29,51,80,103,175,278
04187200,NEW BEGINNING COLLEGE OF COSMETOLOGY    ,AL,35950-2415,Proprietary  ,7,29,36,41,112,153
04187300,HAIR ACADEMY (THE)                      ,AL,36111-2201,Proprietary  ,8,29,37,42,107,149
04197500,UNIVERSITY ACADEMY OF HAIR DESIGN       ,AL,35476-3100,Proprietary  ,11,18,29,42,67,109
04211000,SALON PROFESSIONAL ACADEMY (THE)        ,AL,35816-1849,Proprietary  ,17,35,52,58,116,174
04217900,NUNATION SCHOOL OF COSMETOLOGY          ,AL,35064-2222,Proprietary  ,0,0,0,8,19,27
04226700,ALABAMA COLLEGE OF OSTEOPATHIC MEDICINE ,AL,36303-2251,Private      ,5,40,45,36,636,672
00111100,ALLAN HANCOCK COLLEGE                   ,CA,93454-6399,Public       ,588,1062,1650,4656,4914,9570
00111300,ANTELOPE VALLEY COLLEGE                 ,CA,93536-5426,Public       ,965,2331,3296,7313,10311,17624
00111600,ART CENTER COLLEGE OF DESIGN            ,CA,91103-1999,Private      ,131,193,324,1823,1367,3190
00111700,AZUSA PACIFIC UNIVERSITY                ,CA,91702-7000,Private      ,456,2006,2462,9943,8680,18623
00111800,BAKERSFIELD COLLEGE                     ,CA,93305-1299,Public       ,1017,2151,3168,11674,11008,22682
00111900,BARSTOW COMMUNITY COLLEGE               ,CA,92311-6608,Public       ,459,1372,1831,1353,3563,4916
00112000,AMER BAPT SEM OF THE WEST-BERKELEY      ,CA,94704-0000,Private      ,0,17,17,8,70,78
00112200,BIOLA UNIVERSITY                        ,CA,90639-0001,Private      ,277,316,593,5890,2164,8054
00112300,BROOKS INSTITUTE                        ,CA,93103-1809,Proprietary  ,31,43,74,313,293,606
00112400,CABRILLO COLLEGE                        ,CA,95003-3194,Public       ,611,1101,1712,4672,4495,9167
00112500,CALIFORNIA BAPTIST UNIVERSITY           ,CA,92504-3297,Private      ,355,1382,1737,7853,6539,14392
00112700,CALIFORNIA COLLEGE OF THE ARTS          ,CA,94107-2206,Private      ,118,174,292,2172,1499,3671
00113100,CALIFORNIA INSTITUTE OF TECHNOLOGY      ,CA,91125-0001,Private      ,124,81,205,3756,632,4388
00113200,CALIFORNIA INSTITUTE OF THE ARTS        ,CA,91355-2397,Private      ,142,120,262,2679,1560,4239
00113300,CALIFORNIA LUTHERAN UNIVERSITY          ,CA,91360-2787,Private      ,173,312,485,5042,1672,6714
00113400,CALIFORNIA MARITIME ACADEMY             ,CA,94590-8181,Public       ,34,38,72,1232,403,1635
00113700,CALIF STATE UNIV-FULLERTON              ,CA,92831-3599,Public       ,1383,2434,3817,53257,23974,77231
00113800,"CALIFORNIA STATE UNIVERSITY, EAST BAY   ",CA,94542-3000,Public       ,499,1430,1929,18458,13391,31849
00113900,CALIF STATE UNIV-LONG BEACH             ,CA,90840-0006,Public       ,1360,1984,3344,60699,26163,86862
00114000,CALIF STATE UNIV-LOS ANGELES            ,CA,90032-4226,Public       ,1013,2208,3221,40472,23975,64447
00114100,"CALIF STATE UNIV, DOMINGUEZ HILLS       ",CA,90747-0001,Public       ,355,1351,1706,19903,15861,35764
00114200,CALIF STATE UNIV SAN BERNARDINO         ,CA,92407-2397,Public       ,727,1631,2358,23306,14509,37815
00114300,CAL POLY STATE UNIVERSITY               ,CA,93407-0001,Public       ,647,306,953,43114,4826,47940
00114400,CALIF STATE POLYTECHNIC UNIV POMONA     ,CA,91768-2500,Public       ,741,1057,1798,39409,12961,52370
00114600,CALIF STATE UNIV - CHICO                ,CA,95929-0001,Public       ,540,630,1170,25719,7337,33056
00114700,CALIF STATE UNIV - FRESNO               ,CA,93740-8026,Public       ,775,1350,2125,29470,13377,42847
00114900,HUMBOLDT STATE UNIVERSITY               ,CA,95521-8299,Public       ,319,342,661,14577,4881,19458
00115000,CALIF STATE UNIV-SACRAMENTO             ,CA,95819-6044,Public       ,784,1594,2378,36024,20357,56381
00115100,SAN DIEGO STATE UNIVERSITY              ,CA,92182-1690,Public       ,1796,2377,4173,62119,21175,83294
00115300,CALIF STATE UNIV-NORTHRIDGE             ,CA,91330-8307,Public       ,1152,2193,3345,48812,23870,72682
00115400,SAN FRANCISCO STATE UNIVERSITY          ,CA,94132-1740,Public       ,964,1650,2614,40724,17622,58346
00115500,SAN JOSE STATE UNIVERSITY               ,CA,95192-0036,Public       ,825,1445,2270,35456,17102,52558
00115600,SONOMA STATE UNIVERSITY                 ,CA,94928-3609,Public       ,214,335,549,14542,3758,18300
00115700,CALIF STATE UNIV-STANISLAUS             ,CA,95382-0299,Public       ,214,565,779,11256,6489,17745
00116100,CERRITOS COLLEGE                        ,CA,90650-6296,Public       ,2198,3286,5484,16487,13239,29726
00116200,CHABOT COLLEGE                          ,CA,94545-2400,Public       ,690,1312,2002,6173,6422,12595
00116300,CHAFFEY COLLEGE                         ,CA,91737-9400,Public       ,2308,3614,5922,14885,14524,29409
00116400,CHAPMAN UNIVERSITY                      ,CA,92866-1099,Private      ,369,405,774,12201,4285,16486
00116500,CHURCH DIV SCH OF THE PACIFIC           ,CA,94709-0000,Private      ,0,13,13,1,74,75
00116600,CITRUS COLLEGE                          ,CA,91741-1899,Public       ,1620,1965,3585,9710,7202,16912
00116900,CLAREMONT GRADUATE UNIVERSITY           ,CA,91711-0000,Private      ,1,257,258,28,1660,1688
00117000,CLAREMONT MCKENNA COLLEGE               ,CA,91711-6400,Private      ,41,23,64,3713,204,3917
00117100,HARVEY MUDD COLLEGE                     ,CA,91711-5990,Private      ,25,9,34,2743,94,2837
00117200,PITZER COLLEGE                          ,CA,91711-6101,Private      ,32,16,48,2604,189,2793
00117300,POMONA COLLEGE                          ,CA,91711-6301,Private      ,61,38,99,4660,283,4943
00117400,SCRIPPS COLLEGE                         ,CA,91711-3948,Private      ,28,11,39,1957,134,2091
00117600,WEST HILLS COMMUNITY COLLEGE            ,CA,93210-1399,Public       ,137,262,399,1494,1239,2733
00117700,COGSWELL POLYTECHNICAL COLLEGE          ,CA,94089-1210,Proprietary  ,40,15,55,582,229,811
00117800,COLLEGE OF MARIN                        ,CA,94904-2590,Public       ,156,391,547,1074,1617,2691
00117801,COLG OF MARIN-INDIAN VALLEY CMPS        ,CA,94949-0000,Public       ,39,140,179,332,550,882
00117900,NOTRE DAME DE NAMUR UNIVERSITY          ,CA,94002-1997,Private      ,53,204,257,1468,1178,2646
00118100,COLLEGE OF SAN MATEO                    ,CA,94402-3784,Public       ,430,611,1041,3416,2563,5979
00118200,COLLEGE OF THE DESERT                   ,CA,92260-9305,Public       ,1110,1859,2969,6262,6290,12552
00118300,HOLY NAMES UNIVERSITY                   ,CA,94619-1699,Private      ,60,145,205,913,830,1743
00118500,COLLEGE OF THE REDWOODS                 ,CA,95501-9300,Public       ,299,742,1041,2467,3299,5766
00118600,COLLEGE OF THE SEQUOIAS                 ,CA,93277-2234,Public       ,708,1291,1999,6980,6347,13327
00118700,COLLEGE OF THE SISKIYOUS                ,CA,96094-2899,Public       ,111,207,318,938,951,1889
00118701,COLLEGE OF THE SISKIYOUS - YREKA CENTER ,CA,96097-9538,Public       ,15,68,83,121,300,421
00119000,CONTRA COSTA COLLEGE                    ,CA,94806-3195,Public       ,379,807,1186,2355,3162,5517
00119100,DIABLO VALLEY COLLEGE                   ,CA,94523-1544,Public       ,907,1298,2205,6426,5696,12122
00119200,CUESTA COLLEGE                          ,CA,93403-8106,Public       ,548,843,1391,4244,3591,7835
00119300,CYPRESS COLLEGE                         ,CA,90630-5897,Public       ,1258,1990,3248,11231,8546,19777
00119600,DOMINICAN UNIVERSITY OF CALIFORNIA      ,CA,94901-2298,Private      ,33,125,158,2493,1117,3610
00119700,EL CAMINO COLLEGE                       ,CA,90506-0002,Public       ,1782,2653,4435,15490,12389,27879
00119701,COMPTON COMMUNITY COLLEGE               ,CA,90221-5393,Public       ,607,1377,1984,3677,5278,8955
00119900,FOOTHILL COLLEGE                        ,CA,94022-4597,Public       ,669,1105,1774,4127,4454,8581
00120000,FULLER THEOLOGICAL SEMINARY             ,CA,91182-0000,Private      ,3,298,301,15,2062,2077
00120100,FULLERTON COLLEGE                       ,CA,92832-2095,Public       ,2038,2483,4521,15419,9673,25092
00120200,GAVILAN COLLEGE                         ,CA,95020-9599,Public       ,392,504,896,2043,1965,4008
00120300,GLENDALE COMMUNITY COLLEGE              ,CA,91208-2894,Public       ,1318,2099,3417,9684,8795,18479
00120500,GOLDEN GATE UNIVERSITY                  ,CA,94105-2967,Private      ,31,469,500,238,2424,2662
00120600,GOLDEN WEST COLLEGE                     ,CA,92647-2748,Public       ,975,1496,2471,9217,7270,16487
00120700,GRADUATE THEOLOGICAL UNION              ,CA,94709-0000,Private      ,0,16,16,1,230,231
00120800,GROSSMONT COLLEGE                       ,CA,92020-1799,Public       ,1838,3121,4959,9756,10615,20371
00120900,HARTNELL COMMUNITY COLLEGE              ,CA,93901-1697,Public       ,552,741,1293,4481,3240,7721
00121200,HUMPHREYS COLLEGE                       ,CA,95207-3896,Private      ,41,202,243,270,922,1192
00121400,IMPERIAL VALLEY COLLEGE                 ,CA,92251-9787,Public       ,1064,1414,2478,4872,3811,8683
00121500,LA SIERRA UNIVERSITY                    ,CA,92515-3332,Private      ,206,282,488,3596,1449,5045
00121600,UNIVERSITY OF LA VERNE                  ,CA,91750-4443,Private      ,209,1386,1595,6052,6662,12714
00121700,LASSEN COLLEGE                          ,CA,96130-3000,Public       ,96,137,233,526,500,1026
00121800,LOMA LINDA UNIVERSITY                   ,CA,92350-0001,Private      ,100,487,587,1230,5558,6788
00121900,LONG BEACH CITY COLLEGE                 ,CA,90808-1780,Public       ,2698,4227,6925,18053,15279,33332
00122000,MASTER'S COLLEGE & SEMINARY (THE)       ,CA,91321-1200,Private      ,48,80,128,1303,447,1750
00122300,LOS ANGELES CITY COLLEGE                ,CA,90029-3588,Public       ,1315,3531,4846,9967,15808,25775
00122400,LOS ANGELES HARBOR COLLEGE              ,CA,90744-2397,Public       ,663,1180,1843,4468,5216,9684
00122600,LOS ANGELES PIERCE COLLEGE              ,CA,91371-0001,Public       ,1500,2462,3962,12601,11777,24378
00122700,LOS ANGELES TRADE TECH COLLEGE          ,CA,90015-4181,Public       ,1125,3259,4384,6999,13572,20571
00122800,LOS ANGELES VALLEY COLLEGE              ,CA,91401-4096,Public       ,1185,2417,3602,9040,11053,20093
00122900,SO CA UNIV  HEALTH SCIENCES             ,CA,90604-4051,Private      ,5,122,127,49,727,776
00123000,MARSHALL B. KETCHUM UNIVERSITY          ,CA,92831-1699,Private      ,1,15,16,12,615,627
00123200,AMERICAN RIVER COLLEGE                  ,CA,95841-4286,Public       ,1222,3225,4447,14013,19987,34000
00123300,SACRAMENTO CITY COLLEGE                 ,CA,95822-1386,Public       ,1045,2564,3609,13980,15708,29688
00123600,MENLO COLLEGE                           ,CA,94027-4301,Private      ,51,27,78,1150,181,1331
00123700,MERCED COMMUNITY COLLEGE                ,CA,95348-2898,Public       ,809,1266,2075,6521,5642,12163
00123800,MILLS COLLEGE                           ,CA,94613-1301,Private      ,51,203,254,1416,1630,3046
00123900,MIRACOSTA COLLEGE                       ,CA,92056-3899,Public       ,1027,2122,3149,5647,7789,13436
00124000,MODESTO JUNIOR COLLEGE                  ,CA,95350-5800,Public       ,1030,2092,3122,10311,11307,21618
00124200,MONTEREY PENINSULA COLLEGE              ,CA,93940-4799,Public       ,425,673,1098,3172,2865,6037
00124300,MOUNT ST MARYS COLLEGE                  ,CA,90049-1599,Private      ,67,393,460,3589,2630,6219
00124500,MT. SAN ANTONIO COLLEGE                 ,CA,91789-1399,Public       ,2718,3751,6469,20075,15596,35671
00124600,MT SAN JACINTO COLLEGE                  ,CA,92583-2399,Public       ,1331,2631,3962,9608,12139,21747
00124700,NAPA VALLEY COLLEGE                     ,CA,94558-6236,Public       ,435,635,1070,2980,2646,5626
00124900,OCCIDENTAL COLLEGE                      ,CA,90041-3314,Private      ,50,50,100,4854,340,5194
00125000,ORANGE COAST COLLEGE - FIN AID OFF      ,CA,92628-5005,Public       ,1485,2269,3754,13791,10451,24242
00125100,OTIS COLLEGE OF ART AND DESIGN          ,CA,90045-3505,Private      ,89,104,193,1848,764,2612
00125200,HOPE INTERNATIONAL UNIVERSITY           ,CA,92631-0000,Private      ,54,154,208,921,953,1874
00125300,FRESNO PACIFIC UNIVERSITY               ,CA,93702-4798,Private      ,176,846,1022,2423,4083,6506
00125400,PACIFIC LUTHERAN THEOLOGICAL SEM        ,CA,94708-0000,Private      ,0,3,3,2,45,47
00125500,PACIFIC OAKS COLLEGE                    ,CA,91103-3606,Private      ,5,340,345,59,1517,1576
00125600,PACIFIC SCHOOL OF RELIGION              ,CA,94709-0000,Private      ,0,21,21,1,165,166
00125800,PACIFIC UNION COLLEGE                   ,CA,94508-9797,Private      ,163,107,270,1950,533,2483
00125900,PALO VERDE COLLEGE                      ,CA,92225-0000,Public       ,110,217,327,273,472,745
00126000,PALOMAR COLLEGE                         ,CA,92069-1486,Public       ,1226,2208,3434,10273,9577,19850
00126100,PASADENA CITY COLLEGE                   ,CA,91106-2003,Public       ,2725,3597,6322,18609,13282,31891
00126200,POINT LOMA NAZARENE UNIVERSITY          ,CA,92106-2899,Private      ,178,460,638,4311,1732,6043
00126600,LANEY COLLEGE                           ,CA,94607-4893,Public       ,711,2176,2887,4051,7647,11698
00126700,MERRITT COLLEGE                         ,CA,94619-3196,Public       ,438,1387,1825,2561,4917,7478
00126800,PORTERVILLE COLLEGE                     ,CA,93257-6059,Public       ,269,450,719,2312,2113,4425
00126900,RIO HONDO COLLEGE                       ,CA,90601-1699,Public       ,1787,2334,4121,11898,8662,20560
00127000,RIVERSIDE CITY COLLEGE                  ,CA,92506-1299,Public       ,2404,3610,6014,19317,16851,36168
00127200,SAN BERNARDINO VALLEY COLLEGE           ,CA,92410-2798,Public       ,1476,3550,5026,9884,13491,23375
00127300,SAN DIEGO CITY COLLEGE                  ,CA,92101-4787,Public       ,2067,5177,7244,11324,15734,27058
00127500,SAN DIEGO MESA COLLEGE                  ,CA,92111-4996,Public       ,2465,4926,7391,12360,14340,26700
00127800,SAN FRANCISCO CONSERVATORY OF MUSIC     ,CA,94122-4498,Private      ,27,40,67,282,355,637
00127900,SAN FRANCISCO THEOLOGICAL SEMINARY      ,CA,94960-0000,Private      ,0,11,11,10,67,77
00128000,SAN JOAQUIN DELTA COLLEGE               ,CA,95207-6370,Public       ,1498,2615,4113,9899,10486,20385
00128100,WILLIAM JESSUP UNIVERSITY               ,CA,95765-3707,Private      ,69,112,181,1274,683,1957
00128200,SAN JOSE CITY COLLEGE                   ,CA,95128-2797,Public       ,629,1506,2135,4848,6027,10875
00128400,SANTA ANA COLLEGE                       ,CA,92706-3398,Public       ,1141,1920,3061,9368,7836,17204
00128500,SANTA BARBARA CITY COLLEGE              ,CA,93109-2394,Public       ,891,1274,2165,9183,5762,14945
00128600,SANTA MONICA COLLEGE                    ,CA,90405-1644,Public       ,2201,2709,4910,19647,12612,32259
00128700,SANTA ROSA JUNIOR COLLEGE               ,CA,95401-4395,Public       ,958,1741,2699,6208,6326,12534
00128800,CLAREMONT SCHOOL OF THEOLOGY            ,CA,91711-0000,Private      ,0,45,45,8,282,290
00128900,SHASTA COLLEGE                          ,CA,96049-7692,Public       ,459,1138,1597,3566,4852,8418
00129000,SIERRA COLLEGE                          ,CA,95677-3397,Public       ,1005,1884,2889,8558,9071,17629
00129100,SIMPSON UNIVERSITY                      ,CA,96003-8606,Private      ,35,152,187,1173,1093,2266
00129200,SOLANO COMMUNITY COLLEGE                ,CA,94534-3197,Public       ,593,1228,1821,3786,5209,8995
00129300,VANGUARD UNIVERSITY OF SOUTHERN CA      ,CA,92626-6597,Private      ,84,186,270,2247,1124,3371
00129400,SOUTHWESTERN COLLEGE                    ,CA,91910-7299,Public       ,1463,2078,3541,10363,8650,19013
00129500,SOUTHWESTERN LAW SCHOOL                 ,CA,90010-1106,Private      ,4,118,122,61,2017,2078
00129600,DOMINICAN SCH PHILOSOPHY & THEOLOGY     ,CA,94709-0000,Private      ,0,4,4,4,34,38
00129900,ST JOHN'S SEMINARY COLLEGE              ,CA,93010-0000,Private      ,0,0,0,3,8,11
00130200,SAINT MARY'S COLLEGE OF CALIFORNIA      ,CA,94556-2744,Private      ,167,256,423,5013,1484,6497
00130500,STANFORD UNIVERSITY                     ,CA,94305-6106,Private      ,600,392,992,26264,3119,29383
00130501,STANFORD UNIVERSITY - SCHOOL OF MEDICINE,CA,94305-5404,Private      ,32,109,141,240,856,1096
00130502,STANFORD UNIVERSITY - GRADUATE SCHOOL OF,CA,94305-7298,Private      ,9,201,210,88,2255,2343
00130503,STANFORD UNIVERSITY - STANFORD LAW SCHOO,CA,94305-8610,Private      ,24,125,149,175,2062,2237
00130700,FRESNO CITY COLLEGE                     ,CA,93741-0002,Public       ,1324,3200,4524,16454,16747,33201
00130800,REEDLEY COLLEGE                         ,CA,93654-2099,Public       ,707,1150,1857,7592,5558,13150
00130900,TAFT COLLEGE                            ,CA,93268-2317,Public       ,288,478,766,1910,1814,3724
00131200,"UNIVERSITY OF CALIFORNIA, BERKELEY      ",CA,94720-1520,Public       ,1135,1539,2674,62072,18758,80830
00131300,UNIVERSITY OF CALIFORNIA-DAVIS          ,CA,95616-8558,Public       ,693,889,1582,58196,15180,73376
00131400,UNIVERSITY OF CALIFORNIA-IRVINE         ,CA,92697-2825,Public       ,656,987,1643,65393,14267,79660
00131500,UNIVERSITY OF CALIFORNIA (UCLA)         ,CA,90095-9000,Public       ,1572,2103,3675,78930,25695,104625
00131502,UNIV OF CALIFORNIA LOS ANG SCH MED      ,CA,90095-0000,Public       ,20,51,71,251,1039,1290
00131503,UNIV OF CALIFORNIA LOS ANG DENTAL       ,CA,90095-0000,Public       ,7,16,23,111,196,307
00131600,UNIVERSITY OF CALIFORNIA-RIVERSIDE      ,CA,92521-0209,Public       ,616,880,1496,44068,10068,54136
00131700,UNIVERSITY OF CALIFORNIA-SAN DIEGO      ,CA,92093-0013,Public       ,750,824,1574,58180,11049,69229
00131900,UNIVERSITY OF CALIFORNIA-SFRANCISCO     ,CA,94143-0246,Public       ,135,309,444,1553,4301,5854
00132000,UNIVERSITY OF CALIFORNIA-SANTA BARB     ,CA,93106-3180,Public       ,659,438,1097,56510,7376,63886
00132100,UNIVERSITY OF CALIFORNIA-SANTA CRUZ     ,CA,95064-0001,Public       ,509,371,880,40722,5539,46261
00132200,UNIVERSITY OF REDLANDS                  ,CA,92373-0999,Private      ,131,647,778,5495,3271,8766
00132500,UNIVERSITY OF SAN FRANCISCO             ,CA,94117-1080,Private      ,262,888,1150,12772,7391,20163
00132600,SANTA CLARA UNIVERSITY                  ,CA,95053-4956,Private      ,270,302,572,10727,2980,13707
00132604,JESUIT SCHOOL OF THEOLOGY - BERKELEY    ,CA,94709-1193,Private      ,0,5,5,1,56,57
00132800,UNIVERSITY OF SOUTHERN CALIFORNIA       ,CA,90089-0914,Private      ,989,2905,3894,43166,27808,70974
00132900,UNIVERSITY OF THE PACIFIC               ,CA,95211-0197,Private      ,227,342,569,9094,3255,12349
00132901,UNIVERSITY OF THE PACIFIC - MCGEORGE SCH,CA,95817-2799,Private      ,12,79,91,164,1140,1304
00132902,UNIV OF THE PACIFIC SCH OF DENT         ,CA,94115-0000,Private      ,2,19,21,55,625,680
00133400,VENTURA COLLEGE                         ,CA,93003-3899,Public       ,1209,1561,2770,6537,5295,11832
00133500,VICTOR VALLEY COLLEGE                   ,CA,92395-5849,Public       ,1586,2936,4522,7369,9696,17065
00133800,WEST VALLEY COLLEGE                     ,CA,95070-5697,Public       ,433,629,1062,2825,2539,5364
00134100,WESTMONT COLLEGE                        ,CA,93108-1099,Private      ,62,9,71,2503,140,2643
00134200,WHITTIER COLLEGE                        ,CA,90601-0000,Private      ,136,106,242,4121,585,4706
00134201,WHITTIER COLLEGE - COLLEGE OF LAW       ,CA,92626-1501,Private      ,3,83,86,33,1027,1060
00134300,WOODBURY UNIVERSITY                     ,CA,91510-7846,Private      ,47,99,146,1217,816,2033
00134400,YUBA COLLEGE                            ,CA,95901-7699,Public       ,464,993,1457,3659,4456,8115
00177212,TRINITY INTERNATIONAL UNIV-CA           ,CA,92705-0000,Private      ,2,92,94,5,286,291
00188100,ASHFORD UNIVERSITY                      ,CA,92123-1406,Proprietary  ,545,18830,19375,1699,70484,72183
00274100,AMERICAN JEWISH UNIVERSITY              ,CA,90077-1599,Private      ,8,31,39,74,145,219
00301002,ANTIOCH UNIV/LOS ANGELES                ,CA,90230-7615,Private      ,8,229,237,55,988,1043
00301003,ANTIOCH  UNIV/SANTA BARBARA             ,CA,93101-0000,Private      ,27,98,125,640,576,1216
00369110,MIDDLEBURY COLLEGE - MONTEREY INSTITUTE ,CA,93940-2691,Private      ,3,79,82,37,802,839
00394700,UC-HASTINGS COLLEGE OF THE LAW          ,CA,94102-0000,Public       ,6,42,48,35,2511,2546
00394800,SAN FRANCISCO ART INSTITUTE             ,CA,94133-2299,Private      ,115,153,268,1384,948,2332
00408000,STARR KING SCHOOL FOR THE MINISTRY      ,CA,94709-1299,Private      ,0,7,7,1,76,77
00448000,DE ANZA COLLEGE                         ,CA,95014-5793,Public       ,1561,1805,3366,9758,6909,16667
00448100,OHLONE COLLEGE                          ,CA,94539-5847,Public       ,492,710,1202,3604,3029,6633
00448400,JOHN F. KENNEDY UNIVERSITY              ,CA,94523-4817,Private      ,3,281,284,37,1175,1212
00449400,EVEREST COLLEGE                         ,CA,92408-3752,Proprietary  ,16,56,72,244,382,626
00449401,EVEREST COLLEGE - SANTA ANA             ,CA,92701-4559,Proprietary  ,10,22,32,144,242,386
00449402,EVEREST COLLEGE - ONTARIO               ,CA,91761-8525,Proprietary  ,5,22,27,150,448,598
00450200,CITY COLLEGE OF SAN FRANCISCO           ,CA,94112-0000,Public       ,1109,3183,4292,7738,11353,19091
00563800,DOWNEY ADULT SCHOOL                     ,CA,90241-5610,Public       ,66,237,303,277,772,1049
00565500,HACIENDA LA PUENTE ADULT EDUC CTR       ,CA,91746-0000,Public       ,61,187,248,232,565,797
00616500,LA CNTY CLG OF NURSING & ALLD HLTH      ,CA,90033-1018,Public       ,11,119,130,187,586,773
00672000,COLLEGE OF ALAMEDA                      ,CA,94501-2109,Public       ,429,1019,1448,2607,3676,6283
00673100,CASA LOMA COLLEGE                       ,CA,91405-4523,Private      ,30,111,141,146,509,655
00697300,CANADA COLLEGE                          ,CA,94061-1099,Public       ,256,528,784,1402,1851,3253
00697500,LINCOLN UNIVERSITY                      ,CA,94612-2801,Private      ,5,46,51,40,135,175
00701200,SAMUEL MERRITT COLLEGE                  ,CA,94609-3108,Private      ,34,307,341,379,2544,2923
00704700,LOS ANGELES SOUTHWEST COLLEGE           ,CA,90047-4810,Public       ,593,1709,2302,3582,7522,11104
00705000,BELLUS ACADEMY                          ,CA,91950-3616,Proprietary  ,35,61,96,126,169,295
00711500,MOORPARK COLLEGE                        ,CA,93021-1695,Public       ,1074,1132,2206,6176,4342,10518
00713000,NEWBERRY SCHOOLS OF BEAUTY              ,CA,91344-7404,Proprietary  ,23,32,55,63,98,161
00714200,LYLE'S COLLEGE OF BEAUTY                ,CA,93710-3948,Proprietary  ,18,34,52,89,147,236
00716400,BRYAN COLLEGE                           ,CA,90057-0000,Proprietary  ,69,767,836,193,2147,2340
00718700,NORTH ADRIAN'S COLLEGE OF BEAUTY        ,CA,95350-2381,Proprietary  ,32,70,102,100,167,267
00719000,WYOTECH                                 ,CA,94539-7663,Proprietary  ,6,19,25,144,166,310
00720300,SALON SUCCESS ACADEMY                   ,CA,91786-4060,Proprietary  ,9,28,37,79,121,200
00720400,MODERN BEAUTY ACADEMY                   ,CA,93030-7016,Proprietary  ,5,20,25,36,65,101
00720900,REDONDO BEACH BEAUTY COLLEGE            ,CA,90278-3111,Proprietary  ,5,17,22,16,42,58
00723400,HEALD COLLEGE                           ,CA,94105-2206,Proprietary  ,9,27,36,206,515,721
00723404,HEALD COLLEGE - CONCORD                 ,CA,94520-0000,Proprietary  ,6,33,39,350,817,1167
00723405,HEALD COLLEGE - MILPITAS                ,CA,95035-8008,Proprietary  ,3,17,20,321,781,1102
00723406,HEALD COLLEGE - HAYWARD                 ,CA,94545-2352,Proprietary  ,4,33,37,374,688,1062
00723407,HEALD COLLEGE - MODESTO                 ,CA,95368-9095,Proprietary  ,4,16,20,415,568,983
00723408,HEALD COLLEGE - ROSEVILLE               ,CA,95678-5303,Proprietary  ,3,21,24,293,789,1082
00723409,HEALD COLLEGE - SALINAS                 ,CA,93906-5100,Proprietary  ,5,14,19,306,460,766
00723410,HEALD COLLEGE - STOCKTON                ,CA,95210-5667,Proprietary  ,17,57,74,494,893,1387
00723411,HEALD COLLEGE - RANCHO CORDOVA          ,CA,95670-6005,Proprietary  ,2,8,10,208,653,861
00723412,HEALD COLLEGE - FRESNO                  ,CA,93704-1706,Proprietary  ,9,65,74,660,1109,1769
00725300,FEDERICO BEAUTY INSTITUTE               ,CA,95834-1905,Proprietary  ,52,98,150,248,372,620
00729600,COLEMAN COLLEGE                         ,CA,92123-0000,Private      ,33,142,175,166,518,684
00732909,ITT TECHNICAL INSTITUTE                 ,CA,92868-3506,Proprietary  ,115,537,652,419,1682,2101
00732971,ITT TECHNICAL INSTITUTE                 ,CA,95670-6047,Proprietary  ,96,441,537,315,1503,1818
00732976,ITT TECHNICAL INSTITUTE                 ,CA,92408-3519,Proprietary  ,155,551,706,756,2224,2980
00732981,ITT TECHNICAL INSTITUTE                 ,CA,92123-2662,Proprietary  ,133,531,664,564,2139,2703
00732985,ITT TECHNICAL INSTITUTE                 ,CA,91773-2933,Proprietary  ,57,232,289,289,1248,1537
00732989,ITT TECHNICAL INSTITUTE                 ,CA,90502-1356,Proprietary  ,83,417,500,300,1423,1723
00732994,ITT TECHNICAL INSTITUTE                 ,CA,91342-3664,Proprietary  ,101,333,434,347,1262,1609
00746901,HUSSIAN SCHOOL OF ART-RELATIVITY CAMPUS ,CA,90017-2019,Proprietary  ,10,7,17,120,22,142
00747600,MARINELLO SCHOOLS OF BEAUTY             ,CA,90023-2666,Proprietary  ,60,121,181,238,397,635
00747602,MARINELLO SCHOOLS OF BEAUTY - SPA ACADEM,CA,90048-5101,Proprietary  ,21,61,82,89,177,266
00747603,MARINELLO SCHOOLS OF BEAUTY - INGLEWOOD ,CA,90301-2306,Proprietary  ,13,55,68,106,192,298
00747604,MARINELLO SCHOOLS OF BEAUTY - RESEDA    ,CA,91335-4218,Proprietary  ,3,16,19,44,56,100
00747606,MARINELLO SCHOOLS OF BEAUTY - WEST COVIN,CA,91790-2805,Proprietary  ,14,25,39,73,119,192
00747607,MARINELLO SCHOOLS OF BEAUTY - SAN BERNAR,CA,92410-3261,Proprietary  ,61,104,165,178,299,477
00747608,MARINELLO SCHOOLS OF BEAUTY - ONTARIO   ,CA,91762-2113,Proprietary  ,29,77,106,127,227,354
00747609,MARINELLO SCHOOLS OF BEAUTY - WHITTIER  ,CA,90601-4107,Proprietary  ,28,36,64,86,126,212
00747610,MARINELLO SCHOOLS OF BEAUTY - LOMITA    ,CA,90717-1460,Proprietary  ,5,30,35,45,110,155
00747611,MARINELLO SCHOOLS OF BEAUTY - SAN DIEGO ,CA,92126-4217,Proprietary  ,34,77,111,172,313,485
00747612,MARINELLO SCHOOLS OF BEAUTY - EL CAJON  ,CA,92020-2503,Proprietary  ,9,56,65,79,172,251
00747613,MARINELLO SCHOOLS OF BEAUTY - VICTORVILL,CA,92392-5496,Proprietary  ,40,78,118,125,260,385
00747614,MARINELLO SCHOOLS OF BEAUTY - ANAHEIM   ,CA,92801-4622,Proprietary  ,31,54,85,122,149,271
00747615,MARINELLO SCHOOLS OF BEAUTY - SIMI VALLE,CA,93065-2801,Proprietary  ,5,4,9,23,30,53
00753100,ACADEMY OF ART UNIVERSITY               ,CA,94105-3410,Proprietary  ,869,2496,3365,5693,8769,14462
00753600,COSUMNES RIVER COLLEGE                  ,CA,95823-5799,Public       ,697,1690,2387,9234,9955,19189
00754802,WESTWOOD COLLEGE OF TECHNOLOGY          ,CA,92801-0000,Proprietary  ,38,74,112,364,440,804
00754803,WESTWOOD COLLEGE OF TECHNOLOGY          ,CA,91786-0000,Proprietary  ,66,87,153,515,624,1139
00760700,CONCORDE CAREER INSTITUTE               ,CA,91606-3134,Proprietary  ,71,127,198,304,585,889
00770700,COLUMBIA COLLEGE                        ,CA,95370-8580,Public       ,142,285,427,1162,1312,2474
00771300,SKYLINE COLLEGE                         ,CA,94066-1698,Public       ,573,789,1362,3694,3195,6889
00793000,CONCORDE CAREER INSTITUTE               ,CA,92108-0000,Proprietary  ,58,193,251,240,808,1048
00799300,CALIF STATE UNIV BAKERSFIELD            ,CA,93311-1022,Public       ,411,927,1338,12111,7221,19332
00807100,CONCORDE CAREER INSTITUTE               ,CA,92840-9201,Proprietary  ,40,126,166,198,614,812
00807300,BUTTE COMMUNITY COLLEGE                 ,CA,95965-0000,Public       ,665,1298,1963,6906,7015,13921
00809000,EVEREST COLLEGE                         ,CA,91803-1310,Proprietary  ,3,7,10,90,140,230
00853700,CONCORDE CAREER INSTITUTE               ,CA,92401-0000,Proprietary  ,63,198,261,353,763,1116
00859600,WEST LOS ANGELES COLLEGE                ,CA,90230-3500,Public       ,784,1768,2552,5124,7847,12971
00859700,FEATHER RIVER COLLEGE                   ,CA,95971-9124,Public       ,101,111,212,682,431,1113
00884400,CALIFORNIA CHRISTIAN COLLEGE            ,CA,93703-3599,Private      ,6,25,31,77,124,201
00884600,WRIGHT INSTITUTE                        ,CA,94704-0000,Private      ,1,67,68,3,505,508
00890300,COLLEGE OF THE CANYONS                  ,CA,91355-1899,Public       ,1620,1822,3442,8788,6371,15159
00891800,SADDLEBACK COLLEGE                      ,CA,92692-3699,Public       ,1146,1834,2980,5978,6808,12786
00902200,ASSOCIATED TECHNICAL COLLEGE            ,CA,90017-0000,Proprietary  ,32,124,156,122,338,460
00903200,EMPIRE COLLEGE                          ,CA,95403-2122,Proprietary  ,39,150,189,123,418,541
00927200,CRAFTON HILLS COLLEGE                   ,CA,92399-1799,Public       ,790,1139,1929,4149,4144,8293
00950900,SKILLS & BUSINESS EDUCATION CENTER      ,CA,95824-1529,Public       ,32,190,222,245,743,988
00974800,CARRINGTON COLLEGE                      ,CA,95826-3203,Proprietary  ,490,1118,1608,2308,4879,7187
00974801,CARRINGTON COLLEGE  - SAN LEANDRO CAMPUS,CA,94578-3711,Proprietary  ,0,0,0,6,28,34
00974802,CARRINGTON COLLEGE  - PLEASANT HILL CAMP,CA,94523-1984,Proprietary  ,0,0,0,10,29,39
00974803,CARRINGTON COLLEGE  - STOCKTON          ,CA,95207-5509,Proprietary  ,0,0,0,26,38,64
00974804,CARRINGTON COLLEGE  - CITRUS HEIGHTS    ,CA,95621-5577,Proprietary  ,0,0,0,14,16,30
00974807,CARRINGTON COLLEGE  - SAN JOSE          ,CA,95119-1325,Proprietary  ,0,0,0,42,59,101
00998900,SANTA BARBARA BUSINESS COLLEGE          ,CA,93111-0000,Proprietary  ,48,132,180,278,532,810
01011100,CERRO-COSO COMMUNITY COLLEGE            ,CA,93555-9571,Public       ,175,531,706,840,2138,2978
01014900,PEPPERDINE UNIVERSITY                   ,CA,90263-0000,Private      ,281,1009,1290,8412,5885,14297
01034000,LOS MEDANOS COLLEGE                     ,CA,94565-5197,Public       ,632,1046,1678,3610,4189,7799
01036500,CHARLES R DREW UNIV OF MED & SCI        ,CA,90059-0000,Private      ,12,166,178,121,961,1082
01039500,UNIVERSITY OF SAN DIEGO                 ,CA,92110-2492,Private      ,513,851,1364,16856,5994,22850
01039501,UNIVERSITY OF SAN DIEGO - SCHOOL OF LAW ,CA,92110-2492,Private      ,15,183,198,179,2305,2484
01044100,PARDEE RAND GRADUATE SCHOOL             ,CA,90407-2138,Private      ,1,8,9,2,22,24
01047400,MARYMOUNT COLLEGE OF PALOS VERDES       ,CA,90275-0000,Private      ,38,39,77,1044,277,1321
01085400,THOMAS JEFFERSON SCHOOL OF LAW          ,CA,92110-0000,Private      ,2,140,142,25,1224,1249
01110700,EVEREST  COLLEGE                        ,CA,92801-5231,Proprietary  ,9,38,47,183,253,436
01110900,EVEREST COLLEGE                         ,CA,91335-4631,Proprietary  ,3,18,21,88,191,279
01111200,FIDM-FASHION INSTITUTE OF DESIGN        ,CA,90015-1421,Proprietary  ,442,343,785,4288,1770,6058
01111700,ALLIANT INTERNATIONAL UNIVERSITY        ,CA,92131-1799,Private      ,26,365,391,218,1968,2186
01111705,ALLIANT INTERNATIONAL UNIVERSITY - LOS A,CA,91803-1360,Private      ,1,81,82,6,608,614
01111706,ALLIANT INTERNATIONAL UNIVERSITY - SAN F,CA,94133-1221,Private      ,4,110,114,42,663,705
01111707,ALLIANT INTERNATIONAL UNIVERSITY - FRESN,CA,93727-2014,Private      ,6,81,87,56,477,533
01112300,EVEREST COLLEGE                         ,CA,90247-4163,Proprietary  ,3,9,12,75,186,261
01146000,NATIONAL UNIVERSITY                     ,CA,92037-1011,Private      ,132,4266,4398,717,15596,16313
01162600,PRACTICAL SCHOOLS                       ,CA,92805-0000,Proprietary  ,29,77,106,205,454,659
01164900,LOYOLA MARYMOUNT UNIVERSITY             ,CA,90045-0000,Private      ,299,443,742,12991,3333,16324
01164901,LMU  - LOYOLA LAW SCHOOL                ,CA,90015-0019,Private      ,14,189,203,150,2375,2525
01167200,MENDOCINO COLLEGE                       ,CA,95482-3000,Public       ,236,520,756,1296,1890,3186
01170700,NORTH-WEST COLLEGE                      ,CA,91790-2097,Proprietary  ,74,153,227,292,493,785
01179200,FRANCISCAN SCHOOL OF THEOLOGY           ,CA,92057-6402,Private      ,0,7,7,0,33,33
01182000,SAN DIEGO MIRAMAR COLLEGE               ,CA,92126-0000,Public       ,1258,2965,4223,6025,8687,14712
01186500,CALIFORNIA HAIR DESIGN ACADEMY          ,CA,92115-0000,Proprietary  ,54,75,129,125,193,318
01186600,LU ROSS ACADEMY                         ,CA,93001-2927,Proprietary  ,52,87,139,151,271,422
01202600,BELLUS ACADEMY                          ,CA,92021-6247,Proprietary  ,28,51,79,91,144,235
01203100,SAN DIEGO CHRISTIAN COLLEGE             ,CA,92019-1157,Private      ,91,172,263,875,747,1622
01215400,CALIFORNIA INSTITUTE OF INTEGRAL STUDIES,CA,94103-2557,Private      ,7,390,397,49,1533,1582
01231600,MANCHESTER BEAUTY COLLEGE               ,CA,93726-5306,Proprietary  ,0,0,0,49,44,93
01231700,TULARE BEAUTY COLLEGE                   ,CA,93274-3432,Proprietary  ,0,0,0,10,9,19
01244600,UNIVERSAL COLLEGE OF BEAUTY             ,CA,90044-0044,Proprietary  ,11,25,36,55,109,164
01245200,EVERGREEN VALLEY COLLEGE                ,CA,95135-1598,Public       ,765,1156,1921,5099,5232,10331
01255000,LOS ANGELES MISSION COLLEGE             ,CA,91342-3200,Public       ,677,1216,1893,5622,5637,11259
01265000,MARINELLO SCHOOL OF BEAUTY              ,CA,91502-2828,Proprietary  ,71,119,190,154,271,425
01265001,MARINELLO SCHOOL OF BEAUTY - PALMDALE   ,CA,93550-4686,Proprietary  ,17,24,41,72,102,174
01284200,OXNARD COLLEGE                          ,CA,93030-0000,Public       ,780,1040,1820,3726,3663,7389
01287200,NORTH-WEST COLLEGE                      ,CA,91768-3199,Proprietary  ,119,267,386,431,880,1311
01287300,WYOTECH                                 ,CA,90810-3800,Proprietary  ,18,61,79,308,469,777
01287301,WYOTECH - EVEREST  COLLEGE              ,CA,90034-3158,Proprietary  ,3,13,16,85,134,219
01287302,WYOTECH - EVEREST  COLLEGE              ,CA,91746-3412,Proprietary  ,1,8,9,87,145,232
01290700,LAKE TAHOE COMMUNITY COLLEGE            ,CA,96150-4524,Public       ,119,320,439,581,911,1492
01291200,MTI COLLEGE                             ,CA,95841-0000,Proprietary  ,84,282,366,430,1285,1715
01294200,ROSEMEAD BEAUTY SCHOOL                  ,CA,91770-1639,Proprietary  ,12,65,77,30,183,213
01298400,PROFESSIONAL INSTITUTE OF BEAUTY        ,CA,91731-2613,Proprietary  ,11,46,57,16,63,79
01298500,HAIR CALIFORNIA BEAUTY ACADEMY          ,CA,92867-7127,Proprietary  ,5,22,27,13,51,64
01298900,OCEANSIDE COLLEGE OF BEAUTY             ,CA,92054-5393,Proprietary  ,14,44,58,59,141,200
01301000,LANCASTER BEAUTY SCHOOL                 ,CA,93534-3098,Proprietary  ,31,62,93,82,187,269
01307400,AMERICAN BEAUTY COLLEGE                 ,CA,91790-2906,Proprietary  ,19,29,48,55,78,133
01309500,SALON SUCCESS ACADEMY                   ,CA,92879-0000,Proprietary  ,45,48,93,122,196,318
01310300,CALIFORNIA WESTERN SCHOOL OF LAW        ,CA,92101-0000,Private      ,8,117,125,86,1432,1518
01324000,LYTLE'S REDWOOD EMPIRE BEAUTY CLG       ,CA,95403-0000,Proprietary  ,15,43,58,103,182,285
02054900,MARINELLO SCHOOL OF BEAUTY              ,CA,92630-0000,Proprietary  ,30,66,96,83,170,253
02054902,MARINELLO SCHOOL OF BEAUTY - BAKERSFIELD,CA,93309-5001,Proprietary  ,54,94,148,301,340,641
02054903,MARINELLO SCHOOL OF BEAUTY - VISALIA    ,CA,93277-6228,Proprietary  ,12,36,48,108,118,226
02059800,PARIS BEAUTY COLLEGE                    ,CA,94520-2611,Proprietary  ,6,36,42,39,110,149
02061600,WAYNES COLLEGE OF BEAUTY                ,CA,93906-2830,Proprietary  ,4,26,30,61,85,146
02063500,COASTLINE COMMUNITY COLLEGE             ,CA,92708-0000,Public       ,309,1774,2083,2501,7592,10093
02064300,SIERRA COLLEGE OF BEAUTY                ,CA,95340-0000,Proprietary  ,18,43,61,72,115,187
02065700,CALIFORNIA BEAUTY COLLEGE               ,CA,95354-0000,Proprietary  ,23,23,46,106,135,241
02070500,CONCORDIA UNIVERSITY                    ,CA,92612-0000,Private      ,94,564,658,2966,3176,6142
02075800,SOUTHERN CA INST OF ARCHITECTURE        ,CA,90013-0000,Private      ,15,42,57,178,367,545
02086400,MARINELLO SCHOOL OF BEAUTY              ,CA,95050-0000,Proprietary  ,10,32,42,58,146,204
02086401,MARINELLO SCHOOL OF BEAUTY - SEASIDE    ,CA,93955-3615,Proprietary  ,18,54,72,72,146,218
02086402,MARINELLO SCHOOL OF BEAUTY - SAN MATEO  ,CA,94401-3801,Proprietary  ,1,3,4,30,73,103
02086403,MARINELLO SCHOOL OF BEAUTY - HAYWARD    ,CA,94541-5111,Proprietary  ,13,49,62,82,170,252
02086404,MARINELLO SCHOOL OF BEAUTY - CASTRO VALL,CA,94546-5506,Proprietary  ,9,18,27,33,57,90
02091200,ELEGANCE INTERNATIONAL                  ,CA,90028-0000,Proprietary  ,50,88,138,208,301,509
02091700,KAPLAN COLLEGE                          ,CA,92123-1509,Proprietary  ,112,441,553,597,1895,2492
02091702,KAPLAN COLLEGE - CHULA VISTA            ,CA,91910-5342,Proprietary  ,43,94,137,213,324,537
02096100,FIELDING GRADUATE UNIVERSITY            ,CA,93105-0000,Private      ,0,229,229,5,873,878
02099200,AMERICAN CONSERVATORY THEATER           ,CA,94108-0000,Private      ,8,18,26,70,241,311
02110200,COLUMBIA COLLEGE                        ,CA,91356-0000,Private      ,34,32,66,500,193,693
02110800,CALIFORNIA COLLEGE SAN DIEGO            ,CA,92108-3821,Proprietary  ,209,643,852,1866,2586,4452
02111300,CUYAMACA COLLEGE                        ,CA,92019-0000,Public       ,877,1810,2687,4465,6335,10800
02119100,MISSION COLLEGE                         ,CA,95054-1897,Public       ,440,906,1346,3269,4245,7514
02120600,SAYBROOK GRADUATE SCHOOL                ,CA,94111-1920,Private      ,0,105,105,5,573,578
02120601,SAYBROOK UNIVERSITY -  WESTIN HOTEL     ,CA,94030-3120,Private      ,0,23,23,0,107,107
02120700,SAN JOAQUIN VALLEY COLLEGE              ,CA,93291-0000,Proprietary  ,557,1365,1922,2292,4701,6993
02125000,CAREER ACADEMY OF BEAUTY                ,CA,92845-0000,Proprietary  ,28,44,72,69,147,216
02128200,"VICTOR VALLEY BEAUTY COLLEGE, INC       ",CA,92392-0000,Proprietary  ,30,65,95,135,219,354
02128300,INSTITUTE FOR BUSINESS & TECHNOLOGY     ,CA,95050-0000,Proprietary  ,46,137,183,122,452,574
02128301,INSTITUTE FOR BUSINESS & TECHNOLOGY - NA,CA,95670-6351,Proprietary  ,13,82,95,53,307,360
02138300,PALO ALTO UNIVERSITY                    ,CA,94304-1337,Private      ,9,163,172,77,1125,1202
02161800,MUSICIANS INSTITUTE                     ,CA,90028-6157,Proprietary  ,186,231,417,859,757,1616
02167800,ESTES INSTITUTE OF COSMETOLOGY          ,CA,93291-0000,Proprietary  ,21,28,49,89,103,192
02178700,CITRUS HEIGHTS BEAUTY COLLEGE           ,CA,95610-1410,Proprietary  ,30,50,80,119,181,300
02179937,WESTERN STATE COLLEGE OF LAW            ,CA,92831-3014,Proprietary  ,3,47,50,25,697,722
02179938,"ART INSTITUTE OF CALIFORNIA, HOLLYWOOD  ",CA,91601-3112,Proprietary  ,179,283,462,1668,1240,2908
02179941,"ART INSTITUTE OF CALIFORNIA, LOS ANGELES",CA,90405-3035,Proprietary  ,234,275,509,2171,1443,3614
02179947,"ART INSTITUTE OF CALIFORNIA, SAN DIEGO  ",CA,92108-4423,Proprietary  ,298,466,764,2062,2056,4118
02185800,MOLER BARBER COLLEGE                    ,CA,94611-0000,Proprietary  ,22,75,97,58,176,234
02188400,SIERRA VALLEY COLLEGE OF COURT REPORTING,CA,93726-0000,Proprietary  ,5,27,32,47,141,188
02208600,MADERA BEAUTY COLLEGE                   ,CA,93637-3519,Proprietary  ,0,0,0,36,24,60
02211000,SALON SUCCESS ACADEMY                   ,CA,92405-0000,Proprietary  ,14,26,40,72,109,181
02220000,COLLEEN O'HARA BEAUTY ACADEMY           ,CA,92701-0000,Proprietary  ,23,18,41,42,50,92
02220200,CALIFORNIA CULINARY ACADEMY             ,CA,94102-3336,Proprietary  ,38,90,128,301,418,719
02221300,MARINELLO SCHOOL OF BEAUTY              ,CA,92553-0000,Proprietary  ,25,68,93,126,206,332
02221303,MARINELLO SCHOOL OF BEAUTY - SAN RAFAEL ,CA,94901-3224,Proprietary  ,7,19,26,32,66,98
02222000,AMERICAN FILM INSTITUTE                 ,CA,90027-0000,Private      ,46,117,163,412,834,1246
02226000,EAST LOS ANGELES COLLEGE                ,CA,91754-0000,Public       ,1896,2747,4643,15277,13871,29148
02228500,LIFE CHIROPRACTIC COLLEGE WEST          ,CA,94545-0000,Private      ,0,69,69,13,606,619
02230900,FREDRICK & CHARLES BEAUTY COLLEGE       ,CA,95501-0000,Proprietary  ,21,28,49,71,99,170
02231900,GEMOLOGICAL INSTITUTE OF AMERICA        ,CA,92008-4698,Private      ,8,67,75,45,298,343
02236400,"THANH LE COLG, SCH OF COSMETOLOGY       ",CA,92840-0000,Proprietary  ,2,17,19,6,28,34
02237200,PHILLIPS GRADUATE INSTITUTE             ,CA,91311-5541,Private      ,2,71,73,9,212,221
02241800,AMERICAN CAREER COLLEGE                 ,CA,90004-0000,Proprietary  ,394,812,1206,1500,3195,4695
02242700,BERKELEY CITY COLLEGE                   ,CA,94704-0000,Public       ,601,1148,1749,3846,4455,8301
02255400,INTERNATIONAL SCHOOL OF COSMETOLOGY     ,CA,90250-0000,Proprietary  ,52,72,124,180,230,410
02258600,AVALON SCHOOL OF COSMETOLOGY            ,CA,94501-4569,Proprietary  ,26,47,73,111,193,304
02262400,YESHIVA OHR ELCHONON CHABAD             ,CA,90046-0000,Private      ,19,0,19,95,2,97
02267600,INSTITUTE OF TRANSPERSONAL PSYCHLGY     ,CA,94303-4624,Proprietary  ,1,49,50,10,260,270
02270600,LIFE PACIFIC COLLEGE                    ,CA,91773-0000,Private      ,66,41,107,478,233,711
02276800,WESTMINSTER SEMINARY CALIFORNIA         ,CA,92027-0000,Private      ,0,14,14,7,134,141
02277400,SOUTH COAST COLLEGE                     ,CA,92868-2616,Proprietary  ,25,95,120,168,368,536
02282300,ALHAMBRA BEAUTY COLLEGE                 ,CA,91802-0000,Proprietary  ,4,31,35,21,74,95
02285100,HILLTOP BEAUTY SCHOOL                   ,CA,94014-0000,Proprietary  ,5,45,50,15,87,102
02298000,DESIGN INSTITUTE OF SAN DIEGO           ,CA,92121-0000,Proprietary  ,22,46,68,168,255,423
02304300,"PLATT COLLEGE, SAN DIEGO                ",CA,92115-0000,Proprietary  ,23,48,71,156,252,408
02306300,KAPLAN COLLEGE                          ,CA,95368-0000,Proprietary  ,59,143,202,203,494,697
02306302,KAPLAN COLLEGE - FRESNO                 ,CA,93612-3802,Proprietary  ,23,88,111,154,336,490
02309500,CLOVIS ADULT EDUC                       ,CA,93611-0000,Public       ,25,122,147,190,418,608
02330500,LAGUNA COLLEGE OF ART AND DESIGN        ,CA,92651-0000,Private      ,55,33,88,788,287,1075
02332800,CENTER FOR EMPLOYMENT TRAINING          ,CA,95110-0000,Private      ,188,717,905,421,1618,2039
02338500,GLENDALE CAREER COLLEGE                 ,CA,91203-1207,Proprietary  ,67,183,250,242,502,744
02338700,MARINELLO SCHOOL OF BEAUTY              ,CA,94103-1600,Proprietary  ,27,58,85,105,160,265
02338701,MARINELLO SCHOOL OF BEAUTY - CHICO      ,CA,95928-7184,Proprietary  ,27,49,76,104,161,265
02338702,MARINELLO SCHOOL OF BEAUTY - REDDING    ,CA,96001-1023,Proprietary  ,14,43,57,61,169,230
02338703,MARINELLO SCHOOL OF BEAUTY - FRESNO     ,CA,93711-3246,Proprietary  ,22,66,88,169,255,424
02342400,ACADEMY OF RADIO BROADCASTING           ,CA,92647-3809,Proprietary  ,10,45,55,59,145,204
02343400,BELLUS ACADEMY                          ,CA,92064-4633,Proprietary  ,52,134,186,208,414,622
02351900,KAPLAN COLLEGE                          ,CA,95660-5512,Proprietary  ,60,223,283,388,1068,1456
02351901,KAPLAN COLLEGE - BAKERSFIELD            ,CA,93304-0000,Proprietary  ,53,183,236,430,744,1174
02358000,THOMAS AQUINAS COLLEGE                  ,CA,93060-9622,Private      ,12,4,16,380,34,414
02359300,SHASTA BIBLE COLLEGE                    ,CA,96002-0000,Private      ,6,27,33,39,78,117
02482700,WESTERN UNIVERSITY OF HEALTH S          ,CA,91766-1854,Private      ,10,139,149,149,5344,5493
02494800,LOLA BEAUTY COLLEGE                     ,CA,92641-0000,Proprietary  ,10,30,40,25,62,87
02497300,TRINITY COLLEGE                         ,CA,93277-8109,Proprietary  ,68,208,276,181,555,736
02500000,SAN JOAQUIN COLLEGE OF LAW              ,CA,93612-0000,Private      ,0,36,36,28,280,308
02518400,THE NATIONAL HISPANIC UNIVERSITY        ,CA,95127-0000,Proprietary  ,10,39,49,103,189,292
02519800,AVANCE BEAUTY COLLEGE                   ,CA,92154-0000,Proprietary  ,13,27,40,99,151,250
02520200,CALIFORNIA CAREER SCHOOLS               ,CA,92805-0000,Proprietary  ,7,51,58,50,173,223
02520300,INTERIOR DESIGNERS INSTITUTE            ,CA,92660-0000,Proprietary  ,10,56,66,42,114,156
02520400,ADRIAN'S BEAUTY COLLEGE OF TURLOCK      ,CA,95382-0000,Proprietary  ,21,28,49,71,96,167
02531801,PAUL MITCHELL THE SCHOOL-COSTA MESA     ,CA,92626-3804,Proprietary  ,58,83,141,195,227,422
02531804,PAUL MITCHELL THE SCHOOL - SAN DIEGO    ,CA,92101-0000,Proprietary  ,62,93,155,249,329,578
02537200,PALOMAR INSTITUTE OF COSMETOLOGY        ,CA,92069-0000,Proprietary  ,43,73,116,170,235,405
02539100,KAPLAN COLLEGE                          ,CA,91606-3231,Proprietary  ,103,215,318,331,822,1153
02539102,KAPLAN COLLEGE -  RIVERSIDE             ,CA,92507-4223,Proprietary  ,48,157,205,331,644,975
02539500,IRVINE VALLEY COLLEGE                   ,CA,92620-0000,Public       ,848,1226,2074,6842,4937,11779
02542300,NATIONAL HOLISTIC INSTITUTE             ,CA,94608-0000,Proprietary  ,57,271,328,170,825,995
02543400,BROWNSON TECHNICAL SCHOOL               ,CA,92805-0000,Proprietary  ,14,79,93,37,161,198
02545900,HYPNOSIS MOTIVATION INSTITUTE           ,CA,91356-0000,Private      ,1,36,37,4,81,85
02546400,MTI BUSINESS COLLEGE INC                ,CA,95207-0000,Proprietary  ,7,72,79,45,207,252
02549000,KAPLAN COLLEGE                          ,CA,92083-7736,Proprietary  ,70,181,251,330,837,1167
02549005,KAPLAN COLLEGE -  PALM SPRINGS          ,CA,92262-7011,Proprietary  ,53,100,153,312,452,764
02553500,ASSOCIATED TECHNICAL COLLEGE            ,CA,92101-0000,Proprietary  ,20,93,113,107,268,375
02553600,DIVERSIFIED LANGUAGE INSTITUTE          ,CA,90017-0000,Proprietary  ,18,202,220,53,516,569
02559300,UNITED EDUCATION INSTITUTE              ,CA,90020-0000,Proprietary  ,448,1007,1455,1108,2592,3700
02559400,INTERCOAST COLLEGES                     ,CA,92868-1656,Proprietary  ,87,460,547,234,1387,1621
02570300,LOS ANGELES ORT TECHNICAL INSTITUTE     ,CA,90048-4904,Private      ,43,199,242,213,604,817
02577900,SANTA BARBARA BUSINESS COLLEGE          ,CA,93309-1664,Proprietary  ,79,174,253,405,756,1161
02578000,SANTA BARBARA BUSINESS COLLEGE          ,CA,93454-6943,Proprietary  ,37,65,102,169,292,461
02591600,NORTH-WEST COLLEGE                      ,CA,91101-1744,Proprietary  ,21,62,83,117,256,373
02595600,ASIAN AMERICAN INTERNATIONAL BTY CG     ,CA,92683-4043,Proprietary  ,5,32,37,14,53,67
02596400,SPARTAN COLLEGE OF AERONAUTICS & TECHNOL,CA,90301-2904,Proprietary  ,53,102,155,197,420,617
02597300,SOUTH BAYLO UNIVERSITY                  ,CA,92801-1701,Private      ,1,94,95,8,251,259
02602300,CENTRAL COAST COLLEGE                   ,CA,93901-3301,Proprietary  ,38,72,110,203,298,501
02608900,PINNACLE COLLEGE                        ,CA,91803-8842,Proprietary  ,19,30,49,66,78,144
02608901,PINNACLE COLLEGE - SACRAMENTO           ,CA,95670-6386,Proprietary  ,20,30,50,67,108,175
02609000,EMPERORS COLG OF TRAD ORIENTAL MED      ,CA,90403-5609,Proprietary  ,2,69,71,6,179,185
03010611,VIRGINIA COLLEGE - GOLF ACADEMY OF AMERI,CA,92008-6512,Proprietary  ,6,32,38,28,110,138
03011300,"CALIF STATE UNIV, SAN MARCOS            ",CA,92096-0001,Public       ,494,1107,1601,17562,8861,26423
03019900,CAPSTONE COLLEGE                        ,CA,91402-0000,Proprietary  ,12,28,40,32,54,86
03025600,DELL'ARTE SCH OF PHYSICAL THEATRE       ,CA,95525-0816,Private      ,0,10,10,4,33,37
03027700,PACIFIC COLLEGE OF ORIENTAL MED         ,CA,92108-4408,Proprietary  ,10,140,150,56,546,602
03029600,POMONA ADULT SCHOOL                     ,CA,91766-0000,Public       ,31,75,106,101,232,333
03031409,INTERNATIONAL ACADEMY OF DESIGN AND TECH,CA,95834-9664,Proprietary  ,6,34,40,110,176,286
03035700,LAS POSITAS COLLEGE                     ,CA,94551-6750,Public       ,320,488,808,3119,2454,5573
03039900,FREMONT COLLEGE                         ,CA,90703-5342,Proprietary  ,57,136,193,305,507,812
03043900,NEWSCHOOL OF ARCHITECTURE & DESIGN      ,CA,92101-6634,Proprietary  ,28,82,110,283,462,745
03054100,ROYALE COLLEGE OF BEAUTY                ,CA,92590-2525,Proprietary  ,13,38,51,72,113,185
03062300,WESTECH COLLEGE                         ,CA,91764-4988,Proprietary  ,64,169,233,203,486,689
03062400,MT DIABLO ADULT EDUC LOMA VISTA CTR     ,CA,94518-1122,Public       ,16,58,74,89,231,320
03062700,PLATT COLLEGE                           ,CA,90041-0000,Proprietary  ,82,156,238,482,757,1239
03062701,PLATT COLLEGE                           ,CA,91764-0000,Proprietary  ,61,104,165,344,548,892
03062702,PLATT COLLEGE - RIVERSIDE               ,CA,92507-0730,Proprietary  ,78,147,225,498,614,1112
03063400,MODERN TECHNOLOGY SCHOOL                ,CA,92708-9821,Proprietary  ,19,24,43,49,138,187
03067400,BALDWIN PARK ADULT SCHOOL               ,CA,91706-4897,Public       ,36,81,117,140,241,381
03067500,INSTITUTE OF TECHNOLOGY                 ,CA,93612-3217,Proprietary  ,137,407,544,431,1210,1641
03069500,SAGE COLLEGE                            ,CA,92557-6720,Proprietary  ,31,137,168,96,588,684
03072300,EVEREST COLLEGE                         ,CA,91761-3222,Proprietary  ,5,35,40,114,271,385
03072700,WESTWOOD COLLEGE - LOS ANGELES          ,CA,90010-1577,Proprietary  ,102,425,527,714,2117,2831
03078200,AMERICAN CLG TRADITIONAL CHINESE MD     ,CA,94107-2813,Private      ,0,25,25,8,121,129
03084700,VENTURA ADULT\CONTINUING EDUCATION      ,CA,93003-7313,Public       ,19,76,95,56,243,299
03094400,MARINELLO SCHOOL OF BEAUTY              ,CA,95841-2909,Proprietary  ,25,87,112,190,342,532
03094401,MARINELLO SCHOOL OF BEAUTY - CONCORD    ,CA,94520-2581,Proprietary  ,23,52,75,79,176,255
03094402,MARINELLO SCHOOL OF BEAUTY- STOCKTON    ,CA,95203-3149,Proprietary  ,25,57,82,122,214,336
03097700,CENTRAL CALIF SCH CONTINUING EDUC       ,CA,93401-6739,Proprietary  ,12,55,67,44,152,196
03098200,YO SAN UNIV TRADITIONAL CHINESE MED     ,CA,90066-1103,Private      ,0,45,45,4,125,129
03108100,SUMMIT COLLEGE                          ,CA,92324-3956,Proprietary  ,82,250,332,320,760,1080
03109500,DONGGUK  UNIVERSITY LOS ANGELES         ,CA,90020-1765,Private      ,2,27,29,20,97,117
03113300,UEI COLLEGE                             ,CA,93727-0000,Proprietary  ,144,553,697,524,1368,1892
03113600,SOUTHERN CALIFORNIA INST OF TECHNOL     ,CA,92805-3758,Proprietary  ,43,148,191,148,548,696
03116600,EAST SAN GABRIEL VLY REG OCCUP PROG     ,CA,91790-2105,Public       ,47,130,177,298,344,642
03125300,JOHN WESLEY INTER. BARBER & BTY CLG     ,CA,90813-4321,Proprietary  ,13,53,66,70,193,263
03125800,PREMIERE CAREER COLLEGE                 ,CA,91706-3746,Proprietary  ,32,97,129,82,249,331
03126800,PACIFICA GRADUATE INSTITUTE             ,CA,93013-0000,Proprietary  ,0,275,275,3,842,845
03128700,MT SIERRA COLLEGE                       ,CA,91016-3414,Proprietary  ,16,20,36,252,276,528
03131300,FIVE BRANCHES UNIVERSITY                ,CA,95062-4669,Proprietary  ,2,62,64,14,262,276
03144400,AMERICAN CLG OF HEALTH PROFESSIONS      ,CA,92505-3038,Proprietary  ,51,140,191,214,411,625
03150500,VIRGINIA SEWING MACHINES & SCH CTR      ,CA,90015-3535,Proprietary  ,21,48,69,28,75,103
03162300,FOUR-D SUCCESS ACADEMY                  ,CA,92324-4218,Proprietary  ,23,68,91,105,395,500
03163300,PACIFIC STATES UNIVERSITY               ,CA,90006-0000,Private      ,1,10,11,48,70,118
03195400,EVEREST COLLEGE                         ,CA,90501-2867,Proprietary  ,5,12,17,54,120,174
03210300,LE CORDON BLEU COLLEGE OF CULINARY ARTS ,CA,91101-5221,Proprietary  ,233,389,622,1358,1820,3178
03225300,AMERICAN UNIVERSITY OF HEALTH SCIENCES  ,CA,90755-3612,Proprietary  ,14,45,59,92,370,462
03242300,CAREER NETWORK INSTITUTE                ,CA,92868-4710,Proprietary  ,42,233,275,123,634,757
03250300,COMMUNITY BASED EDUCATION AND DEVELOPMEN,CA,90010-2722,Private      ,50,125,175,153,374,527
03260300,CALIFORNIA STATE U-MONTEREY BAY         ,CA,93955-8001,Public       ,263,564,827,14968,4668,19636
03266300,BETHESDA UNIVERSITY OF CALIFORNIA       ,CA,92801-4132,Private      ,42,38,80,185,150,335
03278300,CHARTER COLLEGE                         ,CA,91351-5432,Proprietary  ,40,102,142,180,477,657
03288300,ACAD CHINESE CULTURE & HEALTH SCIS      ,CA,94512-0000,Private      ,3,33,36,26,143,169
03299300,PACIFIC COLLEGE                         ,CA,92626-3160,Proprietary  ,22,105,127,103,418,521
03308300,BRISTOL UNIVERSITY                      ,CA,92806-6198,Proprietary  ,38,25,63,177,147,324
03327400,ACUPUNCTURE AND INTEGRATIVE MEDICINE COL,CA,94704-2724,Private      ,5,36,41,29,147,176
03332300,SOUTHERN CA BIBLE CLG & SEMINARY        ,CA,92019-1109,Private      ,2,68,70,10,213,223
03359300,ST. FRANCIS CAREER COLLEGE              ,CA,90262-2659,Proprietary  ,33,58,91,134,239,373
03367300,PROFESSIONAL GOLFERS CAREER COLLEGE     ,CA,92591-6013,Proprietary  ,7,16,23,61,69,130
03395300,INTERNATIONAL CAREER DEVELOPMENT        ,CA,90027-5794,Proprietary  ,179,2117,2296,563,6279,6842
03399300,NORTHWESTERN TECHNICAL COLLEGE          ,CA,95670-4443,Proprietary  ,2,9,11,12,19,31
03403300,EPIC BIBLE COLLEGE                      ,CA,95841-3546,Private      ,14,102,116,80,355,435
03413400,ENGLISH CENTER  (THE)                   ,CA,94607-3734,Private      ,9,62,71,16,156,172
03427500,UNIVERSITY OF ANTELOPE VALLEY           ,CA,93534-3324,Proprietary  ,118,266,384,579,916,1495
03440400,MARIAN HEALTH CAREERS CENTER            ,CA,90010-1728,Proprietary  ,21,74,95,59,160,219
03458300,MY LE'S BEAUTY COLLEGE                  ,CA,95824-0000,Proprietary  ,8,50,58,73,172,245
03467300,MARINELLO SCHOOL OF BEAUTY              ,CA,92545-3661,Proprietary  ,21,58,79,73,172,245
03467302,MARINELLO SCHOOL OF BEAUTY - MURRIETA   ,CA,92563-5039,Proprietary  ,19,73,92,101,175,276
03467303,MARINELLO SCHOOL OF BEAUTY - NAPA       ,CA,94559-1237,Proprietary  ,19,33,52,48,90,138
03467304,MARINELLO SCHOOL OF BEAUTY - CITY OF IND,CA,91748-1674,Proprietary  ,10,27,37,39,76,115
03467305,MARINELLO SCHOOL OF BEAUTY - BELL       ,CA,90201-1193,Proprietary  ,12,16,28,58,79,137
03467306,MARINELLO SCHOOL OF BEAUTY - PARAMOUNT  ,CA,90723-5256,Proprietary  ,9,37,46,84,148,232
03467307,MARINELLO SCHOOL OF BEAUTY - HUNTINGTON ,CA,92646-2552,Proprietary  ,7,32,39,57,120,177
03479300,PROFESSIONAL CAREER INSTITUTE           ,CA,90703-2522,Proprietary  ,13,44,57,57,110,167
03516300,KING'S UNIVERSITY (THE)                 ,CA,91405-2233,Private      ,72,216,288,191,524,715
03532400,ADVANCED TRAINING ASSOCIATES            ,CA,92020-1236,Proprietary  ,6,43,49,22,129,151
03542400,COPPER MOUNTAIN COLLEGE                 ,CA,92252-6102,Public       ,168,483,651,743,1799,2542
03577300,COBA ACADEMY                            ,CA,92866-1407,Proprietary  ,9,15,24,25,45,70
03590400,NTMA TRAINING CENTERS OF SOUTHERN C     ,CA,90650-0000,Private      ,38,115,153,108,335,443
03592400,IRELL & MANELLA GRADUATE SCHOOL OF BIOLO,CA,91010-0000,Private      ,0,0,0,4,6,10
03598300,AVALON BEAUTY COLLEGE                   ,CA,93103-3137,Proprietary  ,23,19,42,85,82,167
03614300,DAVID'S ACADEMY OF BEAUTY               ,CA,91780-1089,Proprietary  ,7,28,35,18,62,80
03639300,WEST COAST ULTRASOUND INSTITUTE         ,CA,90211-3312,Proprietary  ,89,263,352,388,1237,1625
03646300,DESIGN'S SCHOOL OF COSMETOLOGY          ,CA,93446-9530,Proprietary  ,28,49,77,73,140,213
03681300,CALIFORNIA HEALING ARTS COLLEGE         ,CA,90025-0000,Proprietary  ,15,77,92,85,259,344
03695300,COMMUNITY ENHANCEMENT SERVICES          ,CA,91502-2750,Private      ,1,46,47,11,117,128
03695700,SANTIAGO CANYON COLLEGE                 ,CA,92869-4512,Public       ,648,717,1365,4533,2772,7305
03696300,UNIVERSITY OF THE WEST                  ,CA,91770-3709,Private      ,3,16,19,54,91,145
03698300,WEST COAST UNIVERSITY                   ,CA,91606-3206,Proprietary  ,332,1233,1565,1876,6038,7914
03736300,ADVANCE BEAUTY COLLEGE                  ,CA,92843-4752,Proprietary  ,17,108,125,52,327,379
03736301,ADVANCE BEAUTY COLLEGE - LAGUNA HILLS   ,CA,92653-1980,Proprietary  ,6,13,19,28,46,74
03740400,ATI COLLEGE                             ,CA,90650-0000,Proprietary  ,9,18,27,43,115,158
03752400,SCHOOL OF URBAN MISSIONS                ,CA,94603-0000,Private      ,95,150,245,224,369,593
03759300,COMPUTER TUTOR BUSINESS & TECH INST     ,CA,95356-0000,Proprietary  ,17,48,65,64,177,241
03786300,ADVANCED COLLEGE                        ,CA,90280-5255,Proprietary  ,15,49,64,58,132,190
03797400,CAREER CARE INSTITUTE                   ,CA,93534-4766,Proprietary  ,44,146,190,216,619,835
03797401,CAREER CARE INSTITUTE - VENTURA         ,CA,93001-0000,Proprietary  ,13,44,57,63,165,228
03797402,CAREER CARE INSTITUTE - MORENO VALLEY   ,CA,92553-7519,Proprietary  ,12,25,37,58,94,152
03814400,SOKA UNIVERSITY OF AMERICA              ,CA,92656-8081,Private      ,5,7,12,521,69,590
03853300,KECK GRADUATE INSTITUTE OF APPLIED LIFE ,CA,91711-4817,Private      ,0,62,62,18,390,408
03868300,WORLD MISSION UNIVERSITY                ,CA,90020-1789,Private      ,2,20,22,12,94,106
03868400,LOS ANGELES MUSIC ACADEMY               ,CA,91105-2540,Proprietary  ,21,45,66,183,175,358
03871300,FOLSOM LAKE COLLEGE                     ,CA,95630-6798,Public       ,302,780,1082,3689,4027,7716
03874300,CAMBRIDGE JUNIOR COLLEGE                ,CA,95993-0000,Proprietary  ,8,90,98,162,386,548
03874400,COMMMUNITY CHRISTIAN COLLEGE            ,CA,92373-4465,Private      ,16,29,45,100,84,184
03889300,STANBRIDGE COLLEGE                      ,CA,92612-0000,Proprietary  ,112,277,389,464,1511,1975
03910400,NATIONAL POLYTECHNIC COLLEGE            ,CA,90040-3066,Proprietary  ,33,38,71,77,111,188
03933300,MUELLER COLLEGE OF HOLISTIC STUDIES     ,CA,92116-2630,Proprietary  ,2,51,53,23,193,216
03935300,CALIFORNIA NURSES EDUCATIONAL INSTITUTE ,CA,92234-7248,Proprietary  ,35,84,119,104,280,384
03962300,AMERICAN INSTITUTE OF MASSAGE THERAPY   ,CA,92705-5463,Proprietary  ,11,23,34,39,105,144
03964400,INTERNATIONAL SCHOOL OF BEAUTY          ,CA,92260-2740,Proprietary  ,34,80,114,108,217,325
03969600,UEI COLLEGE                             ,CA,90703-2637,Proprietary  ,160,433,593,471,1152,1623
03971300,AMERICAN CAREER COLLEGE                 ,CA,91764-4906,Proprietary  ,164,412,576,755,1558,2313
03973300,EX'PRESSION COLLEGE FOR DIGTAL ARTS     ,CA,94608-1021,Proprietary  ,64,70,134,428,338,766
03974500,CALIFORNIA CAREER COLLEGE               ,CA,91303-2006,Proprietary  ,8,48,56,35,132,167
03980300,CALIFORNIA STATE UNIVERSITY CHANNEL ISLA,CA,93012-8599,Public       ,173,364,537,10497,4169,14666
03995300,UNIVERSITY OF EAST-WEST MEDICINE        ,CA,94085-3922,Proprietary  ,1,27,28,10,70,80
03999300,BEAUMONT ADULT SCHOOL                   ,CA,92223-1927,Public       ,2,17,19,22,98,120
04001300,PALACE BEAUTY COLLEGE                   ,CA,90006-4233,Proprietary  ,13,31,44,65,127,192
04003300,BLAKE AUSTIN COLLEGE                    ,CA,95687-3100,Proprietary  ,51,131,182,193,484,677
04004300,THUY PRINCESS BEAUTY COLLEGE            ,CA,91766-0000,Proprietary  ,6,25,31,15,43,58
04005300,UNITED STATES UNIVERSITY                ,CA,91911-1683,Proprietary  ,12,102,114,53,321,374
04014400,PALLADIUM TECHNICAL ACADEMY             ,CA,91731-2429,Proprietary  ,7,11,18,13,32,45
04037300,LOS ANGELES FILM SCHOOL (THE)           ,CA,90028-7300,Proprietary  ,390,771,1161,1769,2557,4326
04056300,CAREER COLLEGE OF CALIFORNIA            ,CA,92705-5805,Proprietary  ,23,52,75,83,181,264
04057300,ASHER COLLEGE                           ,CA,95825-4025,Proprietary  ,29,202,231,146,641,787
04076400,GNOMON SCHOOL OF VISUAL EFFECTS         ,CA,90038-2616,Proprietary  ,21,60,81,144,236,380
04088300,WESTMED COLLEGE                         ,CA,95128-2541,Private      ,6,57,63,115,255,370
04088301,WESTMED COLLEGE - MERCED                ,CA,95340-9165,Private      ,9,45,54,105,251,356
04088302,WESTMED COLLEGE - FRESNO                ,CA,93720-1551,Private      ,8,17,25,42,87,129
04088303,WESTMED COLLEGE - CHULA VISTA           ,CA,91910-5200,Private      ,2,21,23,13,47,60
04092300,COASTLINE BEAUTY COLLEGE                ,CA,92708-3847,Proprietary  ,5,81,86,53,162,215
04092400,MAKE-UP DESIGNORY                       ,CA,91502-1322,Proprietary  ,45,53,98,208,225,433
04100400,TAFT UNIVERSITY SYSTEM (THE)            ,CA,92704-6954,Proprietary  ,2,102,104,8,387,395
04111300,WEST HILLS COLLEGE LEMOORE              ,CA,93245-9248,Public       ,190,633,823,2327,2899,5226
04114500,VALLEY COLLEGE OF MEDICAL CAREERS       ,CA,91304-2354,Proprietary  ,20,43,63,55,116,171
04115300,COACHELLA VALLEY BEAUTY COLLEGE         ,CA,92253-2051,Proprietary  ,23,44,67,88,131,219
04115600,MAYFIELD COLLEGE                        ,CA,92234-7014,Proprietary  ,61,145,206,150,392,542
04118800,NEW YORK FILM ACADEMY                   ,CA,91608-1002,Proprietary  ,139,264,403,794,941,1735
04119200,CAREER COLLEGE CONSULTANTS              ,CA,90041-2088,Proprietary  ,3,45,48,27,91,118
04119800,GDS INSTITUTE                           ,CA,90280-2072,Proprietary  ,4,21,25,14,35,49
04126400,CHAMPION INSTITUTE OF COSMETOLOGY       ,CA,92264-7458,Proprietary  ,6,25,31,29,63,92
04126500,COAST CAREER INSTITUTE                  ,CA,90015-3040,Proprietary  ,12,86,98,53,231,284
04127100,"UNIVERSITY OF CALIFORNIA, MERCED        ",CA,95343-5001,Public       ,137,110,247,17052,2028,19080
04127900,TRIDENT UNIVERSITY INTERNATIONAL        ,CA,90630-5023,Proprietary  ,19,997,1016,85,3747,3832
04129700,INTERNATIONAL POLYTECHNIC INSTITUTE     ,CA,92231-1737,Private      ,1,3,4,17,25,42
04129803,MEDIATECH INSTITUTE - OCEANSIDE         ,CA,92054-5116,Proprietary  ,7,21,28,46,114,160
04132400,ACADEMY OF ESTHETICS AND COSMETOLOGY    ,CA,91342-3373,Proprietary  ,14,21,35,46,65,111
04132700,INFOTECH CAREER COLLEGE                 ,CA,90706-5579,Proprietary  ,14,40,54,44,99,143
04133100,CALIFORNIA UNIVERSITY OF MANAGEMENT AND ,CA,92801-1702,Private      ,2,17,19,19,72,91
04134500,CAREER COLLEGE OF SAN DIEGO             ,CA,92102-3348,Proprietary  ,24,108,132,173,391,564
04134700,INTERNATL PROFESSIONAL SCHL OF BODYWORK ,CA,92123-1520,Proprietary  ,3,49,52,23,150,173
04137200,BORNER'S BARBER COLLEGE                 ,CA,90047-3856,Proprietary  ,11,56,67,68,202,270
04138700,PAUL MITCHELL THE SCHOOL - PASADENA     ,CA,91801-3903,Proprietary  ,35,47,82,130,157,287
04140500,HORIZON UNIVERSITY                      ,CA,92111-2622,Private      ,10,23,33,35,92,127
04141300,SAN FRANCISCO INSTITUTE OF ESTHETICS    ,CA,94103-4083,Proprietary  ,27,68,95,100,192,292
04141400,LAURUS COLLEGE                          ,CA,93401-5405,Proprietary  ,52,233,285,154,879,1033
04141700,HEALING HANDS SCHOOL OF HOLISTIC HEALTH ,CA,92025-1722,Proprietary  ,16,50,66,48,182,230
04142500,TOURO COLLEGE LOS ANGELES               ,CA,90046-4506,Private      ,22,139,161,120,524,644
04142600,TOURO UNIVERSITY                        ,CA,94592-1118,Private      ,9,210,219,59,2746,2805
04143800,WOODLAND COMMUNITY COLLEGE              ,CA,95776-5156,Public       ,148,322,470,1446,1666,3112
04144200,CAREER DEVELOPMENT INSTITUTE            ,CA,90035-4364,Proprietary  ,9,53,62,47,163,210
04145000,SAN DIEGO CULINARY INSTITUTE            ,CA,91941-6435,Proprietary  ,39,99,138,283,405,688
04145600,INTERNATIONAL COLLEGE OF COSMETOLOGY    ,CA,94601-3525,Proprietary  ,13,74,87,51,161,212
04146000,NATIONAL CAREER COLLEGE                 ,CA,91605-1400,Proprietary  ,20,85,105,57,233,290
04148200,BEYOND 21ST CENTURY BEAUTY ACADEMY      ,CA,90670-6316,Proprietary  ,3,10,13,28,35,63
04148900,N CALIF INSTITUTE OF COSMETOLOGY        ,CA,94577-2820,Proprietary  ,8,22,30,20,50,70
04149700,HOMESTEAD SCHOOLS                       ,CA,90505-5945,Private      ,24,87,111,53,197,250
04150000,CENTRAL NURSING COLLEGE                 ,CA,90010-2444,Proprietary  ,0,0,0,9,5,14
04150100,GOLDEN STATE COLLEGE OF COURT REPORTING ,CA,94568-2948,Proprietary  ,2,9,11,13,39,52
04150300,RWM FIBER OPTICS                        ,CA,90746-1051,Proprietary  ,2,58,60,14,110,124
04150500,"PREFERRED COLLEGE OF NURSING, LOS ANGELE",CA,90010-2202,Proprietary  ,2,24,26,61,161,222
04152800,CALIFORNIA ACADEMY (THE) - A PAUL MITCHE,CA,95825-2276,Proprietary  ,110,190,300,413,608,1021
04153900,PROVIDENCE CHRISTIAN COLLEGE            ,CA,91104-2635,Private      ,37,6,43,222,40,262
04155500,"ACADEMY FOR JEWISH RELIGION, CALIFORNIA ",CA,90024-3234,Private      ,2,17,19,21,79,100
04156100,TONI & GUY HAIRDRESSING ACADEMY         ,CA,95356-9695,Proprietary  ,18,27,45,90,130,220
04157800,GRACE MISSION UNIVERSITY                ,CA,92833-3860,Private      ,0,40,40,5,67,72
04158200,PAUL MITCHELL THE SCHOOL SHERMAN OAKS   ,CA,91403-5882,Proprietary  ,47,59,106,134,182,316
04158700,HOLLYWOOD BEAUTY COLLEGE                ,CA,95210-3514,Proprietary  ,0,0,0,4,4,8
04158800,THEATRE OF ARTS                         ,CA,90028-6111,Proprietary  ,20,60,80,23,75,98
04158900,FLAIR BEAUTY COLLEGE                    ,CA,91351-3381,Proprietary  ,8,20,28,33,55,88
04159600,GALAXY MEDICAL COLLEGE                  ,CA,91606-1593,Proprietary  ,5,23,28,42,54,96
04159700,AMERICAN MEDICAL SCIENCES CENTER        ,CA,91204-5108,Proprietary  ,7,47,54,40,93,133
04160100,TRINITY SCHOOL OF HEALTH AND ALLIED SCIE,CA,90248-4334,Proprietary  ,4,18,22,11,77,88
04160400,ANGELES COLLEGE OF NURSING              ,CA,90010-2100,Proprietary  ,35,143,178,378,576,954
04161300,PREFERRED COLLEGE OF NURSING            ,CA,91401-1442,Proprietary  ,1,6,7,26,39,65
04161700,SHASTA SCHOOL OF COSMETOLOGY            ,CA,96003-0000,Proprietary  ,19,29,48,85,105,190
04161800,BRANDMAN UNIVERSITY                     ,CA,92618-3801,Private      ,82,2241,2323,425,7624,8049
04162800,S.I.C.E PAUL MITCHELL PARTNER SCHOOL    ,CA,95350-1440,Proprietary  ,42,94,136,186,289,475
04163400,COSMO BEAUTY ACADEMY                    ,CA,95605-1904,Proprietary  ,15,52,67,165,248,413
04164400,ANGELES INSTITUTE                       ,CA,90712-2903,Proprietary  ,23,51,74,78,184,262
04165900,PAUL MITCHELL THE SCHOOL FRESNO         ,CA,93710-7617,Proprietary  ,47,71,118,306,264,570
04167000,PAUL MITCHELL THE SCHOOL TEMECULA       ,CA,92591-4663,Proprietary  ,62,87,149,243,264,507
04169200,TRAMY BEAUTY SCHOOL                     ,CA,92115-6347,Proprietary  ,23,72,95,94,202,296
04169700,UNITEK COLLEGE                          ,CA,94538-3185,Proprietary  ,176,556,732,523,2081,2604
04169800,GURNICK ACADEMY OF MEDICAL ARTS         ,CA,94403-1849,Proprietary  ,88,316,404,324,1623,1947
04172000,SOUTHERN CALIFORNIA UNIVERSITY SOMA     ,CA,90017-2211,Proprietary  ,19,43,62,173,250,423
04173400,SANTA ANA BEAUTY ACADEMY                ,CA,92705-7820,Proprietary  ,8,20,28,39,51,90
04173500,MORENO VALLEY COLLEGE                   ,CA,92551-2204,Public       ,931,1537,2468,5336,6426,11762
04175200,PAUL MITCHELL THE SCHOOL EAST BAY       ,CA,94523-5515,Proprietary  ,46,65,111,208,211,419
04175400,ELITE COSMETOLOGY SCHOOL                ,CA,92284-2860,Proprietary  ,14,20,34,33,71,104
04176100,NORCO COLLEGE                           ,CA,92860-2600,Public       ,891,1170,2061,5395,4958,10353
04176300,BERGIN UNIVERSITY OF CANINE STUDIES     ,CA,95407-6834,Private      ,1,14,15,20,62,82
04177200,REAL BARBERS COLLEGE (THE)              ,CA,92805-2533,Proprietary  ,23,61,84,62,123,185
04178900,HANDS-ON MEDICAL MASSAGE SCHOOL         ,CA,92373-6271,Proprietary  ,10,24,34,20,58,78
04180000,CINTA AVEDA INSTITUTE                   ,CA,94108-3204,Proprietary  ,43,86,129,160,314,474
04181200,SOUTHERN CALIFORNIA HEALTH INSTITUTE    ,CA,91601-3100,Proprietary  ,31,98,129,89,254,343
04181600,INTEGRITY COLLEGE OF HEALTH             ,CA,91104-2300,Proprietary  ,5,22,27,24,92,116
04185200,SALINAS BEAUTY COLLEGE                  ,CA,93901-2405,Proprietary  ,2,7,9,31,48,79
04185500,ACADEMY OF COUTURE ART                  ,CA,90069-5701,Proprietary  ,12,24,36,98,143,241
04185600,MEDICAL ALLIED CAREER CENTER            ,CA,90670-4710,Proprietary  ,1,18,19,21,83,104
04185700,ACADEMY FOR SALON PROFESSIONALS (THE)   ,CA,95050-4057,Proprietary  ,19,35,54,63,103,166
04186900,"INTERNATIONAL COLLEGE OF BEAUTY, ARTS & ",CA,90039-1012,Proprietary  ,18,46,64,106,186,292
04189300,ALLIED AMERICAN UNIVERSITY              ,CA,92653-1337,Proprietary  ,32,1040,1072,93,2691,2784
04189700,CALIFORNIA MIRAMAR UNIVERSITY           ,CA,92126-7501,Proprietary  ,46,155,201,384,644,1028
04189800,ACADEMY FOR SALON PROFESSIONALS         ,CA,91304-2305,Proprietary  ,12,29,41,49,104,153
04190800,SANTA ANA BEAUTY COLLEGE                ,CA,92706-2321,Proprietary  ,11,53,64,73,138,211
04190900,SUTTER BEAUTY COLLEGE                   ,CA,95991-3624,Proprietary  ,14,34,48,57,104,161
04191300,ANNENBERG SCHOOL OF NURSING             ,CA,91335-5426,Private      ,5,25,30,43,91,134
04192500,WESTCHESTER COLLEGE OF NURSING & ALLIED ,CA,90045-3647,Proprietary  ,4,26,30,28,78,106
04193300,SHEPHERD UNIVERSITY                     ,CA,90065-1415,Private      ,4,18,22,4,18,22
04193500,LEMELANGE ACADEMY OF HAIR               ,CA,94558-2935,Proprietary  ,10,20,30,26,44,70
04193700,JOHN PAUL THE GREAT CATHOLIC UNIVERSITY ,CA,92131-1652,Private      ,24,41,65,284,158,442
04194300,COLTON-REDLANDS-YUCAIPA REGIONAL OCCUPAT,CA,92374-2896,Public       ,4,28,32,72,128,200
04194600,BRAND COLLEGE                           ,CA,91203-3646,Proprietary  ,2,12,14,8,55,63
04195200,DIAMOND BEAUTY COLLEGE                  ,CA,91733-2180,Proprietary  ,3,27,30,11,46,57
04195400,NCP COLLEGE OF NURSING                  ,CA,94080-1005,Proprietary  ,23,76,99,105,259,364
04195401,NCP COLLEGE OF NURSING - HAYWARD CAMPUS ,CA,94541-7026,Proprietary  ,21,54,75,109,276,385
04205800,"SAE INSTITUTE OF TECHNOLOGY, LOS ANGELES",CA,90028-7219,Proprietary  ,34,78,112,183,254,437
04206800,ADVANCE BEAUTY TECHS ACADEMY            ,CA,92583-6572,Proprietary  ,11,21,32,51,67,118
04208100,UKIAH ADULT SCHOOL                      ,CA,95482-3865,Public       ,2,5,7,18,65,83
04208400,RIVERSIDE COUNTY OFFICE OF EDUCATION    ,CA,92503-3504,Public       ,37,119,156,276,402,678
04208900,ADVANCED CAREER INSTITUTE               ,CA,93291-9254,Proprietary  ,19,127,146,66,270,336
04209000,SAN FRANCISCO COLLEGE OF COSMETOLOGY    ,CA,94110-1217,Proprietary  ,9,37,46,91,108,199
04209800,HINTON BARBER COLLEGE                   ,CA,94590-4547,Proprietary  ,6,23,29,29,70,99
04210600,ADVANCED COMPUTING INSTITUTE            ,CA,90010-3911,Proprietary  ,14,92,106,128,232,360
04211900,XAVIER COLLEGE SCHOOL OF NURSING        ,CA,95202-1332,Proprietary  ,19,66,85,137,296,433
04212000,LAWRENCE & COMPANY COLLEGE OF COSMETOLOG,CA,93230-4102,Proprietary  ,11,24,35,74,91,165
04215100,CALIFORNIA CAREER INSTITUTE             ,CA,92840-2816,Proprietary  ,18,96,114,57,229,286
04215300,COSMO FACTORY COSMETOLOGY ACADEMY (THE) ,CA,95060-4401,Proprietary  ,2,6,8,29,36,65
04216300,UEI COLLEGE                             ,CA,95065-1520,Proprietary  ,0,0,0,32,31,63
04217100,RUDOLF STEINER COLLEGE                  ,CA,95628-6811,Private      ,0,16,16,0,77,77
04217400,HIGH TECH HIGH GRADUATE SCHOOL OF EDUCAT,CA,92106-6025,Private      ,3,22,25,22,83,105
04217500,W ACADEMY OF SALON AND SPA              ,CA,94526-4012,Proprietary  ,5,18,23,21,58,79
04221700,ZMS THE ACADEMY                         ,CA,90042-4231,Proprietary  ,3,20,23,10,29,39
04221800,TONI&GUY HAIRDRESSING ACADEMY           ,CA,95337-5703,Proprietary  ,20,25,45,56,77,133
04221900,COMPUTER TRAINING ACADEMY               ,CA,92507-2122,Proprietary  ,13,78,91,91,284,375
04222200,FAB SCHOOL (THE)                        ,CA,92507-3434,Proprietary  ,26,53,79,115,168,283
04223700,BAY AREA MEDICAL ACADEMY                ,CA,94102-2844,Proprietary  ,24,83,107,179,308,487
04226100,LAWRENCE AND COMPANY COLLEGE OF COSMETOL,CA,93662-3509,Proprietary  ,10,13,23,43,47,90
04228100,HIGH DESERT MEDICAL COLLEGE             ,CA,93534-1134,Proprietary  ,59,175,234,235,629,864
04228800,BAY AREA COLLEGE OF NURSING             ,CA,94303-4617,Proprietary  ,7,17,24,49,104,153
04234000,SAN FRANCISCO SCHOOL OF DIGITAL FILMMAKI,CA,94103-2835,Proprietary  ,12,17,29,84,112,196
04234700,CALIFORNIA INTERNATIONAL BUSINESS UNIVER,CA,92101-3431,Private      ,1,8,9,1,8,9
04235500,PRESIDIO GRADUATE SCHOOL                ,CA,94129-1749,Private      ,0,27,27,3,125,128
04237100,SALON PROFESSIONAL ACADEMY (THE)        ,CA,95129-5101,Proprietary  ,16,64,80,82,172,254
04237600,CALIFORNIA JAZZ CONSERVATORY            ,CA,94704-1268,Private      ,8,18,26,9,29,38
04237800,CALIFORNIA BARBER AND BEAUTY COLLEGE    ,CA,92115-4730,Proprietary  ,19,54,73,127,238,365
04240200,AVIATION INSTITUTE OF MAINTENANCE       ,CA,94621-4527,Proprietary  ,21,103,124,62,264,326
04241700,SAINT JOSEPH'S SCHOOL OF NURSING        ,CA,93534-2304,Proprietary  ,9,46,55,50,146,196
04242500,ASSOCIATED BARBER COLLEGE OF SAN DIEGO  ,CA,92101-4210,Proprietary  ,17,77,94,25,111,136
04242600,ABCO TECHNOLOGY                         ,CA,90045-1551,Proprietary  ,14,60,74,23,79,102
04243100,ALHAMBRA MEDICAL UNIVERSITY             ,CA,91801-7146,Proprietary  ,4,15,19,4,15,19
04243400,INTERNATIONAL SPORTS SCIENCES ASSOCIATIO,CA,93013-2912,Proprietary  ,7,96,103,7,96,103
04244000,CALIFORNIA INTERCONTINENTAL UNIVERSITY  ,CA,92614-5636,Proprietary  ,7,73,80,7,74,81
04245500,UNITED HEALTHCARE CAREERS COLLEGE       ,CA,90015-3811,Proprietary  ,4,37,41,8,56,64
00184600,BRIAR CLIFF UNIVERSITY                  ,IA,51104-2100,Private      ,84,132,216,1043,663,1706
00184700,BUENA VISTA UNIVERSITY                  ,IA,50588-9987,Private      ,98,425,523,1523,1688,3211
00184800,SOUTHEASTERN COMMUNITY COLLEGE          ,IA,52655-0000,Public       ,240,468,708,1084,1246,2330
00185000,CENTRAL COLLEGE                         ,IA,50219-1999,Private      ,101,18,119,2004,100,2104
00185200,CLARKE UNIVERSITY                       ,IA,52001-3198,Private      ,77,91,168,1152,469,1621
00185400,COE COLLEGE                             ,IA,52402-5092,Private      ,58,36,94,2573,239,2812
00185500,DES MOINES UNIV-OSTEOPATHIC MED CTR     ,IA,50312-0000,Private      ,5,143,148,34,1567,1601
00185600,CORNELL COLLEGE                         ,IA,52314-1098,Private      ,28,5,33,1757,103,1860
00185700,SOUTHWESTERN COMMUNITY COLLEGE          ,IA,50801-1098,Public       ,134,170,304,669,517,1186
00185800,DIVINE WORD COLLEGE                     ,IA,52045-0380,Private      ,6,13,19,15,20,35
00185900,DORDT COLLEGE                           ,IA,51250-1697,Private      ,55,25,80,1411,105,1516
00186000,DRAKE UNIVERSITY                        ,IA,50311-4505,Private      ,157,271,428,4642,1762,6404
00186200,ELLSWORTH COMMUNITY COLLEGE             ,IA,50126-1199,Public       ,134,71,205,675,248,923
00186400,IOWA LAKES COMMUNITY COLLEGE            ,IA,51334-2234,Public       ,163,230,393,955,664,1619
00186500,IOWA CENTRAL COMMUNITY COLLEGE          ,IA,50501-0000,Public       ,592,814,1406,2675,2444,5119
00186600,GRACELAND UNIVERSITY                    ,IA,50140-1699,Private      ,149,276,425,1379,1324,2703
00186700,GRAND VIEW UNIVERSITY                   ,IA,50316-1599,Private      ,109,209,318,1977,1152,3129
00186800,GRINNELL COLLEGE                        ,IA,50112-1690,Private      ,33,7,40,3088,84,3172
00186900,IOWA STATE UNIV SCIENCE & TECHNOLOG     ,IA,50011-2028,Public       ,945,665,1610,29309,5692,35001
00187100,IOWA WESLEYAN COLLEGE                   ,IA,52641-1398,Private      ,26,48,74,1211,321,1532
00187300,LORAS COLLEGE                           ,IA,52004-0178,Private      ,79,30,109,1950,170,2120
00187400,LUTHER COLLEGE                          ,IA,52101-1045,Private      ,64,19,83,3149,128,3277
00187500,MARSHALLTOWN COMMUNITY COLLEGE          ,IA,50158-4760,Public       ,140,203,343,668,624,1292
00187700,NORTH IOWA AREA COMMUNITY COLLEGE       ,IA,50401-7299,Public       ,209,264,473,1269,763,2032
00187900,MORNINGSIDE COLLEGE                     ,IA,51106-1751,Private      ,126,293,419,2075,842,2917
00188000,MOUNT MERCY UNIVERSITY                  ,IA,52402-4797,Private      ,95,233,328,1191,988,2179
00188300,NORTHWESTERN COLLEGE                    ,IA,51041-1996,Private      ,37,44,81,1288,187,1475
00188700,SIMPSON COLLEGE                         ,IA,50125-1297,Private      ,71,71,142,2013,424,2437
00188900,ST AMBROSE UNIVERSITY                   ,IA,52803-2898,Private      ,232,228,460,2944,1227,4171
00189000,UNIVERSITY OF NORTHERN IOWA             ,IA,50614-0002,Public       ,866,572,1438,9785,2651,12436
00189100,UNIVERSITY OF DUBUQUE                   ,IA,52001-5099,Private      ,166,195,361,2056,771,2827
00189200,UNIVERSITY OF IOWA                      ,IA,52242-1316,Public       ,1041,978,2019,21898,8111,30009
00189300,UPPER IOWA UNIVERSITY                   ,IA,52142-9206,Private      ,198,1461,1659,1709,4356,6065
00189500,WALDORF COLLEGE                         ,IA,50436-1700,Proprietary  ,119,375,494,706,1232,1938
00189600,WARTBURG COLLEGE                        ,IA,50677-2200,Private      ,61,11,72,1999,102,2101
00189700,WARTBURG THEOLOGICAL SEMINARY           ,IA,52004-5004,Private      ,1,26,27,5,92,97
00190000,WILLIAM PENN UNIVERSITY                 ,IA,52577-1799,Private      ,104,150,254,1196,791,1987
00396300,AIB COLLEGE OF BUSINESS                 ,IA,50321-1799,Private      ,12,51,63,364,374,738
00407500,ESTRN IOWA COMMUNITY COLLEGE DIST       ,IA,52801-1201,Public       ,51,148,199,246,491,737
00407501,CLINTON COMMUNITY COLLEGE               ,IA,52732-0000,Public       ,84,282,366,445,1091,1536
00407502,MUSCATINE COMMUNITY COLLEGE             ,IA,52761-0000,Public       ,119,172,291,546,559,1105
00407503,SCOTT COMMUNITY COLLEGE                 ,IA,52722-0000,Public       ,348,626,974,1431,2183,3614
00407600,KIRKWOOD COMMUNITY COLLEGE              ,IA,52406-2068,Public       ,1215,1959,3174,6140,5639,11779
00423300,MERCY/ST. LUKE'S SCH RAD TECH           ,IA,52402-0000,Private      ,2,11,13,27,47,74
00458600,KAPLAN UNIVERSITY                       ,IA,52807-2095,Proprietary  ,1104,18127,19231,3181,62025,65206
00458604,KAPLAN UNIVERSITY - CEDAR RAPIDS        ,IA,52404-2998,Proprietary  ,34,371,405,158,1502,1660
00458605,KAPLAN UNIVERSITY - DES MOINES          ,IA,50323-5702,Proprietary  ,44,450,494,168,1856,2024
00458606,KAPLAN UNIVERSITY - MASON CITY          ,IA,50401-4665,Proprietary  ,18,191,209,57,740,797
00458607,KAPLAN UNIVERSITY - CEDAR FALLS         ,IA,50613-6309,Proprietary  ,26,317,343,110,1184,1294
00458700,NORTHEAST IOWA COMMUNITY COLLEGE        ,IA,52132-0400,Public       ,130,169,299,637,494,1131
00458701,NORTHEAST IOWA COMMUNITY COLLEGE        ,IA,52068-0000,Public       ,201,334,535,894,1012,1906
00459500,HAWKEYE COMMUNITY COLLEGE               ,IA,50701-0000,Public       ,556,826,1382,2500,2266,4766
00459800,IOWA WESTERN CMTY CLG-COUNCIL BLUFF     ,IA,51502-0000,Public       ,697,796,1493,3342,2887,6229
00460000,NORTHWEST IOWA COMMUNITY COLLEGE        ,IA,51201-1046,Public       ,79,124,203,536,403,939
00626700,IOWA METHODIST MEDICAL CENTER SCHOOLS   ,IA,50309-1499,Private      ,4,18,22,38,68,106
00627300,MERCY COLLEGE OF HEALTH SCIENCES        ,IA,50309-1239,Private      ,69,219,288,470,803,1273
00712000,DES MOINES AREA CMTY COLLEGE            ,IA,50021-0000,Public       ,1394,2316,3710,7154,7600,14754
00712100,FAITH BAPTIST BIBLE CLG & THEOL SEM     ,IA,50021-0000,Private      ,22,17,39,276,56,332
00729100,ST LUKE'S COLLEGE                       ,IA,51104-0263,Private      ,11,30,41,121,186,307
00731600,WESTERN IOWA TECH COMMUNITY COLLEGE     ,IA,51106-0000,Public       ,516,847,1363,1930,2494,4424
00758800,CAPRI COLLEGE                           ,IA,52004-0873,Proprietary  ,28,51,79,127,154,281
00761100,EQ SCHOOL OF HAIR DESIGN                ,IA,51503-0813,Proprietary  ,10,16,26,25,60,85
00765600,AMERICAN COLLEGE OF HARISTYLING -CR     ,IA,52402-0000,Proprietary  ,0,0,0,4,12,16
00765800,AMER COLL OF HAIRSTYLING-DES MOINES     ,IA,50309-5446,Proprietary  ,5,16,21,14,51,65
00765900,LA JAMES COLLEGE OF HAIRSTYLING         ,IA,50401-3308,Proprietary  ,8,15,23,46,47,93
00771700,CAPRI COLLEGE                           ,IA,52807-2622,Proprietary  ,32,44,76,113,154,267
00794100,COLLEGE OF HAIR DESIGN                  ,IA,50703-1834,Proprietary  ,3,17,20,4,40,44
00826000,IOWA SCHOOL OF BEAUTY INC               ,IA,50322-0000,Proprietary  ,16,44,60,66,150,216
00840300,INDIAN HILLS COMMUNITY COLLEGE          ,IA,52501-1398,Public       ,360,667,1027,1713,2009,3722
00842400,LA JAMES INTERNATIONAL COLLEGE          ,IA,50501-5577,Proprietary  ,10,20,30,34,49,83
00959300,LA'JAMES COLLEGE OF HAIRSTYLING         ,IA,52240-0000,Proprietary  ,8,18,26,37,57,94
01111300,MAHARISHI UNIV OF MANAGEMENT            ,IA,52557-0001,Private      ,21,78,99,117,416,533
01206400,HAMILTON TECHNICAL COLLEGE              ,IA,52807-2653,Proprietary  ,23,60,83,101,187,288
01230000,PALMER COLLEGE OF CHIROPRACTIC          ,IA,52803-5287,Private      ,7,214,221,90,2245,2335
01300600,LA' JAMES INTERNATIONAL COLLEGE-CF      ,IA,50613-5242,Proprietary  ,8,18,26,23,39,62
02090300,CAPRI COLLEGE                           ,IA,52404-0000,Proprietary  ,19,55,74,97,195,292
02134500,LA JAMES INTERNATIONAL COLLEGE - DAV    ,IA,52806-3952,Proprietary  ,7,42,49,25,80,105
02160900,PCI ACADEMY                             ,IA,50010-6062,Proprietary  ,21,19,40,107,74,181
02262500,FAUST INSTITUTE OF COSMETOLOGY          ,IA,50588-0000,Proprietary  ,1,9,10,11,23,34
02274100,LA' JAMES INTERNATIONAL COLLEGE - DM    ,IA,50131-0000,Proprietary  ,10,32,42,39,105,144
02289000,AMERICAN HAIR ACADEMY                   ,IA,52627-4530,Proprietary  ,3,10,13,15,28,43
02306900,IOWA SCHOOL OF BEAUTY                   ,IA,52501-0000,Proprietary  ,9,8,17,35,35,70
02328900,EMMAUS BIBLE COLLEGE                    ,IA,52001-0000,Private      ,27,22,49,228,68,296
02330900,IOWA SCHOOL OF BEAUTY                   ,IA,50158-0000,Proprietary  ,5,7,12,14,36,50
02609200,VATTEROTT COLLEGE                       ,IA,50321-4704,Proprietary  ,21,87,108,73,383,456
03065302,PAUL MITCHELL THE SCHOOL DAVENPORT      ,IA,52806-4000,Proprietary  ,0,0,0,18,12,30
03069100,ALLEN COLLEGE                           ,IA,50703-1916,Private      ,28,97,125,364,568,932
03441300,IOWA SCHOOL OF BEAUTY                   ,IA,51106-5111,Proprietary  ,4,27,31,33,62,95
03607400,TOTAL LOOK SCHOOL OF COSMETOLOGY AND MAS,IA,52136-1053,Proprietary  ,1,2,3,3,9,12
03720300,CARLSON COLLEGE OF MASSAGE THERAPY      ,IA,52205-7519,Proprietary  ,4,9,13,10,30,40
04051313,ART INSTITUTE OF PHOENIX (THE) - BROWN M,IA,52722-3628,Proprietary  ,1,14,15,15,67,82
04177800,SALON PROFESSIONAL ACADEMY (THE)        ,IA,52240-6083,Proprietary  ,4,15,19,36,50,86
04203300,AVEDA INSTITUTE DES MOINES              ,IA,50266-8137,Proprietary  ,32,41,73,131,145,276
00259600,ATLANTIC COMMUNITY COLLEGE              ,NJ,08330-2699,Public       ,698,1026,1724,3424,3925,7349
00259700,BLOOMFIELD COLLEGE                      ,NJ,07003-3425,Private      ,162,236,398,2976,1399,4375
00259800,CALDWELL COLLEGE                        ,NJ,07006-6195,Private      ,117,174,291,2751,1049,3800
00259900,CENTENARY COLLEGE                       ,NJ,07840-2184,Private      ,53,168,221,1607,862,2469
00260000,COLLEGE OF SAINT ELIZABETH              ,NJ,07960-6989,Private      ,37,141,178,670,631,1301
00260100,CUMBERLAND COUNTY COLLEGE               ,NJ,08362-9912,Public       ,482,679,1161,2143,2733,4876
00260300,DREW UNIVERSITY                         ,NJ,07940-4063,Private      ,78,56,134,2478,551,3029
00260700,FAIRLEIGH DICKINSON UNIV-TEANECK        ,NJ,07666-1996,Private      ,236,660,896,4527,2615,7142
00260701,FAIRLEIGH DICKINSON UNIV-FLORHAM        ,NJ,07940-0000,Private      ,186,198,384,4172,1062,5234
00260702,FAIRLEIGH DICKINSON UNIV-ED WMS CLG     ,NJ,07601-0000,Private      ,46,99,145,473,436,909
00260703,FAIRLEIGH DICKINSON UNIVERSITY          ,NJ,07940-0000,Private      ,87,110,197,1546,629,2175
00260800,GEORGIAN COURT UNIVERSITY               ,NJ,08701-2697,Private      ,199,272,471,1660,1064,2724
00260900,ROWAN UNIVERSITY                        ,NJ,08028-1702,Public       ,1254,1104,2358,17673,5957,23630
00261000,FELICIAN COLLEGE                        ,NJ,07644-2198,Private      ,90,258,348,1937,1245,3182
00261300,NEW JERSEY CITY UNIVERSITY              ,NJ,07305-1597,Public       ,621,1410,2031,5135,5793,10928
00261500,MIDDLESEX COUNTY COLLEGE                ,NJ,08818-3050,Public       ,1333,1304,2637,6301,4608,10909
00261600,MONMOUTH UNIVERSITY                     ,NJ,07764-1898,Private      ,352,346,698,8727,2372,11099
00261700,MONTCLAIR STATE UNIVERSITY              ,NJ,07043-9987,Public       ,1276,1379,2655,20793,7598,28391
00261900,NEW BRUNSWICK THEOLOGICAL SEMINARY      ,NJ,08901-0000,Private      ,10,52,62,61,177,238
00262100,NEW JERSEY INST OF TECHNOLOGY           ,NJ,07102-1982,Public       ,551,723,1274,8348,3666,12014
00262200,KEAN UNIVERSITY                         ,NJ,07083-7131,Public       ,962,1473,2435,12947,8691,21638
00262400,OCEAN COUNTY COLLEGE                    ,NJ,08754-2001,Public       ,997,1086,2083,4538,3696,8234
00262500,WILLIAM PATERSON UNIVERSITY             ,NJ,07470-2152,Public       ,969,939,1908,12920,5121,18041
00262600,PRINCETON THEOLOGICAL SEMINARY          ,NJ,08542-0000,Private      ,3,40,43,15,597,612
00262700,PRINCETON UNIVERSITY                    ,NJ,08544-0001,Private      ,284,128,412,16288,1367,17655
00262800,RIDER UNIVERSITY                        ,NJ,08648-3099,Private      ,293,259,552,8517,1561,10078
00262900,"RUTGERS, THE STATE UNIVERSITY OF NJ     ",NJ,08901-1281,Public       ,3054,4429,7483,51229,27461,78690
00263200,SETON HALL UNIVERSITY                   ,NJ,07079-2697,Private      ,394,720,1114,12645,3646,16291
00263201,SETON HALL UNIVERSITY - SCHOOL OF LAW   ,NJ,07079-5210,Private      ,26,193,219,304,1394,1698
00263800,SAINT PETER'S UNIVERSITY                ,NJ,07306-5997,Private      ,226,483,709,4100,1860,5960
00263900,STEVENS INSTITUTE OF TECHNOLOGY         ,NJ,07030-5370,Private      ,232,131,363,5852,562,6414
00264200,COLLEGE OF NEW JERSEY (THE)             ,NJ,08628-0718,Public       ,599,246,845,12147,1359,13506
00264300,UNION COUNTY COLLEGE                    ,NJ,07016-1598,Public       ,1439,1983,3422,5232,7112,12344
00473600,BERGEN COMMUNITY COLLEGE                ,NJ,07652-1595,Public       ,1776,1510,3286,8132,5295,13427
00474000,MERCER COUNTY COMMUNITY COLLEGE         ,NJ,08690-0000,Public       ,745,1027,1772,3424,3513,6937
00539900,MONMOUTH COUNTY VOCATIONAL SCH DIST     ,NJ,07728-5033,Public       ,26,57,83,80,147,227
00545200,TETERBORO SCH OF AERONAUTICS            ,NJ,07608-1083,Proprietary  ,41,54,95,86,98,184
00546100,SALEM COMMUNITY COLLEGE                 ,NJ,08069-2799,Public       ,155,228,383,516,701,1217
00641700,HOLY NAME MEDICAL CENTER SCHOOL OF NURSI,NJ,07666-4254,Private      ,13,60,73,76,265,341
00642000,MOUNTAINSIDE HOSP SCH NRSG              ,NJ,07042-4898,Proprietary  ,10,15,25,23,116,139
00642100,MUHLENBERG SNYDER SCHOOLS               ,NJ,07061-3399,Private      ,23,108,131,123,447,570
00642900,ST FRANCIS MEDICAL CTR SCH NURSING      ,NJ,08629-1986,Private      ,4,40,44,24,122,146
00642902,ST FRANCIS MED CTR RAD TECH             ,NJ,08629-0000,Private      ,4,23,27,15,46,61
00686500,CAMDEN COUNTY COLLEGE                   ,NJ,08012-3240,Public       ,1450,2171,3621,5701,7082,12783
00690100,GLOUCESTER COUNTY COLLEGE               ,NJ,08080-4249,Public       ,902,826,1728,3759,2731,6490
00710700,ESSEX COUNTY COLLEGE                    ,NJ,07102-1798,Public       ,1406,2316,3722,5438,8179,13617
00750200,BERKELEY COLLEGE                        ,NJ,07424-3367,Proprietary  ,374,806,1180,2725,3798,6523
00759300,PARISIAN BEAUTY ACADEMY                 ,NJ,07601-5509,Proprietary  ,40,78,118,148,230,378
00772900,COUNTY COLLEGE OF MORRIS                ,NJ,07869-0000,Public       ,856,535,1391,3707,1972,5679
00773000,BURLINGTON COUNTY COLLEGE               ,NJ,08068-1599,Public       ,845,1337,2182,3996,4577,8573
00773100,RARITAN VALLEY COMMUNITY COLLEGE        ,NJ,08876-1265,Public       ,726,621,1347,2763,2010,4773
00780401,STAR CAREER ACADEMY - STAR LAKEWOOD     ,NJ,08701-5900,Proprietary  ,54,128,182,115,312,427
00780402,STAR CAREER ACADEMY - STAR EGG HARBOR   ,NJ,08234-4863,Proprietary  ,39,144,183,76,285,361
00793808,LINCOLN TECHNICAL INSTITUTE - SOUTH PLAI,NJ,07080-2424,Proprietary  ,26,41,67,192,188,380
00793810,LINCOLN TECHNICAL INSTITUTE - MAHWAH    ,NJ,07430-2106,Proprietary  ,107,139,246,421,386,807
00793811,LINCOLN TECHNICAL INSTITUTE - UNION     ,NJ,07083-5032,Proprietary  ,181,198,379,702,705,1407
00794700,BETH MEDRASH GOVOHA OF AMERICA          ,NJ,08701-0000,Private      ,204,480,684,280,1421,1701
00840400,BROOKDALE COMMUNITY COLLEGE             ,NJ,07738-1597,Public       ,1513,1362,2875,5421,3881,9302
00849400,HO HO KUS SCHL OF TRADE & TECH SCIENCES ,NJ,07513-1402,Proprietary  ,47,71,118,98,153,251
00860900,RABBINICAL COLLEGE OF AMERICA           ,NJ,07960-3600,Private      ,40,2,42,65,8,73
00907800,CAPRI INSTITUTE OF HAIR DESIGN          ,NJ,07011-2111,Proprietary  ,31,53,84,72,147,219
00934400,RAMAPO COLLEGE OF NEW JERSEY            ,NJ,07430-1680,Public       ,472,321,793,7970,1569,9539
00934500,RICHARD STOCKTON COLLEGE OF NJ          ,NJ,08205-9441,Public       ,678,566,1244,9562,3273,12835
00982804,EVEREST INSTITUTE - SOUTH PLAINFIELD    ,NJ,07080-1125,Private      ,59,92,151,169,319,488
00999400,PASSAIC COUNTY COMMUNITY COLLEGE        ,NJ,07505-1179,Public       ,1433,1693,3126,4160,4609,8769
01062900,P B COSMETOLOGY EDUCATION CENTRE        ,NJ,08030-1750,Proprietary  ,34,42,76,105,136,241
01085100,ANTHEM INSTITUTE                        ,NJ,07054-3409,Proprietary  ,66,198,264,124,438,562
01085101,ANTHEM INSTITUTE                        ,NJ,07306-0000,Proprietary  ,9,34,43,30,94,124
01085102,ANTHEM INSTITUTE                        ,NJ,08902-0000,Proprietary  ,7,33,40,28,75,103
01090300,RIZZIERI INSTITUTE                      ,NJ,08043-4600,Proprietary  ,27,55,82,106,138,244
01152300,MORRIS COUNTY SCHOOL OF TECHNOLOGY      ,NJ,07834-0000,Public       ,15,25,40,53,77,130
01198900,TALMUDICAL ACADEMY                      ,NJ,07710-0000,Private      ,18,0,18,29,5,34
01209000,ROBERT FIANCE BEAUTY SCHOOLS            ,NJ,08861-4118,Proprietary  ,39,68,107,71,110,181
01246100,LINCOLN TECHNICAL INSTITUTE             ,NJ,08820-2896,Proprietary  ,69,152,221,230,519,749
01246102,LINCOLN TECHNICAL INSTITUTE             ,NJ,08057-3212,Proprietary  ,41,151,192,171,652,823
01246103,LINCOLN TECHNICAL INSTITUTE             ,NJ,07652-2106,Proprietary  ,85,170,255,360,599,959
01246200,HOHOKUS - HACKENSACK SCHOOL OF BUSINESS ,NJ,07601-7197,Proprietary  ,42,134,176,121,409,530
01295400,HUDSON COUNTY COMMUNITY COLLEGE         ,NJ,07306-4012,Public       ,1521,1757,3278,5242,5581,10823
02053700,EASTWICK COLLEGE                        ,NJ,07446-0000,Proprietary  ,78,259,337,299,992,1291
02061800,ROMAN ACADEMY OF BEAUTY CULTURE         ,NJ,07506-0000,Proprietary  ,1,10,11,13,16,29
02092300,HOHOKUS SCHOOL - RETS/NUTLEY            ,NJ,07110-0000,Proprietary  ,49,91,140,153,321,474
02103700,CAPRI INSTITUTE OF HAIR DESIGN          ,NJ,07652-0000,Proprietary  ,18,37,55,48,73,121
02104000,HARRIS SCHOOL OF BUSINESS               ,NJ,08002-2983,Proprietary  ,128,541,669,255,1100,1355
02106601,AMERICAN INSTITUTE - CLIFTON            ,NJ,07011-2345,Proprietary  ,103,175,278,221,525,746
02106605,AMERICAN INSTITUTE - TOMS RIVER         ,NJ,08755-1524,Proprietary  ,39,165,204,97,365,462
02131100,DU CRET SCHOOL OF THE ARTS              ,NJ,07060-0000,Private      ,5,6,11,27,17,44
02131600,PENNCO TECH                             ,NJ,08012-0000,Proprietary  ,143,252,395,405,606,1011
02132300,FORTIS INSTITUTE                        ,NJ,07470-7041,Proprietary  ,153,212,365,343,544,887
02146800,JOE KUBERT SCH OF CARTOON & GRAPHIC     ,NJ,07801-0000,Proprietary  ,9,9,18,75,66,141
02154000,DIVERS ACAD OF EASTERN SEABOARD         ,NJ,08081-1139,Proprietary  ,15,37,52,69,121,190
02183600,CAPRI INSTITUTE OF HAIR DESIGN          ,NJ,07033-0000,Proprietary  ,22,32,54,48,86,134
02192200,THOMAS EDISON STATE COLLEGE             ,NJ,08608-0000,Public       ,103,1976,2079,462,7025,7487
02219600,OMEGA INSTITUTE                         ,NJ,08109-0000,Proprietary  ,1,10,11,5,25,30
02223700,ROBERT FIANCE BEAUTY SCHOOLS            ,NJ,07093-4623,Proprietary  ,32,105,137,54,186,240
02223900,DRAKE COLLEGE OF BUSINESS               ,NJ,07201-0000,Proprietary  ,5,21,26,31,75,106
02223902,DRAKE COLLEGE OF BUSINESS - NEWARK CAMPU,NJ,07112-2760,Proprietary  ,5,41,46,57,169,226
02232500,UNION COUNTY VOCATIONAL TECH INST       ,NJ,07076-0000,Public       ,17,30,47,65,79,144
02234600,ATLANTIC BEAUTY & SPA ACADEMY           ,NJ,08234-2621,Proprietary  ,20,56,76,54,112,166
02246000,ROSS UNIVERSITY - MEDICAL SCHOOL        ,NJ,08837-0000,Proprietary  ,2,1098,1100,20,3268,3288
02248600,COOPER HEALTH SYS-CTR ALLIED HEALTH     ,NJ,08103-0000,Private      ,15,85,100,98,292,390
02265500,CAPRI INSTITUTE OF HAIR DESIGN          ,NJ,08724-0000,Proprietary  ,17,67,84,48,135,183
02277900,ROSS UNIV - SCH OF VETERINARY MED       ,NJ,08837-0000,Proprietary  ,2,244,246,15,1486,1501
02312000,BERGEN COUNTY TECHNICAL SCHOOLS         ,NJ,07601-6110,Public       ,22,43,65,86,134,220
02503900,WARREN COUNTY COMMUNITY COLLEGE         ,NJ,07882-0000,Public       ,176,181,357,626,564,1190
02523700,OCEAN COUNTY VOCATIONAL-TECH SCHOOL     ,NJ,08753-0000,Public       ,73,130,203,245,418,663
02525900,ARTISTIC ACADEMY OF HAIR DESIGN         ,NJ,07950-1409,Proprietary  ,23,22,45,71,81,152
02528200,ROBERT FIANCE BEAUTY SCHOOLS            ,NJ,07060-4840,Proprietary  ,25,57,82,58,127,185
02558700,PRISM CAREER INSTITUTE                  ,NJ,08037-0000,Proprietary  ,32,148,180,127,681,808
02568800,SUSSEX COUNTY COMMUNITY COLLEGE         ,NJ,07860-1149,Public       ,390,324,714,1403,902,2305
02586900,HARRIS SCHOOL OF BUSINESS               ,NJ,08043-2604,Proprietary  ,52,278,330,98,506,604
02616402,SANFORD-BROWN INSTITUTE - ISELIN        ,NJ,08830-0000,Proprietary  ,12,31,43,61,218,279
03077500,RABBI JACOB JOSEPH SCHOOL               ,NJ,08817-4494,Private      ,14,0,14,29,3,32
03122600,EASTERN INTERNATIONAL COLLEGE           ,NJ,07306-3906,Proprietary  ,60,176,236,151,476,627
03187300,STENOTECH CAREER INSTITUTE              ,NJ,07004-0000,Proprietary  ,0,2,2,4,19,23
03197300,INSTITUTE FOR HEALTH EDUCATION(THE)     ,NJ,07306-2929,Proprietary  ,0,0,0,2,7,9
03324300,CENTRAL CAREER SCHOOL                   ,NJ,07080-2408,Proprietary  ,24,75,99,37,122,159
03380302,STAR CAREER ACADEMY - STAR NEWARK       ,NJ,07102-4510,Proprietary  ,66,185,251,151,521,672
03380303,STAR CAREER ACADEMY - STAR CLIFTON      ,NJ,07011-2248,Proprietary  ,43,107,150,79,215,294
03536300,INSTITUTE FOR THERAPEUTIC MASSAGE       ,NJ,07420-1452,Proprietary  ,7,46,53,19,106,125
03650600,PC AGE                                  ,NJ,07306-3936,Proprietary  ,20,102,122,45,265,310
03650603,PC AGE                                  ,NJ,08817-2842,Proprietary  ,5,18,23,21,49,70
03666300,PILLAR COLLEGE                          ,NJ,07102-5511,Private      ,17,177,194,86,676,762
03803300,HEALTHCARE TRAINING INSTITUTE           ,NJ,07083-3504,Proprietary  ,33,108,141,80,286,366
03811300,EASTERN SCHOOL OF ACUPUNCTURE AND TRADIT,NJ,07042-3562,Proprietary  ,2,24,26,5,56,61
04081300,BAIS MEDRASH TORAS CHESED               ,NJ,08701-0000,Private      ,7,6,13,20,14,34
04123400,YESHIVAS BE'ER YITZCHOK                 ,NJ,07208-2380,Private      ,10,6,16,17,33,50
04125000,GENTLE HEALING SCHOOL OF MASSAGE        ,NJ,08512-3600,Proprietary  ,1,9,10,3,28,31
04131100,YESHIVA TORAS CHAIM                     ,NJ,08701-2120,Private      ,26,0,26,97,1,98
04131200,TOTAL IMAGE BEAUTY ACADEMY              ,NJ,07307-2943,Proprietary  ,14,55,69,21,87,108
04134100,JERSEY COLLEGE                          ,NJ,07608-1104,Proprietary  ,69,613,682,187,2169,2356
04136400,AMERICAN INSTITUTE OF MEDICAL SCIENCES &,NJ,07080-1183,Proprietary  ,26,95,121,82,287,369
04154500,STARTING POINTS FOR CHILDREN            ,NJ,07306-0001,Private      ,7,24,31,19,66,85
04154900,NATIONAL CAREER INSTITUTE               ,NJ,07018-2011,Proprietary  ,19,113,132,29,223,252
04154901,NATIONAL CAREER INSTITUTE - JERSEY CITY ,NJ,07306-4300,Proprietary  ,15,65,80,40,153,193
04173100,LAB PAUL MITCHELL PARTNER SCHOOL (THE)  ,NJ,08628-2500,Proprietary  ,17,18,35,42,61,103
04180300,MESIVTA KESER TORAH                     ,NJ,07719-2409,Private      ,1,0,1,2,1,3
04181400,BEST CARE TRAINING INSTITUTE            ,NJ,07018-1703,Proprietary  ,0,42,42,14,119,133
04184500,CHRISTINE VALMY INTERNATIONAL SCHOOL OF ,NJ,07058-9589,Proprietary  ,8,19,27,25,53,78
04188700,ASI CAREER INSTITUTE                    ,NJ,08012-1043,Proprietary  ,5,51,56,13,131,144
04192400,YESHIVA GEDOLAH ZICHRON LEYMA           ,NJ,07036-3905,Private      ,2,1,3,5,2,7
04207500,MEDICAL CAREER INSTITUTE                ,NJ,07712-7202,Proprietary  ,12,57,69,27,128,155
04215600,AMERICAN INSTITUTE OF PHARMACEUTICAL TEC,NJ,07601-9991,Proprietary  ,28,305,333,53,429,482
04216000,UNIVERSAL TRAINING INSTITUTE            ,NJ,08861-4106,Proprietary  ,7,60,67,20,120,140
04216100,YESHIVA YESODEI HATORAH                 ,NJ,08701-4946,Private      ,0,0,0,1,0,1
04216500,RIZZIERI INSTITUTE                      ,NJ,08043-1911,Proprietary  ,14,33,47,38,70,108
04218200,PAUL MITCHELL THE SCHOOL - JERSEY SHORE ,NJ,08723-3413,Proprietary  ,29,52,81,67,111,178
04218500,SALON PROFESSIONAL ACADEMY THE          ,NJ,07080-0000,Proprietary  ,17,58,75,50,132,182
00266500,VAUGHN COLLEGE OF AERONAUTICS AND TECHNO,NY,11369-9997,Private      ,220,252,472,1184,848,2032
00266600,ADELPHI UNIVERSITY                      ,NY,11530-4299,Private      ,386,789,1175,8808,3957,12765
00266700,DOWLING COLLEGE                         ,NY,11769-1999,Private      ,135,203,338,1609,758,2367
00266800,ALFRED UNIVERSITY                       ,NY,14802-1205,Private      ,126,189,315,3696,636,4332
00266900,BANK STREET COLLEGE OF EDUCATION        ,NY,10025-0000,Private      ,2,82,84,16,629,645
00267100,BARD COLLEGE                            ,NY,12504-5000,Private      ,38,30,68,3787,611,4398
00267400,NEW YORK THEOLOGICAL SEMINARY           ,NY,10115-0002,Private      ,1,95,96,6,254,260
00267700,BROOKLYN LAW SCHOOL                     ,NY,11201-0000,Private      ,14,203,217,62,2293,2355
00267800,BRYANT & STRATTON COLLEGE               ,NY,14203-1713,Proprietary  ,584,3304,3888,2099,12563,14662
00267803,BRYANT & STRATTON COLLEGE - GREECE      ,NY,14606-4227,Proprietary  ,65,276,341,253,1059,1312
00267805,BRYANT & STRATTON COLLEGE - SYRACUSE    ,NY,13203-2502,Proprietary  ,121,267,388,522,1160,1682
00267807,BRYANT & STRATTON COLLEGE - ALBANY      ,NY,12205-5230,Proprietary  ,49,213,262,196,737,933
00268100,CANISIUS COLLEGE                        ,NY,14208-1098,Private      ,182,315,497,4699,1572,6271
00268500,CAZENOVIA COLLEGE                       ,NY,13035-1085,Private      ,60,30,90,2028,243,2271
00268700,CUNY-BROOKLYN COLLEGE                   ,NY,11210-2814,Public       ,1558,2456,4014,20480,11674,32154
00268800,CITY COLLEGE-CUNY                       ,NY,10031-9198,Public       ,1259,2037,3296,20742,10474,31216
00268900,CUNY-HUNTER COLLEGE                     ,NY,10021-0000,Public       ,1786,2577,4363,27749,14588,42337
00269000,QUEENS COLLEGE-CUNY                     ,NY,11367-1597,Public       ,1438,1949,3387,18682,8656,27338
00269100,CUNY- BOROUGH OF MANHATTAN CMTY CLG     ,NY,10007-1047,Public       ,4380,4050,8430,28025,16445,44470
00269200,CUNY BRONX COMMUNITY COLLEGE            ,NY,10453-3102,Public       ,1940,2530,4470,11196,10003,21199
00269300,CUNY-JOHN JAY CLG CRIMINAL JUSTICE      ,NY,10019-1093,Public       ,1276,1568,2844,16858,8086,24944
00269400,KINGSBOROUGH COMMUNITY COLLEGE          ,NY,11235-2398,Public       ,2711,2443,5154,13409,7678,21087
00269600,NY CITY COLLEGE OF TECHNOLOGY-CUNY      ,NY,11201-2983,Public       ,1854,2130,3984,18891,9248,28139
00269700,QUEENSBOROUGH COMMUNITY COLLEGE         ,NY,11364-1497,Public       ,1762,1353,3115,14676,6353,21029
00269800,CUNY THE COLLEGE OF STATEN ISLAND       ,NY,10314-6600,Public       ,1550,1082,2632,13702,4555,18257
00269900,CLARKSON UNIVERSITY                     ,NY,13699-5615,Private      ,67,69,136,6372,535,6907
00270000,COLGATE ROCHESTER CROZER DIVINITY S     ,NY,14620-0000,Private      ,2,24,26,9,83,92
00270100,COLGATE UNIVERSITY                      ,NY,13346-1386,Private      ,83,7,90,4249,112,4361
00270300,COLLEGE OF MOUNT SAINT VINCENT          ,NY,10471-1093,Private      ,135,117,252,2652,482,3134
00270400,COLLEGE OF NEW ROCHELLE                 ,NY,10805-2339,Private      ,112,1047,1159,1068,3785,4853
00270500,COLLEGE OF SAINT ROSE                   ,NY,12203-1490,Private      ,261,272,533,4847,1455,6302
00270700,COLUMBIA UNIVERSITY                     ,NY,10027-0000,Private      ,514,1638,2152,24174,19774,43948
00270800,BARNARD COLLEGE-COLUMBIA UNIV           ,NY,10027-6598,Private      ,75,79,154,4898,423,5321
00270900,CONCORDIA COLLEGE                       ,NY,10708-1998,Private      ,55,205,260,885,726,1611
00271000,COOPER UNION                            ,NY,10003-7120,Private      ,46,47,93,1889,246,2135
00271100,CORNELL UNIVERSITY                      ,NY,14853-2801,Private      ,545,470,1015,28855,5578,34433
00271101,WEILL CORNELL MEDICAL COLLEGE AND GRADUA,NY,10021-0000,Private      ,5,56,61,41,692,733
00271200,D'YOUVILLE COLLEGE                      ,NY,14201-1084,Private      ,142,353,495,1908,2037,3945
00271300,DOMINICAN COLLEGE                       ,NY,10962-1299,Private      ,151,237,388,1826,901,2727
00271800,ELMIRA COLLEGE                          ,NY,14901-2099,Private      ,92,81,173,2151,310,2461
00272200,FORDHAM UNIVERSITY                      ,NY,10458-5157,Private      ,640,1122,1762,27108,7795,34903
00272600,GENERAL THEOLOGICAL SEMINARY            ,NY,10011-0000,Private      ,0,10,10,2,56,58
00272800,HAMILTON COLLEGE                        ,NY,13323-1218,Private      ,55,8,63,3091,90,3181
00272900,HARTWICK COLLEGE                        ,NY,13820-4020,Private      ,90,16,106,2553,149,2702
00273100,HOBART & WILLIAM SMITH COLLEGES         ,NY,14456-3397,Private      ,47,10,57,3045,105,3150
00273200,HOFSTRA UNIVERSITY                      ,NY,11549-1010,Private      ,600,715,1315,17415,4944,22359
00273400,HOUGHTON COLLEGE                        ,NY,14744-0128,Private      ,37,39,76,1269,148,1417
00273500,HILBERT COLLEGE                         ,NY,14075-1597,Private      ,115,87,202,988,303,1291
00273700,IONA COLLEGE                            ,NY,10801-1890,Private      ,148,129,277,8170,1127,9297
00273900,ITHACA COLLEGE                          ,NY,14850-7130,Private      ,266,67,333,13943,1054,14997
00274000,JEWISH THEOLOGICAL SEMINARY OF AMER     ,NY,10027-4649,Private      ,3,8,11,125,130,255
00274200,THE JUILLIARD SCHOOL                    ,NY,10023-6588,Private      ,57,52,109,1468,796,2264
00274400,KEUKA COLLEGE                           ,NY,14478-0000,Private      ,128,240,368,2037,1154,3191
00274800,LEMOYNE COLLEGE                         ,NY,13214-1399,Private      ,236,170,406,5344,945,6289
00274900,NEW YORK COLLEGE OF PODIATRIC MED       ,NY,10035-1940,Private      ,2,27,29,35,436,471
00275100,LONG ISLAND UNIVERSITY                  ,NY,11548-1326,Private      ,907,2127,3034,12418,9660,22078
00275800,MANHATTAN COLLEGE                       ,NY,10471-4098,Private      ,227,164,391,7046,791,7837
00275900,MANHATTAN SCHOOL OF MUSIC               ,NY,10027-4689,Private      ,38,50,88,667,627,1294
00276000,MANHATTANVILLE COLLEGE                  ,NY,10577-2132,Private      ,141,169,310,3174,771,3945
00276300,MARIA COLLEGE                           ,NY,12208-1798,Private      ,70,211,281,328,723,1051
00276500,MARIST COLLEGE                          ,NY,12601-1387,Private      ,503,323,826,8763,1181,9944
00276900,MARYMOUNT MANHATTAN COLLEGE             ,NY,10021-4597,Private      ,153,53,206,4099,337,4436
00277200,MERCY COLLEGE                           ,NY,10522-1189,Private      ,752,1906,2658,5683,6462,12145
00277500,MOLLOY COLLEGE                          ,NY,11570-1100,Private      ,231,410,641,4302,2142,6444
00277700,MEDAILLE COLLEGE                        ,NY,14214-2695,Private      ,235,501,736,1564,1539,3103
00277800,MOUNT SAINT MARY COLLEGE                ,NY,12550-3494,Private      ,213,239,452,3714,1069,4783
00277900,NAZARETH COLLEGE OF ROCHESTER           ,NY,14618-3790,Private      ,107,145,252,3696,1345,5041
00278200,NEW YORK INSTITUTE OF TECHNOLOGY        ,NY,11568-8000,Private      ,545,473,1018,6360,2220,8580
00278202,NY INSTITUTE OF TECHNOLOGY-OSTEOPATHIC M,NY,11568-0000,Private      ,2,36,38,54,1168,1222
00278300,NEW YORK LAW SCHOOL                     ,NY,10013-0000,Private      ,7,216,223,61,1982,2043
00278400,NEW YORK MEDICAL COLLEGE                ,NY,10595-0000,Private      ,10,124,134,30,1725,1755
00278500,NEW YORK UNIVERSITY                     ,NY,10012-1091,Private      ,1340,2935,4275,46306,25310,71616
00278800,NIAGARA UNIVERSITY                      ,NY,14109-2010,Private      ,219,196,415,3953,938,4891
00279000,NYACK COLLEGE                           ,NY,10960-3698,Private      ,162,535,697,1162,1572,2734
00279100,PACE UNIVERSITY - NEW YORK              ,NY,10038-1598,Private      ,491,719,1210,13145,3758,16903
00279101,PACE UNIVERSITY-PLEASANTVILLE           ,NY,10570-0000,Private      ,163,250,413,3895,1154,5049
00279102,PACE UNIVERSITY - WHITE PLAINS          ,NY,10603-0000,Private      ,23,221,244,561,1400,1961
00279500,PAUL SMITHS CLG OF ARTS & SCIENCES      ,NY,12970-0000,Private      ,91,34,125,1239,179,1418
00279800,PRATT INSTITUTE                         ,NY,11205-3899,Private      ,270,252,522,5040,1932,6972
00280300,RENSSELAER POLYTECHNIC INSTITUTE        ,NY,12180-3590,Private      ,256,50,306,12369,670,13039
00280500,ROBERTS WESLEYAN COLLEGE                ,NY,14624-1997,Private      ,107,336,443,1518,1194,2712
00280600,ROCHESTER INSTITUTE OF TECHNOLOGY       ,NY,14623-5608,Private      ,849,452,1301,17373,2449,19822
00280700,ROCKEFELLER UNIVERSITY                  ,NY,10021-0000,Private      ,0,17,17,19,49,68
00280800,DAEMEN COLLEGE                          ,NY,14226-3592,Private      ,229,292,521,2849,1176,4025
00281000,THE SAGE COLLEGES                       ,NY,12180-4199,Private      ,92,259,351,2268,1832,4100
00281200,TROCAIRE COLLEGE                        ,NY,14220-2094,Private      ,105,324,429,780,1416,2196
00281300,SARAH LAWRENCE COLLEGE                  ,NY,10708-5999,Private      ,43,47,90,2197,618,2815
00281400,SKIDMORE COLLEGE                        ,NY,12866-1632,Private      ,53,13,66,4690,142,4832
00281500,ST BERNARDS SCH THEOLOGY & MINISTRY     ,NY,14618-3822,Private      ,1,5,6,2,31,33
00281600,SIENA COLLEGE                           ,NY,12211-1462,Private      ,359,68,427,6137,323,6460
00281700,ST BONAVENTURE UNIVERSITY               ,NY,14778-2284,Private      ,144,79,223,2782,386,3168
00282000,ST FRANCIS COLLEGE                      ,NY,11201-4398,Private      ,405,242,647,3013,786,3799
00282100,ST JOHN FISHER COLLEGE                  ,NY,14618-3597,Private      ,248,323,571,4836,1656,6492
00282200,CHRIST THE KING SEMINARY                ,NY,14052-0607,Private      ,0,0,0,0,2,2
00282300,ST JOHN'S UNIVERSITY                    ,NY,11439-1343,Private      ,594,633,1227,22587,5747,28334
00282500,ST JOSEPH'S COLLEGE                     ,NY,11205-3688,Private      ,125,228,353,1490,753,2243
00282501,ST JOSEPH'S COLLEGE-SUFFOLK CAMPUS      ,NY,11772-0000,Private      ,371,428,799,2732,1549,4281
00282900,ST LAWRENCE UNIVERSITY                  ,NY,13617-1455,Private      ,139,27,166,3171,155,3326
00283200,ST THOMAS AQUINAS COLLEGE               ,NY,10976-1050,Private      ,261,91,352,1823,242,2065
00283300,ST VLADIMIR ORTHODOX THEOL SEM          ,NY,10707-0000,Private      ,0,7,7,0,46,46
00283400,EXCELSIOR COLLEGE                       ,NY,12203-5159,Private      ,195,4192,4387,670,12505,13175
00283500,SUNY AT ALBANY                          ,NY,12222-0001,Public       ,1451,877,2328,22021,4624,26645
00283600,BINGHAMTON UNIVERSITY (SUNY)            ,NY,13902-6000,Public       ,1098,505,1603,26596,2925,29521
00283700,SUNY AT BUFFALO                         ,NY,14260-0001,Public       ,1384,1292,2676,25305,9265,34570
00283800,SUNY AT STONY BROOK                     ,NY,11794-0701,Public       ,1506,1221,2727,28634,7769,36403
00283900,SUNY-DOWNSTATE MEDICAL CENTER           ,NY,11203-2098,Public       ,25,271,296,197,2268,2465
00284000,SUNY UPSTATE MEDICAL UNIVERSITY         ,NY,13210-2375,Public       ,18,107,125,249,1430,1679
00284100,SUNY BROCKPORT - FIN AID OFF            ,NY,14420-2914,Public       ,821,620,1441,10009,2789,12798
00284200,BUFFALO STATE COLLEGE - SUNY            ,NY,14222-1095,Public       ,1405,1100,2505,14638,4340,18978
00284300,SUNY COLLEGE-CORTLAND                   ,NY,13045-0900,Public       ,657,228,885,11505,1303,12808
00284400,SUNY AT FREDONIA                        ,NY,14063-1145,Public       ,500,135,635,7059,880,7939
00284500,SUNY GENESEO                            ,NY,14454-1401,Public       ,314,68,382,8980,560,9540
00284600,SUNY COLLEGE-NEW PALTZ                  ,NY,12561-2499,Public       ,545,311,856,13015,2050,15065
00284700,SUNY COLLEGE-ONEONTA                    ,NY,13820-4015,Public       ,676,130,806,11247,810,12057
00284800,SUNY OSWEGO                             ,NY,13126-3599,Public       ,873,352,1225,11575,1779,13354
00284900,SUNY COLLEGE AT PLATTSBURGH             ,NY,12901-2681,Public       ,606,272,878,8027,1310,9337
00285000,SUNY COLLEGE-POTSDAM                    ,NY,13676-2294,Public       ,462,157,619,5760,868,6628
00285100,SUNY COLLEGE OF ENVIRONMENT SCIENCE AND ,NY,13210-2778,Public       ,106,115,221,2411,556,2967
00285300,SUNY MARITIME COLLEGE                   ,NY,10465-4198,Public       ,139,76,215,2052,389,2441
00285400,SUNY COLLEGE OF TECHNOLOGY-ALFRED       ,NY,14802-9951,Public       ,446,197,643,4894,930,5824
00285500,SUNY CANTON COLG OF TECHNOLOGY          ,NY,13617-1098,Public       ,323,253,576,3696,1318,5014
00285600,SUNY AG & TECH COLLEGE-COBLESKILL       ,NY,12043-9986,Public       ,367,126,493,3488,592,4080
00285700,SUNY DELHI                              ,NY,13753-1190,Public       ,417,297,714,4225,1213,5438
00285800,SUNY FARMINGDALE                        ,NY,11735-1021,Public       ,880,685,1565,7231,2725,9956
00285900,SUNY COLLEGE OF AG & TECH AT MORRISVILLE,NY,13408-0901,Public       ,409,199,608,4006,825,4831
00286000,ADIRONDACK COMMUNITY COLLEGE            ,NY,12804-1445,Public       ,621,542,1163,2248,1494,3742
00286100,CAYUGA COMMUNITY COLLEGE                ,NY,13021-3099,Public       ,433,607,1040,1553,1725,3278
00286200,BROOME COMMUNITY COLLEGE                ,NY,13902-0000,Public       ,957,900,1857,4465,2652,7117
00286300,CORNING COMMUNITY COLLEGE               ,NY,14830-3297,Public       ,468,461,929,1769,1447,3216
00286400,DUTCHESS COMMUNITY COLLEGE              ,NY,12601-1595,Public       ,945,605,1550,4399,1997,6396
00286600,FASHION INSTITUTE OF TECHNOLOGY         ,NY,10001-5992,Public       ,599,580,1179,9423,3133,12556
00286700,SUNY FULTON MONTGOMERY COMM CLG         ,NY,12095-3790,Public       ,373,278,651,1454,886,2340
00286800,HUDSON VALLEY COMMUNITY COLLEGE         ,NY,12180-6096,Public       ,1365,1273,2638,5950,3961,9911
00286900,JAMESTOWN COMMUNITY COLLEGE             ,NY,14702-0020,Public       ,459,463,922,2186,1454,3640
00287000,JEFFERSON COMMUNITY COLLEGE             ,NY,13601-1897,Public       ,433,791,1224,1658,2211,3869
00287100,"SUNY, MOHAWK VALLEY COMMUNITY CLG       ",NY,13501-5394,Public       ,855,813,1668,3507,2541,6048
00287200,MONROE COMMUNITY COLLEGE                ,NY,14623-5780,Public       ,2115,2475,4590,8920,8043,16963
00287300,NASSAU COMMUNITY COLLEGE                ,NY,11530-6793,Public       ,3597,2390,5987,11303,6780,18083
00287400,NIAGARA COUNTY COMMUNITY COLLEGE        ,NY,14132-9460,Public       ,844,695,1539,3550,2338,5888
00287500,ONONDAGA COMMUNITY COLLEGE              ,NY,13215-4585,Public       ,1130,1127,2257,6828,3832,10660
00287600,ORANGE COUNTY COMMUNITY COLLEGE         ,NY,10940-6441,Public       ,855,697,1552,2860,2131,4991
00287700,ROCKLAND COMMUNITY COLLEGE              ,NY,10901-3611,Public       ,1159,776,1935,2754,1944,4698
00287800,SUFFOLK COMMUNITY COLLEGE               ,NY,11784-2899,Public       ,1530,932,2462,6837,3173,10010
00287801,SUFFOLK COMMUNITY CLG-W. CAMPUS         ,NY,11717-0000,Public       ,1246,940,2186,4891,3165,8056
00287803,SUFFOLK COMMUNITY CLG-EASTRN CAMPUS     ,NY,11901-0000,Public       ,425,331,756,1754,1017,2771
00287900,SULLIVAN COUNTY COMMUNITY COLLEGE       ,NY,12759-5151,Public       ,232,213,445,997,624,1621
00288000,ULSTER COUNTY COMMUNITY COLLEGE         ,NY,12484-0557,Public       ,318,307,625,1131,891,2022
00288100,SUNY WESTCHESTER COMMUNITY COLLEGE      ,NY,10595-1698,Public       ,1835,1621,3456,6211,4737,10948
00288200,SYRACUSE UNIVERSITY                     ,NY,13244-2130,Private      ,489,748,1237,27428,6394,33822
00288300,UTICA COLLEGE- UTICA                    ,NY,13502-4892,Private      ,178,407,585,4634,2426,7060
00288500,ALBANY COLLEGE OF PHARMACY AND HEALTH SC,NY,12208-3492,Private      ,27,25,52,1706,772,2478
00288600,ALBANY LAW SCHOOL                       ,NY,12208-0000,Private      ,11,53,64,55,790,845
00288700,ALBANY MEDICAL COLLEGE                  ,NY,12208-0000,Private      ,12,65,77,78,1054,1132
00288900,UNION COLLEGE                           ,NY,12308-2311,Private      ,51,23,74,3901,143,4044
00289000,UNION THEOLOGICAL SEMINARY              ,NY,10027-0000,Private      ,0,42,42,4,266,270
00289200,UNITED STATES MERCHANT MARINE ACADEMY   ,NY,11024-1634,Public       ,9,3,12,365,19,384
00289400,UNIVERSITY OF ROCHESTER                 ,NY,14627-9000,Private      ,138,295,433,9021,1893,10914
00289401,EASTMAN SCH OF MUSIC/UNIV ROCHESTER     ,NY,14604-0000,Private      ,13,37,50,791,391,1182
00289402,UNIV OF ROCHESTER SCHL OF MEDICINE      ,NY,14642-0000,Private      ,5,53,58,58,723,781
00289500,VASSAR COLLEGE                          ,NY,12604-0008,Private      ,75,30,105,4763,194,4957
00289600,VILLA MARIA COLLEGE-BUFFALO             ,NY,14225-3999,Private      ,116,100,216,520,300,820
00289900,WAGNER COLLEGE                          ,NY,10301-4495,Private      ,141,108,249,2642,549,3191
00290000,WEBB INSTITUTE                          ,NY,11542-1398,Private      ,7,1,8,101,5,106
00290100,WELLS COLLEGE                           ,NY,13026-0500,Private      ,22,7,29,1378,75,1453
00290300,YESHIVA UNIVERSITY                      ,NY,10033-3201,Private      ,153,197,350,2215,2125,4340
00290302,YESHIVA UNIVERSITY - BRONX CAMPUS       ,NY,10461-1975,Private      ,10,49,59,98,1143,1241
00397400,MESIVTHA TIFERETH JERUSALEM OF AMER     ,NY,10002-6382,Private      ,7,0,7,13,3,16
00397600,RABBINICAL ACAD MESIVTA RABBI CHAIM     ,NY,11230-4715,Private      ,0,1,1,1,2,3
00397700,RABBINICAL COLLEGE CH'SAN SOFER         ,NY,11204-1252,Private      ,0,1,1,0,2,2
00397800,RABBINICAL SEMINARY OF AMERICA          ,NY,11375-0000,Private      ,38,17,55,74,31,105
00397900,COLUMBIA UNIV TEACHERS COLLEGE          ,NY,10027-0000,Private      ,14,532,546,95,4324,4419
00405400,HEBREW UNION COL-JEWISH INST OF REL     ,NY,10012-0000,Private      ,0,9,9,0,216,216
00475900,"CUNY, YORK COLLEGE                      ",NY,11451-0001,Public       ,769,1207,1976,12272,5607,17879
00476500,CUNY GRADUATE SCH & UNIV CTR            ,NY,10016-4309,Public       ,26,652,678,124,2980,3104
00477600,CENTRAL YESHIVA TOMCHEI TMIMIM LUBA     ,NY,11230-2798,Private      ,11,6,17,21,8,29
00478800,HERKIMER COUNTY COMMUNITY COLLEGE       ,NY,13350-1598,Public       ,355,352,707,1977,1076,3053
00479800,MIRRER YESHIVA CENTRAL INST             ,NY,11223-2010,Private      ,27,20,47,36,22,58
00479900,MONROE COLLEGE                          ,NY,10468-4305,Proprietary  ,796,1378,2174,4472,5376,9848
00481100,EVEREST INSTITUTE                       ,NY,14621-3007,Proprietary  ,3,22,25,41,293,334
00506400,SAINT JAMES MERCY HOSPITAL SCHOOL OF RAD,NY,14843-2197,Private      ,0,0,0,1,3,4
00520800,THE COLLEGE OF WESTCHESTER              ,NY,10602-0000,Proprietary  ,135,222,357,824,784,1608
00587700,ROBERT J HOCHSTIM SCHOOL OF RADIOG      ,NY,11572-1151,Private      ,0,3,3,1,9,10
00643501,ARNOT OGDEN MEDICAL CENTER              ,NY,14905-1676,Private      ,8,15,23,40,48,88
00643800,PHILLIPS BETH ISRAEL SCH OF NURSING     ,NY,10001-6354,Private      ,10,74,84,78,334,412
00644300,COCHRAN SCH NSG-ST JOHN RVSDE HOSP      ,NY,10701-1399,Private      ,5,33,38,25,163,188
00644500,CROUSE HOSP SCH OF NURSING              ,NY,13210-1690,Private      ,19,69,88,199,301,500
00644800,BELANGER SCHOOL OF NURSING              ,NY,12304-1009,Private      ,12,37,49,55,175,230
00646100,SAINT ELIZABETH MEDICAL CENTER          ,NY,13501-2998,Private      ,21,25,46,142,156,298
00646700,SAINT JOSEPH'S COLLEGE OF NURSING       ,NY,13203-1806,Private      ,12,34,46,227,250,477
00678200,GENESEE COMMUNITY COLLEGE               ,NY,14020-9704,Public       ,595,758,1353,2663,2207,4870
00678500,SCHENECTADY COUNTY COMMUNITY CLG        ,NY,12305-2294,Public       ,675,737,1412,2155,1991,4146
00678700,CLINTON COMMUNITY COLLEGE               ,NY,12901-5690,Public       ,246,149,395,998,569,1567
00678800,TOMPKINS CORTLAND COMMUNITY COLLEGE     ,NY,13053-0139,Public       ,511,430,941,2511,1389,3900
00678900,COLUMBIA-GREENE COMMUNITY COLLEGE       ,NY,12534-9543,Public       ,269,327,596,731,802,1533
00679100,SUNY AT PURCHASE                        ,NY,10577-1400,Public       ,503,210,713,7503,1077,8580
00702200,CUNY-LEHMAN COLLEGE                     ,NY,10468-1589,Public       ,955,2380,3335,13429,11842,25271
00702600,MOUNT SINAI SCHOOL OF MEDICINE          ,NY,10029-0000,Private      ,7,92,99,41,1034,1075
00710900,SUNY COLLEGE-OLD WESTBURY               ,NY,11568-0210,Public       ,351,380,731,5558,2104,7662
00711100,NORTH COUNTRY COMMUNITY COLLEGE         ,NY,12983-2046,Public       ,128,192,320,638,551,1189
00726400,MESIFTA TORAH VODAATH RABBINCAL SEM     ,NY,11218-5209,Private      ,2,13,15,4,14,18
00727300,CUNY-BERNARD BARUCH COLLEGE             ,NY,10010-5518,Public       ,1095,1600,2695,19131,9127,28258
00730400,CULINARY INSTITUTE OF AMERICA           ,NY,12538-1499,Private      ,341,270,611,3484,1237,4721
00732916,ITT TECHNICAL INSTITUTE                 ,NY,12205-1003,Proprietary  ,27,120,147,113,392,505
00737200,AUSTIN'S SCHOOL OF SPA TECHNOLOGY       ,NY,12206-1513,Proprietary  ,46,104,150,124,285,409
00737500,ISLAND DRAFTING & TECHNICAL INST        ,NY,11701-2704,Proprietary  ,19,15,34,70,50,120
00738700,LONG ISLAND BEAUTY SCHOOL               ,NY,11788-4346,Proprietary  ,47,97,144,106,193,299
00738800,LONG ISLAND BEAUTY SCHOOL               ,NY,11550-3704,Proprietary  ,14,34,48,31,99,130
00739100,BEAUTY SCHOOL OF MIDDLETOWN             ,NY,10940-6574,Proprietary  ,14,34,48,35,67,102
00739400,BERKELEY COLLEGE                        ,NY,10017-0000,Proprietary  ,463,974,1437,2806,4106,6912
00740100,MANDL SCHOOL                            ,NY,10019-5516,Proprietary  ,60,179,239,193,844,1037
00740500,WOOD TOBE-COBURN SCHOOL                 ,NY,10016-0102,Proprietary  ,36,21,57,376,112,488
00746500,AMERICAN ACADEMY OF DRAMATIC ARTS       ,NY,10016-7089,Private      ,84,56,140,1106,339,1445
00746600,LIM COLLEGE                             ,NY,10022-5268,Proprietary  ,138,96,234,1998,502,2500
00746800,SCHOOL OF VISUAL ARTS                   ,NY,10010-3994,Proprietary  ,206,132,338,3622,1369,4991
00751800,APEX TECHNICAL SCHOOL                   ,NY,10011-0000,Proprietary  ,155,379,534,379,1004,1383
00752200,CONTINENTAL SCH OF BEAUTY CULTURE       ,NY,14623-3231,Proprietary  ,88,205,293,157,370,527
00752205,CONTINENTAL SCHOOL OF BEAUTY CULTURE - M,NY,13211-1003,Proprietary  ,5,16,21,16,32,48
00753200,FINGER LAKES COMMUNITY COLLEGE          ,NY,14424-8395,Public       ,551,560,1111,3192,2199,5391
00757200,AMERICAN MUSICAL AND DRAMATIC ACAD      ,NY,10023-2106,Private      ,244,81,325,3060,520,3580
00757300,EMPIRE BEAUTY SCHOOL                    ,NY,11103-4028,Proprietary  ,162,395,557,573,1421,1994
00780400,STAR CAREER ACADEMY                     ,NY,10011-7307,Proprietary  ,50,181,231,122,453,575
00793809,LINCOLN TECHNICAL INSTITUTE - WHITESTONE,NY,11357-6092,Proprietary  ,112,81,193,460,286,746
00818900,CONTINENTAL SCHOOL OF BEAUTY CULTURE - B,NY,14224-3402,Proprietary  ,26,60,86,52,90,142
00818903,CONTINENTAL SCHOOL OF BEAUTY CULTURE - B,NY,14223-2911,Proprietary  ,15,85,100,67,161,228
00843700,CHAMPLAIN VALLEY - TEC/PRN              ,NY,12901-0000,Public       ,19,52,71,48,108,156
00849500,JAMESTOWN BUSINESS COLLEGE              ,NY,14702-0429,Proprietary  ,52,61,113,203,212,415
00861100,"CUNY, HOSTOS CMTY COLLEGE               ",NY,10451-2946,Public       ,1352,1899,3251,8553,7462,16015
00861400,RABBINICAL CLG BOBOVER YESHIVA BNEI     ,NY,11219-3293,Private      ,37,0,37,39,2,41
00878800,STATE UNIVERSITY OF NEW YORK STUDENT LOA,NY,12246-0000,Public       ,33,62,95,369,282,651
00902900,NEIGHBORHOOD PLAYHOUSE                  ,NY,10022-5017,Private      ,1,14,15,26,46,72
00904300,ELMIRA BUSINESS INSTITUTE               ,NY,14901-2731,Proprietary  ,23,128,151,69,546,615
00907700,UTICA SCHOOL OF COMMERCE                ,NY,13501-2280,Proprietary  ,9,61,70,58,202,260
00924800,SAMARITAN HOSPITAL SCH NURSING          ,NY,12180-2475,Private      ,11,41,52,63,216,279
00928300,MIDWAY-PARIS BEAUTY SCHOOL              ,NY,11385-3453,Proprietary  ,12,33,45,19,61,80
00928400,BRITTANY BEAUTY SCHOOL                  ,NY,11756-1345,Proprietary  ,39,87,126,74,174,248
00933500,MESIVTA EASTERN PKWY RABBINICAL CLG     ,NY,11218-5559,Private      ,9,2,11,13,3,16
00947900,SAINT VINCENTS CMC SI NURSING SCHOOL    ,NY,10304-3850,Proprietary  ,53,140,193,187,536,723
00976900,METROPOLITAN COLLEGE OF NEW YORK        ,NY,10013-1919,Private      ,36,479,515,179,1903,2082
00992900,SUNY COLLEGE OF OPTOMETRY               ,NY,10036-8003,Public       ,5,11,16,18,359,377
01005100,LA GUARDIA CMTY COLLEGE - CUNY          ,NY,11101-3083,Public       ,2361,2681,5042,16176,10565,26741
01005200,JEFFERSON-LEWIS BOCES PRAC NRSGPRG      ,NY,13601-9509,Public       ,10,47,57,26,160,186
01009700,CUNY-MEDGAR W EVERS COLLEGE             ,NY,11225-2010,Public       ,807,1503,2310,7526,5941,13467
01014200,TOURO COLLEGE                           ,NY,10010-4202,Private      ,915,2589,3504,2926,9146,12072
01014700,WESTERN SUFFOLK BOCES                   ,NY,11768-3499,Public       ,53,94,147,158,287,445
01015300,HELENE FULD COL OF NRSNG/N GEN HOSP     ,NY,10035-0000,Private      ,8,260,268,25,664,689
01028600,EMPIRE STATE COLLEGE                    ,NY,12866-4391,Public       ,245,2336,2581,954,10821,11775
01037800,RABBINICAL COLLEGE OF LONG ISLAND       ,NY,11561-3244,Private      ,33,1,34,42,2,44
01054900,KEHILATH YAKOV RABBINICAL SEMINARY      ,NY,10562-1001,Private      ,0,0,0,2,2,4
01055100,NEW YORK SCH MED & DENTAL ASSISTANT     ,NY,11101-2327,Proprietary  ,38,112,150,96,234,330
01064100,SOUTHERN WESTCHESTER BOCES              ,NY,10543-0000,Public       ,15,103,118,35,171,206
01068400,ERIE COMMUNITY COLLEGE-ALL CAMPUSES     ,NY,14203-2698,Public       ,1995,2258,4253,6816,6496,13312
01081300,AMERICAN ACAD MCALLISTER INST           ,NY,10019-3604,Private      ,29,121,150,117,606,723
01094300,RABBINICAL COLLEGE BETH SHRAGA          ,NY,10952-3033,Private      ,8,0,8,8,1,9
01095200,PNW BOCES LPN PROGRAM                   ,NY,10598-0000,Public       ,7,32,39,15,53,68
01103100,TECHNICAL CAREER INSTITUTE              ,NY,10001-2789,Proprietary  ,359,762,1121,806,2305,3111
01118900,UNITED TALMUDICAL SEMINARY              ,NY,11211-7984,Private      ,0,0,0,1,1,2
01119200,BETH HAMEDRASH SHAAREI YOSHER INST      ,NY,11204-1052,Private      ,1,0,1,1,1,2
01161400,CHAMPLAIN VALLEY HOSP SCH RAD TECH      ,NY,12901-1490,Private      ,2,6,8,23,23,46
01161700,NEW YORK METHODIST HOSPITAL             ,NY,11229-9023,Private      ,48,153,201,119,442,561
01164700,SBI CAMPUS - AN AFFILIATE OF SANFORD-BRO,NY,11747-3785,Proprietary  ,8,7,15,71,132,203
01167700,MEMORIAL SLOAN KETTERING CANCER CTR     ,NY,10021-6094,Private      ,1,11,12,3,30,33
01167800,SUNY INST OF TECHNOLOGY UTICA ROME      ,NY,13504-3050,Public       ,206,261,467,2482,1052,3534
01182100,YESHIVATH ZICHRON MOSHE                 ,NY,12779-0580,Private      ,45,1,46,45,2,47
01183000,BERK TRADE AND BUSINESS SCHOOL          ,NY,11101-0000,Proprietary  ,35,59,94,81,171,252
01185900,WORD OF LIFE BIBLE INSTITUTE            ,NY,12860-0129,Private      ,88,28,116,602,94,696
01186000,MERCY MED CNTR SCHL OF RADIOGRAPHY      ,NY,11570-1098,Private      ,1,6,7,20,32,52
01192100,WESTCHESTER SCH OF BEAUTY CULTURE       ,NY,10550-2295,Proprietary  ,10,40,50,20,82,102
01192200,BETH HATALMUD RABBINICAL CLG            ,NY,11214-2594,Private      ,1,0,1,5,4,9
01198400,OHR HAMEIR THEOLOGICAL SEMINARY         ,NY,10566-0990,Private      ,3,0,3,6,0,6
01201100,TALMUDICAL SEM OHOLEI TORAH             ,NY,11213-3310,Private      ,68,1,69,71,1,72
01210700,INSTITUTE OF DESIGN & CONSTRUCTION      ,NY,11201-5380,Private      ,2,9,11,34,63,97
01220300,MEMORIAL HOSPITAL SCH OF NURSING        ,NY,12204-1083,Private      ,9,43,52,52,155,207
01227700,NEW YORK CHIROPRACTIC COLLEGE           ,NY,13148-0800,Private      ,2,72,74,14,712,726
01229300,VEEB NASSAU CNTY SCHL OF PRACT NURS     ,NY,11553-3040,Public       ,20,45,65,60,263,323
01235800,PLAZA COLLEGE                           ,NY,11372-6300,Proprietary  ,131,333,464,255,782,1037
01236400,SAINT VINCENTS CATHOLIC MEDICAL CENTERS ,NY,11354-0000,Proprietary  ,24,79,103,96,463,559
01240700,SCHUYLER-CHEMUNG-TIOGA BOCES            ,NY,14903-1089,Public       ,8,42,50,30,152,182
01240701,STEUBEN SCHUYLER CHEMUNG TIOGA ALLEGANY ,NY,14870-9518,Public       ,1,0,1,1,3,4
01256100,FIVE TOWNS COLLEGE                      ,NY,11746-5871,Proprietary  ,98,59,157,732,204,936
01258900,ERIE 1 BOCES                            ,NY,14224-0000,Public       ,35,139,174,93,374,467
01265200,ONONDAGA CORTLAND MADISON BOCES         ,NY,13090-4500,Public       ,60,164,224,184,440,624
01278300,OSWEGO COUNTY BOCES ADULT CAREERS       ,NY,13114-4498,Public       ,7,31,38,31,84,115
01292700,SYRACUSE CITY SCHOOL DISTRICT           ,NY,13202-3092,Public       ,4,13,17,33,57,90
01302600,MACHZIKEI HADATH RABBINICAL COLLEGE     ,NY,11204-1805,Private      ,0,0,0,2,1,3
01302700,YESHIVATH VIZNITZ                       ,NY,10952-3021,Private      ,0,0,0,1,0,1
01302900,BORICUA COLLEGE                         ,NY,10032-1599,Private      ,148,425,573,357,1028,1385
02056400,CAPRI COSMETOLOGY LEARNING CENTER       ,NY,10954-0000,Proprietary  ,31,76,107,104,175,279
02066200,THE NEW SCHOOL                          ,NY,10011-0000,Private      ,468,753,1221,6608,4679,11287
02069000,NEW YORK SCHOOL OF INTERIOR DESIGN      ,NY,10021-0000,Private      ,22,78,100,181,368,549
02075700,BRIARCLIFFE COLLEGE                     ,NY,11714-0000,Proprietary  ,55,148,203,378,984,1362
02075702,BRIARCLIFFE COLLEGE - PATCHOGUE         ,NY,11772-3019,Proprietary  ,41,104,145,419,634,1053
02092400,RIDLEY-LOWELL SCHOOL OF BUSINESS        ,NY,13905-0000,Proprietary  ,13,49,62,40,138,178
02093700,LONG ISLAND BUSINESS INSTITUTE          ,NY,11725-0000,Proprietary  ,96,457,553,283,1204,1487
02093701,LONG ISLAND BUSINESS INSTITUTE - FLUSHIN,NY,11354-4429,Proprietary  ,2,11,13,12,34,46
02098400,HERKIMER COUNTY BOCES                   ,NY,13350-0000,Public       ,16,51,67,38,116,154
02104300,OTSEGO AREA SCHOOL OF PRAC NURSING      ,NY,12167-0000,Public       ,9,30,39,11,34,45
02105900,HAIR DESIGN INSTITUTE AT FIFTH AVE      ,NY,11220-0000,Proprietary  ,21,89,110,49,167,216
02106800,BRAMSON ORT COLLEGE                     ,NY,11375-0000,Private      ,49,221,270,165,514,679
02110900,CATTARAUGUS/ALLEGANY BOCES              ,NY,14760-0000,Public       ,12,50,62,42,116,158
02112301,RIDLEY - LOWELL BUSINESS & TECHNICAL INS,NY,12601-3328,Proprietary  ,42,153,195,98,378,476
02116011,SANFORD-BROWN INSTITUTE - NEW YORK      ,NY,10003-2103,Proprietary  ,14,52,66,166,580,746
02124000,ORANGE ULSTER BOCES SCH OF PRAC NRS     ,NY,10924-9401,Public       ,8,32,40,41,131,172
02125500,CIRCLE IN THE SQUARE THEATRE SCHOOL     ,NY,10019-0000,Private      ,9,14,23,56,58,114
02126300,MADISON-ONEIDA BOCES PRAC NRS           ,NY,13478-0000,Public       ,2,16,18,13,44,57
02138500,BOCES RENSSELAER SCHOOL OF PN           ,NY,12033-3221,Public       ,0,1,1,5,15,20
02145800,CAYUGA ONONDAGA BOCES                   ,NY,13021-9430,Public       ,13,27,40,39,75,114
02146000,WAYNE-FINGER LAKES BOCES                ,NY,14513-0000,Public       ,16,82,98,54,274,328
02152000,YESHIVA SHAAR HATORAH ITRI TORAH        ,NY,11418-0000,Private      ,0,1,1,2,1,3
02153600,BROOME-TIOGA BOCES PN PROG              ,NY,13905-0000,Public       ,5,22,27,30,118,148
02157900,ROCHESTER GENERAL HOSPITAL              ,NY,14621-3001,Private      ,10,38,48,40,98,138
02158200,WSHNGTN-SARTGA-WARN-HMLTN-ESX BOCES     ,NY,12839-1051,Public       ,2,5,7,12,49,61
02160100,GENEVA GENERAL HOSPITAL                 ,NY,14456-0000,Private      ,4,21,25,41,148,189
02163400,NEW YORK CAREER INSTITUTE               ,NY,10007-2801,Proprietary  ,31,118,149,123,459,582
02169100,DAVIS COLLEGE                           ,NY,13790-0000,Private      ,36,48,84,162,111,273
02170000,SWEDISH INSTITUTE                       ,NY,10001-0000,Proprietary  ,48,232,280,172,917,1089
02170200,ALBANY SCHOHARIE SCHENECTADY            ,NY,12205-0000,Public       ,13,82,95,29,135,164
02171900,AILEY SCHOOL (THE)                      ,NY,10019-4402,Private      ,8,16,24,143,70,213
02172100,HAMILTON-FULTON-MONTGOMERY BOCES        ,NY,12095-0665,Public       ,13,37,50,42,81,123
02172800,DUTCHESS COUNTY BOCES SCH PRAC NURS     ,NY,12601-0000,Public       ,18,60,78,64,160,224
02173200,EMPIRE BEAUTY SCHOOL                    ,NY,10001-0000,Proprietary  ,262,436,698,729,1554,2283
02173900,ULSTER COUNTY BOCES PRACTICAL NRSG      ,NY,12466-0000,Public       ,19,69,88,39,169,208
02176000,CHERYL FELL'S SCHOOL OF BUSINESS        ,NY,14304-0000,Proprietary  ,3,40,43,10,92,102
02179400,EASTERN SUFFOLK BOCES                   ,NY,11713-0000,Public       ,56,140,196,165,349,514
02182200,NEW SCHOOL OF RADIO & TELEVISION        ,NY,12206-1106,Proprietary  ,19,35,54,59,88,147
02191600,TORAH TEMIMAH TALMUDICAL SEMINARY       ,NY,11218-0000,Private      ,6,0,6,9,0,9
02192500,BELLEVUE HOSP CTR SCH RAD TECH          ,NY,10016-0000,Public       ,4,25,29,17,87,104
02199300,ORLEANS-NIAGARA BOCES                   ,NY,14132-0000,Public       ,5,35,40,21,98,119
02206000,HUNTER BUSINESS SCHOOL                  ,NY,11756-0000,Proprietary  ,138,257,395,281,672,953
02219500,MILDRED ELLEY                           ,NY,12206-1513,Proprietary  ,143,912,1055,343,2498,2841
02235600,ERIE 2-CHAUTAUQUA-CATTARAUGUS BOCES     ,NY,14006-0000,Public       ,5,19,24,22,103,125
02265100,YESHIVA DERECH CHAIM                    ,NY,11218-0000,Private      ,17,10,27,23,11,34
02272900,ROCKLAND COUNTY BOCES PRAC NRSG SCH     ,NY,10994-0000,Public       ,11,56,67,23,92,115
02275900,"MODERN WELDING SCHOOL, INC.             ",NY,12304-0000,Proprietary  ,18,29,47,58,86,144
02287800,NATIONAL TRACTOR TRAILER SCHOOL         ,NY,13088-2505,Proprietary  ,22,190,212,35,318,353
02294900,INSTITUTE OF AUDIO RESEARCH             ,NY,10003-0000,Proprietary  ,83,122,205,166,312,478
02306500,PROFESSIONAL BUSINESS COLLEGE           ,NY,10013-5049,Private      ,4,24,28,20,61,81
02314200,EMPIRE BEAUTY SCHOOL                    ,NY,10566-3805,Proprietary  ,10,14,24,30,34,64
02350600,YESHIVA AND KOLLEL HARBOTZAS TORAH      ,NY,11230-0000,Private      ,0,0,0,1,1,2
02491400,SPANISH AMERICAN INSTITUTE              ,NY,10036-0000,Private      ,0,4,4,3,19,22
02505800,YESHIVA KARLIN STOLIN RAB INSTITUTE     ,NY,11204-0000,Private      ,1,0,1,3,3,6
02505900,SH-OR YOSHUV RABBINICAL COLLEGE         ,NY,11691-0000,Private      ,2,4,6,7,6,13
02506000,ASSOCIATED BETH RIVKAH SCHOOLS          ,NY,11225-0000,Private      ,69,5,74,101,7,108
02506100,CITY UNIV OF NEW YORK-CENTRAL           ,NY,10021-0000,Public       ,86,234,320,1691,1236,2927
02506800,YESHIVAT MIKDASH MELECH                 ,NY,11230-0000,Private      ,3,0,3,14,2,16
02511500,JOFFREY BALLET SCHOOL                   ,NY,10011-0000,Proprietary  ,14,0,14,134,12,146
02513500,MAR JON SCHOOL OF BEAUTY CULTURE        ,NY,14150-0000,Proprietary  ,4,14,18,14,38,52
02525600,ART INSTITUTE OF NEW YORK CITY (THE)    ,NY,10013-2429,Proprietary  ,137,195,332,1043,856,1899
02540800,"GLOBE INSTITUTE OF TECHNOLOGY, INC.     ",NY,10007-0000,Proprietary  ,133,94,227,352,275,627
02546000,TRI-STATE COLLEGE OF ACUPUNCTURE        ,NY,10011-0000,Proprietary  ,2,33,35,4,105,109
02546300,YESHIVA OF THE TELSHE ALUMNI            ,NY,10471-0000,Private      ,1,0,1,2,0,2
02550600,TALMUDICAL INST OF UPSTATE NY           ,NY,14607-0000,Private      ,0,1,1,1,3,4
02556700,SEMINAR L'MOROS BAIS YAAKOV             ,NY,11219-0000,Private      ,105,0,105,242,0,242
02572900,BUSINESS INFORMATICS CENTER             ,NY,11580-0000,Proprietary  ,3,3,6,7,14,21
02575400,FRENCH CULINARY INSTITUTE               ,NY,10013-2618,Proprietary  ,65,217,282,238,607,845
02587600,ORLO SCH HAIR DESIGN & COSMETOLOGY      ,NY,12206-1723,Proprietary  ,17,14,31,26,42,68
02599400,NEW YORK COLLEGE OF HEALTH PROFESSIONS  ,NY,11791-4413,Private      ,31,178,209,112,653,765
02600100,NEW YORK ACADEMY OF ART (THE)           ,NY,10013-2911,Private      ,29,41,70,159,252,411
02614900,SANFORD-BROWN INSTITUTE                 ,NY,10604-2910,Proprietary  ,0,0,0,7,20,27
02615001,SANFORD-BROWN COLLEGE - SANFORD-BROWN IN,NY,11530-4734,Proprietary  ,19,40,59,129,265,394
02616600,SHEAR EGO INTERNATIONAL SCHOOL OF HAIR D,NY,14617-3501,Proprietary  ,21,43,64,72,115,187
02617000,CONTINENTAL SCH OF BEAUTY CULTURE       ,NY,14020-0000,Proprietary  ,8,26,34,14,43,57
02617002,CONTINENTAL SCHOOL OF BEAUTY CULTURE  - ,NY,14020-1908,Proprietary  ,5,23,28,14,37,51
02622900,BAIS MEDRASH ELYON                      ,NY,10952-3013,Private      ,7,3,10,7,4,11
03000100,YESHIVA GEDOLAH IMREI YOSEF DSPINKA     ,NY,11219-4696,Private      ,0,0,0,1,0,1
03007200,DANCE THEATRE OF HARLEM                 ,NY,10031-0000,Private      ,6,14,20,36,43,79
03027701,PACIFIC COLLEGE OF ORIENTAL MEDICINE - N,NY,10010-7108,Proprietary  ,8,115,123,16,430,446
03081600,DELAWARE CHENANGO MADISON OT. BOCES     ,NY,13815-9554,Public       ,2,22,24,10,43,53
03095500,ASA INST BUSINESS & COMPUTER TECH       ,NY,11201-5208,Proprietary  ,575,931,1506,1640,2987,4627
03096200,CHARLES STUART SCHOOL                   ,NY,11229-2004,Proprietary  ,2,12,14,7,24,31
03103700,ADIRONDACK BEAUTY SCHOOL                ,NY,12801-3158,Proprietary  ,5,5,10,21,32,53
03104900,SULLIVAN COUNTY BOCES                   ,NY,12754-2116,Public       ,2,8,10,8,18,26
03115300,GENESEE VALLEY BOCES                    ,NY,14020-1099,Public       ,14,74,88,22,143,165
03120700,NEW YORK CONSERVATORY FOR DRAMATIC ARTS ,NY,10011-4225,Proprietary  ,62,33,95,441,161,602
03127100,YESHIVAS NOVOMINSK                      ,NY,11219-0000,Private      ,33,0,33,36,0,36
03129200,RABBINICAL CLG OHR SHIMAR YISROEL       ,NY,11211-8102,Private      ,0,1,1,1,2,3
03169300,STUDIO JEWELERS                         ,NY,10016-4112,Proprietary  ,1,7,8,3,24,27
03181400,MERKAZ BNOS                             ,NY,11214-4911,Private      ,3,21,24,6,117,123
03191300,CUNY SCHOOL OF LAW @ QUEENS COLLEGE     ,NY,11367-0000,Public       ,51,150,201,595,1243,1838
03193300,MANHATTAN SCHOOL OF COMPUTER TECH       ,NY,11230-1617,Private      ,47,194,241,171,546,717
03203300,NEW YORK INSTITUTE OF MASSAGE           ,NY,14221-6021,Proprietary  ,13,48,61,26,108,134
03216300,UNIFICATION THEOLOGICAL SEMINARY        ,NY,12507-5021,Private      ,0,18,18,5,32,37
03328300,FRANKLIN CAREER INSTITUTE               ,NY,11550-3003,Private      ,12,19,31,29,57,86
03328301,FRANKLIN CAREER INSTITUTE - BROOKLYN    ,NY,11220-3110,Private      ,34,102,136,97,337,434
03358300,ALLEN SCHOOL                            ,NY,11432-4901,Proprietary  ,60,337,397,161,1009,1170
03358301,ALLEN SCHOOL - BROOKLYN                 ,NY,11201-0000,Proprietary  ,45,176,221,131,496,627
03380300,STAR CAREER ACADEMY                     ,NY,11791-5311,Proprietary  ,12,37,49,45,139,184
03419400,NORTHEASTERN SEMINARY                   ,NY,14624-1997,Private      ,0,42,42,19,105,124
03433500,LIA SCHORR INSTITUTE OF COSMETIC SK     ,NY,10022-2614,Proprietary  ,0,12,12,6,24,30
03443300,NEW YORK COLLEGE OF TRADITIONAL CHINESE ,NY,11501-0000,Private      ,1,65,66,3,105,108
03496300,YESHIVA SHAAREI TORAH OF ROCKLAND       ,NY,10901-4003,Private      ,1,6,7,1,7,8
03537300,NEW YORK AUTOMOTIVE & DIESEL INSTIT     ,NY,11101-0000,Proprietary  ,61,106,167,114,254,368
03651300,SAINT JOSEPH'S MEDICAL CENTER SCHOO     ,NY,10701-4080,Private      ,0,0,0,1,7,8
03652300,METROPOLITAN LEARNING INSTITUTE         ,NY,11374-2101,Private      ,21,221,242,57,749,806
03665400,CHRISTIE'S EDUCATION                    ,NY,10036-8002,Proprietary  ,1,8,9,1,39,40
03713300,BEIS MEDRASH HEICHAL DOVID              ,NY,11691-4433,Private      ,22,0,22,25,1,26
03773300,CENTER FOR NATURAL WELLNESS SCHOOL OF MA,NY,12205-1601,Proprietary  ,14,44,58,39,133,172
03802300,UTA MESIVTA OF KIRYAS JOEL              ,NY,10950-2169,Private      ,211,0,211,212,1,213
03839300,AVEDA INSTITUTE NEW YORK                ,NY,10013-1522,Proprietary  ,33,103,136,103,285,388
03881300,UNION GRADUATE COLLEGE                  ,NY,12308-3131,Private      ,1,43,44,12,173,185
03903400,AMERICAN BEAUTY SCHOOL                  ,NY,10462-8003,Proprietary  ,43,88,131,108,282,390
03941400,ELITE ACADEMY OF BEAUTY ARTS            ,NY,11223-1630,Proprietary  ,0,0,0,1,2,3
03983300,"SCHOOL OF PROFESSIONAL HORTICULTURE, AT ",NY,10458-5126,Private      ,1,5,6,8,25,33
03988300,"SAE INSTITUTE OF TECHNOLOGY, NEW YORK   ",NY,10001-2915,Proprietary  ,82,154,236,303,390,693
04043300,ACE COMPUTER TRAINING CENTER            ,NY,11375-5337,Proprietary  ,17,65,82,38,130,168
04092401,MAKE-UP DESIGNORY -                     ,NY,10012-0041,Proprietary  ,64,81,145,236,275,511
04095300,KING'S COLLEGE (THE)                    ,NY,10018-0110,Private      ,24,24,48,912,136,1048
04102300,NEW AGE TRAINING                        ,NY,10001-4006,Proprietary  ,24,99,123,45,232,277
04115500,TALMUDICAL SEMINARY OF BOBOV            ,NY,11219-3826,Private      ,17,3,20,17,4,21
04117100,EDP SCHOOL OF COMPUTER PROGRAMMING      ,NY,11235-0000,Private      ,4,65,69,21,159,180
04117700,"MONROE 2-ORLEANS BOCES, CENTER FOR WORK ",NY,14624-1119,Public       ,31,85,116,90,186,276
04119600,YESHIVA OF FAR ROCKAWAY DERECH AYSON RAB,NY,11691-5219,Private      ,3,0,3,8,0,8
04125600,CAREER SCHOOL OF NY                     ,NY,10301-2416,Private      ,20,45,65,46,118,164
04131500,COLLECTIVE (THE)                        ,NY,10011-2026,Proprietary  ,5,4,9,16,17,33
04133700,NEW YORK MEDICAL CAREER TRAINING CENTER ,NY,11354-6504,Proprietary  ,14,89,103,31,182,213
04133701,NEW YORK MEDICAL CAREER TRAINING CENTER ,NY,10018-6504,Proprietary  ,16,113,129,63,256,319
04134000,"JOHN PAOLO'S XTREME BEAUTY INSTITUTE, GO",NY,12020-1245,Proprietary  ,3,19,22,10,42,52
04134001,"JOHN PAOLO'S XTREME BEAUTY INSTITUTE, GO",NY,13417-1319,Proprietary  ,6,25,31,20,67,87
04137700,ANN MARIE'S WORLD OF BEAUTY SCHOOL      ,NY,13901-2308,Proprietary  ,0,0,0,2,2,4
04138100,YESHIVA OF MACHZIKAI HADAS              ,NY,11219-1408,Private      ,49,25,74,50,25,75
04144300,INSTITUTE OF CULINARY EDUCATION         ,NY,10010-5205,Proprietary  ,75,224,299,370,737,1107
04148000,NEW LIFE BUSINESS INSTITUTE             ,NY,11432-6149,Proprietary  ,11,101,112,20,179,199
04151200,SALON PROFESSIONAL ACADEMY (THE)        ,NY,14150-9200,Proprietary  ,23,46,69,72,117,189
04155300,ONONDAGA SCHOOL OF THERAPEUTIC MASSAGE  ,NY,13210-1533,Proprietary  ,17,62,79,70,200,270
04156000,ACADEMY OF COSMETOLOGY & ESTHETICS NYC (,NY,10306-3003,Proprietary  ,25,34,59,96,122,218
04157500,ACCESS CAREERS                          ,NY,11201-5826,Proprietary  ,1,14,15,33,89,122
04165700,"JOHN PAOLO'S XTREME BEAUTY INSTITUTE, GO",NY,12110-3053,Proprietary  ,1,6,7,5,19,24
04166000,MANHATTAN INSTITUTE (THE)               ,NY,10016-6516,Proprietary  ,48,121,169,128,235,363
04167600,FINGER LAKES SCHOOL OF MASSAGE (THE)    ,NY,14850-1384,Proprietary  ,15,45,60,47,112,159
04167601,FINGER LAKES SCHOOL OF MASSAGE (THE) -  ,NY,10549-1103,Proprietary  ,2,33,35,16,88,104
04178700,ATELIER ESTHETIQUE INSTITUTE OF ESTHETIC,NY,10016-8804,Proprietary  ,8,71,79,20,153,173
04179800,SOTHEBY'S INSTITUTE OF ART - NY         ,NY,10022-6717,Proprietary  ,4,29,33,19,128,147
04180200,LONG ISLAND NAIL & SKIN CARE INSTITUTE  ,NY,11756-1316,Proprietary  ,7,35,42,13,74,87
04189000,LONG ISLAND BARBER INSTITUTE (THE)      ,NY,11550-6317,Proprietary  ,7,32,39,17,56,73
04190500,NEW YORK SCHOOL OF ESTHETICS & DAY SPA  ,NY,10591-3232,Proprietary  ,6,24,30,18,58,76
04192800,BE'ER YAAKOV TALMUDIC SEMINARY          ,NY,10977-1912,Private      ,0,45,45,0,46,46
04204300,AESTHETIC SCIENCE INSTITUTE (THE)       ,NY,12110-1095,Proprietary  ,9,18,27,24,55,79
04206200,DIGITAL FILM ACADEMY                    ,NY,10036-3708,Proprietary  ,22,63,85,116,186,302
04207400,YESHIVA GEDOLA OHR YISRAEL              ,NY,11229-1817,Private      ,1,0,1,3,0,3
04207600,AMERICAN ACADEMY OF PERSONAL TRAINING   ,NY,10011-7301,Proprietary  ,8,43,51,40,136,176
04208600,RELAY SCHOOL OF EDUCATION               ,NY,10011-4233,Private      ,0,160,160,3,321,324
04208800,GLORIA FRANCIS SCHOOL OF MAKE-UP ARTISTR,NY,11801-3873,Proprietary  ,8,17,25,16,31,47
04210100,STELLA AND CHARLES GUTTMAN COMMUNITY COL,NY,10018-2602,Public       ,114,29,143,3130,413,3543
04210400,BETH MEDRASH MEOR YITZCHOK              ,NY,10952-4023,Private      ,1,0,1,10,1,11
04210700,NEW YORK INSTITUTE OF BEAUTY            ,NY,11749-1479,Proprietary  ,25,42,67,48,100,148
04212500,CACTUS ACADEMY (THE)                    ,NY,11530-3402,Proprietary  ,28,49,77,62,89,151
04213400,ACCESS CAREERS                          ,NY,11550-0000,Proprietary  ,4,39,43,15,72,87
04213500,SHARP EDGEZ BARBER INSTITUTE            ,NY,14620-0000,Proprietary  ,5,27,32,13,53,66
04215900,YESHIVA GEDOLAH KESSER TORAH            ,NY,10952-2127,Private      ,18,0,18,28,0,28
04223100,ARROJO COSMETOLOGY SCHOOL               ,NY,10014-4960,Proprietary  ,22,63,85,85,182,267
04223200,GRACE INTERNATIONAL BEAUTY SCHOOL       ,NY,11355-2446,Proprietary  ,6,29,35,12,89,101
04223300,ALLIANCE COMPUTING SOLUTIONS            ,NY,11354-6507,Proprietary  ,3,18,21,8,34,42
04223800,ELECTRICAL TRAINING CENTER (THE)        ,NY,11726-2701,Proprietary  ,22,32,54,52,80,132
04225500,WESTCHESTER SCHOOL FOR DENTAL ASSISTANTS,NY,10606-1246,Proprietary  ,16,42,58,31,110,141
04227200,BET MEDRASH GADOL ATERET TORAH          ,NY,11223-1933,Private      ,2,0,2,9,4,13
04228300,PAUL MITCHELL THE SCHOOL                ,NY,12305-2303,Proprietary  ,21,42,63,81,89,170
04231500,YESHIVA SHOLOM SHACHNA                  ,NY,11230-2621,Private      ,1,0,1,2,0,2
04233700,CHRISTINE VALMY INTERNATIONAL SCHOOL FOR,NY,10016-7701,Proprietary  ,19,123,142,38,250,288
04234200,CENTER FOR ULTRASOUND RESEARCH & EDUCATI,NY,10801-5104,Proprietary  ,0,10,10,10,29,39
04234300,CULINARY TECH CENTER                    ,NY,10001-2320,Proprietary  ,23,78,101,76,244,320
04234900,AMG SCHOOL OF LICENSE PRACTICAL NURSING ,NY,11201-1728,Proprietary  ,15,101,116,17,118,135
04237500,DERMALOGICA ACADEMY                     ,NY,10011-2420,Proprietary  ,4,28,32,15,84,99
00267808,BRYANT & STRATTON COLLEGE - PARMA       ,OH,44130-0000,Proprietary  ,98,525,623,385,2169,2554
00301000,ANTIOCH UNIVERSITY                      ,OH,45387-1608,Private      ,10,126,136,167,693,860
00301100,ART ACADEMY OF CINCINNATI               ,OH,45202-7106,Private      ,22,35,57,399,196,595
00301200,ASHLAND UNIVERSITY                      ,OH,44805-3799,Private      ,209,599,808,3632,2455,6087
00301300,ATHENAEUM OF OHIO                       ,OH,45230-2000,Private      ,1,5,6,2,16,18
00301400,BALDWIN-WALLACE COLLEGE                 ,OH,44017-2088,Private      ,383,293,676,4677,1463,6140
00301600,BLUFFTON UNIVERSITY                     ,OH,45817-2104,Private      ,62,48,110,1269,319,1588
00301800,BOWLING GREEN STATE UNIVERSITY          ,OH,43403-0001,Public       ,1375,999,2374,18805,5319,24124
00302300,CAPITAL UNIVERSITY                      ,OH,43209-2394,Private      ,210,380,590,4022,2258,6280
00302400,CASE WESTERN RESERVE UNIV               ,OH,44106-0000,Private      ,133,363,496,10789,2087,12876
00302401,CASE WESTERN RESERVE UNIV - MED         ,OH,44106-0000,Private      ,10,50,60,84,1164,1248
00302402,CASE WESTERN RESERVE UNIV - DENTAL      ,OH,44106-0000,Private      ,4,22,26,41,318,359
00302403,CASE WESTERN RESERVE UNIV - LAW         ,OH,44106-0000,Private      ,3,45,48,28,763,791
00302404,CASE WESTERN RESERVE UNIV - UG          ,OH,44106-0000,Private      ,3,10,13,172,43,215
00302405,CASE WESTERN RESERVE UNIV - MSASS       ,OH,44106-0000,Private      ,1,100,101,14,671,685
00302406,CASE WESTERN RESERVE UNIV - NURS UG     ,OH,44106-0000,Private      ,9,36,45,201,167,368
00302407,CASE WESTERN RESERVE UNIV - WSOM        ,OH,44106-0000,Private      ,3,43,46,15,199,214
00302408,CASE WESTERN RESERVE UNIV -A&S GRAD     ,OH,44106-0000,Private      ,0,36,36,4,265,269
00302409,CASE WESTERN RESERVE UNIV -ENG GRAD     ,OH,44106-0000,Private      ,0,16,16,27,73,100
00302410,CASE WESTERN RESERVE UNIV -NURS GRD     ,OH,44106-0000,Private      ,3,40,43,19,357,376
00302500,CEDARVILLE UNIVERSITY                   ,OH,45314-8564,Private      ,272,112,384,3949,516,4465
00302600,CENTRAL STATE UNIVERSITY                ,OH,45384-1004,Public       ,301,275,576,2894,1232,4126
00302900,CINCINNATI CHRISTIAN UNIVERSITY         ,OH,45204-3200,Private      ,94,142,236,603,548,1151
00303000,OHIO CHRISTIAN UNIVERSITY               ,OH,43113-9487,Private      ,173,1480,1653,925,4181,5106
00303100,CLEVELAND INSTITUTE OF MUSIC            ,OH,44106-1776,Private      ,18,27,45,424,355,779
00303200,CLEVELAND STATE UNIVERSITY              ,OH,44115-2214,Public       ,1505,2767,4272,12209,11773,23982
00303300,MOUNT ST. JOSEPH UNIVERSITY             ,OH,45233-1670,Private      ,97,209,306,1895,1276,3171
00303500,OHIO DOMINICAN UNIVERSITY               ,OH,43219-2099,Private      ,128,356,484,1856,1822,3678
00303600,FRANCISCAN UNIV OF STEUBENVILLE         ,OH,43952-1763,Private      ,217,134,351,2328,642,2970
00303700,COLLEGE OF WOOSTER                      ,OH,44691-2363,Private      ,54,14,68,3394,116,3510
00303900,COLUMBUS COLLEGE OF ART AND DESIGN      ,OH,43215-1758,Private      ,175,133,308,1492,577,2069
00304000,CUYAHOGA COMMUNITY COLLEGE              ,OH,44115-2878,Public       ,2811,5913,8724,10274,19370,29644
00304100,"DEFIANCE COLLEGE, THE                   ",OH,43512-1695,Private      ,79,49,128,1124,254,1378
00304200,DENISON UNIVERSITY                      ,OH,43023-1329,Private      ,97,15,112,3403,130,3533
00304400,TRINITY LUTHERAN SEMINARY               ,OH,43209-0000,Private      ,2,11,13,3,105,108
00304500,UNIVERSITY OF FINDLAY                   ,OH,45840-3695,Private      ,226,343,569,3463,1442,4905
00304600,FRANKLIN UNIVERSITY                     ,OH,43215-5399,Private      ,157,1467,1624,923,7689,8612
00304800,HEIDELBERG UNIVERSITY                   ,OH,44883-2462,Private      ,85,62,147,1680,278,1958
00304900,HIRAM COLLEGE                           ,OH,44234-1808,Private      ,65,73,138,1390,317,1707
00305000,JOHN CARROLL UNIVERSITY                 ,OH,44118-4581,Private      ,254,147,401,4568,728,5296
00305100,KENT STATE UNIVERSITY                   ,OH,44242-0001,Public       ,1762,1738,3500,25695,11266,36961
00305101,KENT STATE UNIVERSITY - GEAUGA CAMPUS   ,OH,44021-9500,Public       ,151,175,326,860,882,1742
00305102,KENT STATE UNIVERSITY - STARK CAMPUS    ,OH,44720-7599,Public       ,492,660,1152,3031,2978,6009
00305103,KENT STATE UNIVERSITY - TUSCARAWAS CAMPU,OH,44663-9403,Public       ,130,198,328,919,922,1841
00305104,KENT STATE UNIVERSITY - TRUMBULL CAMPUS ,OH,44483-1998,Public       ,164,347,511,1135,1653,2788
00305105,KENT STATE UNIVERSITY - ASHTABULA CAMPUS,OH,44004-2299,Public       ,119,251,370,818,1396,2214
00305106,KENT STATE UNIVERSITY - EAST LIVERPOOL C,OH,43920-3497,Public       ,66,133,199,416,669,1085
00305107,KENT STATE UNIVERSITY - SALEM CAMPUS    ,OH,44460-9412,Public       ,125,186,311,900,972,1872
00306500,KENYON COLLEGE                          ,OH,43022-9623,Private      ,46,6,52,3868,89,3957
00306600,LAKE ERIE COLLEGE                       ,OH,44077-3389,Private      ,112,75,187,1199,360,1559
00306800,LORAIN COUNTY COMMUNITY COLLEGE         ,OH,44035-1691,Public       ,1169,1889,3058,3754,6098,9852
00306900,LOURDES COLLEGE                         ,OH,43560-2898,Private      ,143,204,347,1018,1001,2019
00307200,MALONE UNIVERSITY                       ,OH,44709-3897,Private      ,79,201,280,1645,1007,2652
00307300,MARIETTA COLLEGE                        ,OH,45750-4033,Private      ,90,32,122,2021,300,2321
00307500,METHODIST THEOLOGICAL SCH IN OHIO       ,OH,43015-0000,Private      ,0,25,25,1,132,133
00307700,MIAMI UNIVERSITY                        ,OH,45056-1831,Public       ,1111,837,1948,22450,4365,26815
00307800,WRIGHT STATE UNIVERSITY                 ,OH,45435-0002,Public       ,1070,1455,2525,12457,8907,21364
00308300,UNIVERSITY OF MOUNT UNION               ,OH,44601-3993,Private      ,189,52,241,3088,311,3399
00308400,MUSKINGUM UNIVERSITY                    ,OH,43762-1199,Private      ,165,123,288,2049,561,2610
00308500,NOTRE DAME COLLEGE OF OHIO              ,OH,44121-4293,Private      ,191,284,475,2200,1308,3508
00308600,OBERLIN COLLEGE                         ,OH,44074-1090,Private      ,75,30,105,5026,202,5228
00308900,OHIO NORTHERN UNIVERSITY                ,OH,45810-1555,Private      ,159,114,273,3428,817,4245
00309000,OHIO STATE UNIVERSITY-ALL CAMPUSES      ,OH,43210-1358,Public       ,2435,2616,5051,55374,21888,77262
00310000,OHIO UNIVERSITY                         ,OH,45701-2979,Public       ,1321,2088,3409,23891,11366,35257
00310002,"OHIO UNIVERSITY, ZANESVILLE CAMPUS      ",OH,43701-0000,Public       ,129,220,349,1159,1144,2303
00310003,"OHIO UNIVERSITY, LANCASTER CAMPUS       ",OH,43130-0000,Public       ,204,280,484,1484,1486,2970
00310004,"OHIO UNIVERSITY, SOUTHERN CAMPUS        ",OH,45638-0000,Public       ,115,347,462,801,1480,2281
00310005,"OHIO UNIVERSITY, CHILLICOTHE CAMPUS     ",OH,45601-0000,Public       ,192,343,535,1132,1552,2684
00310006,"OHIO UNIVERSITY, EASTERN CAMPUS         ",OH,43950-0000,Public       ,67,87,154,434,342,776
00310008,OHIO UNIV COLL OF OSTEOPATHIC MED       ,OH,45701-0000,Public       ,0,39,39,20,768,788
00310900,OHIO WESLEYAN UNIVERSITY                ,OH,43015-2398,Private      ,98,28,126,2914,193,3107
00311000,OTTERBEIN UNIVERSITY                    ,OH,43081-2006,Private      ,153,111,264,3568,849,4417
00311300,PONTIFICAL COLLEGE JOSEPHINUM           ,OH,43235-1498,Private      ,5,11,16,39,21,60
00311400,FIRELANDS REGIONAL MEDICAL CENTER - SOUT,OH,44870-4788,Private      ,9,20,29,66,126,192
00311500,RABBINICAL COLLEGE OF TELSHE            ,OH,44092-2584,Private      ,4,18,22,10,20,30
00311600,UNIV OF RIO GRANDE                      ,OH,45674-3131,Private      ,262,458,720,1451,1477,2928
00311900,SINCLAIR COMMUNITY COLLEGE              ,OH,45402-1460,Public       ,1904,3797,5701,7660,12270,19930
00312100,TIFFIN UNIVERSITY                       ,OH,44883-2161,Private      ,200,424,624,2381,2489,4870
00312200,UNITED THEOLOGICAL SEMINARY             ,OH,45406-0000,Private      ,0,109,109,0,499,499
00312300,UNIVERSITY OF AKRON                     ,OH,44325-6211,Public       ,1361,1662,3023,20353,10430,30783
00312500,UNIVERSITY OF CINCINNATI                ,OH,45221-0125,Public       ,2962,4016,6978,28444,19051,47495
00312504,UNIVERSITY OF CINCINNATI - MEDICINE     ,OH,45267-0553,Public       ,36,143,179,291,1480,1771
00312700,UNIVERSITY OF DAYTON                    ,OH,45469-1668,Private      ,291,424,715,13047,2679,15726
00313100,UNIVERSITY OF TOLEDO                    ,OH,43606-3390,Public       ,1463,1446,2909,16144,8600,24744
00313300,URBANA UNIVERSITY                       ,OH,43078-2091,Private      ,123,126,249,697,575,1272
00313400,URSULINE COLLEGE                        ,OH,44124-4398,Private      ,51,254,305,685,1025,1710
00313500,WALSH UNIVERSITY                        ,OH,44720-3396,Private      ,81,187,268,2308,1150,3458
00314100,WILBERFORCE UNIVERSITY                  ,OH,45384-1001,Private      ,93,130,223,558,451,1009
00314200,WILMINGTON COLLEGE                      ,OH,45177-2499,Private      ,85,64,149,1967,378,2345
00314300,WITTENBERG UNIVERSITY                   ,OH,45501-2199,Private      ,108,72,180,3737,360,4097
00314400,XAVIER UNIVERSITY                       ,OH,45207-1035,Private      ,345,469,814,7404,2399,9803
00314500,YOUNGSTOWN STATE UNIVERSITY             ,OH,44555-0001,Public       ,1043,1062,2105,8988,5405,14393
00398200,CLEVELAND INSTITUTE OF ART              ,OH,44106-1700,Private      ,42,45,87,988,230,1218
00406000,WINEBRENNER THEOLOGICAL SEMINARY        ,OH,45840-0000,Private      ,0,24,24,1,58,59
00485200,CLARK STATE COMMUNITY COLLEGE           ,OH,45505-4795,Public       ,459,1535,1994,1798,4794,6592
00485300,BRADFORD SCHOOL                         ,OH,43219-0000,Proprietary  ,63,95,158,568,528,1096
00485500,DAVIS COLLEGE                           ,OH,43623-4307,Proprietary  ,24,138,162,84,434,518
00486100,UNIVERSITY OF NORTHWESTERN OHIO         ,OH,45805-1498,Private      ,390,313,703,4384,1530,5914
00486600,STAUTZENBERGER COLLEGE                  ,OH,43537-4007,Proprietary  ,122,314,436,413,1051,1464
00510200,SCH OF DIAGNOSTIC IMAGING-CLEVELAND     ,OH,44119-0000,Private      ,2,12,14,10,39,49
00531300,NORTH CENTRAL STATE COLLEGE             ,OH,44901-0000,Public       ,229,366,595,1089,1723,2812
00575300,OWENS STATE COMMUNITY COLLEGE           ,OH,43699-0000,Public       ,1179,1930,3109,4283,6358,10641
00648700,AULTMAN COLLEGE OF NURSING AND HEALTH SC,OH,44710-1799,Private      ,16,81,97,175,442,617
00648900,CHRIST COLLEGE OF NURSING AND HEALTH SCI,OH,45219-2906,Private      ,48,173,221,423,815,1238
00649400,GOOD SAMARITAN COLG-NURSING/HEALTH      ,OH,45220-2489,Private      ,32,107,139,292,530,822
00650700,TRINIT HEALTH SYSTEM SCH OF NURSING     ,OH,43952-2667,Private      ,7,20,27,65,130,195
00680400,LAKELAND COMMUNITY COLLEGE              ,OH,44094-5198,Public       ,635,1217,1852,2543,4584,7127
00686700,COLUMBUS STATE COMMUNITY COLLEGE        ,OH,43215-1786,Public       ,2387,4361,6748,12149,17856,30005
00703500,KETTERING COLLEGE OF MEDICAL ARTS       ,OH,45429-1299,Private      ,46,134,180,484,682,1166
00708500,MOUNT VERNON NAZARENE UNIVERSITY        ,OH,43050-9500,Private      ,84,217,301,1492,869,2361
00708501,MOUNT VERNON NAZARENE UNIV - AGS        ,OH,43050-0000,Private      ,10,61,71,66,275,341
00727500,EASTERN GATEWAY COMMUNITY COLLEGE       ,OH,43952-3598,Public       ,367,700,1067,1200,2208,3408
00732920,ITT TECHNICAL INSTITUTE                 ,OH,45414-3456,Proprietary  ,66,325,391,265,1199,1464
00732992,ITT TECHNICAL INSTITUTE                 ,OH,44509-4098,Proprietary  ,31,249,280,271,1083,1354
00747300,CHOFFIN CAREER & TECHNICAL CENTER       ,OH,44503-1628,Public       ,15,77,92,27,106,133
00759800,HOCKING TECHNICAL COLLEGE               ,OH,45764-9582,Public       ,477,468,945,2617,1955,4572
00812900,ADULT AND COMMUNITY EDUCATION @ HUDSON  ,OH,43211-2017,Public       ,9,108,117,42,376,418
00813200,TOLEDO SCHOOL OF PRACTICAL NURSING      ,OH,43613-5110,Public       ,17,102,119,94,382,476
00813300,ZANE STATE COLLEGE                      ,OH,43701-2626,Public       ,172,334,506,1006,1217,2223
00819400,AKRON SCHOOL OF PRACTICAL NRSG          ,OH,44311-0000,Public       ,22,65,87,151,226,377
00827800,TERRA COMMUNITY COLLEGE                 ,OH,43420-9670,Public       ,206,477,683,706,1315,2021
00867700,NORTHWEST STATE COMMUNITY COLLEGE       ,OH,43502-9542,Public       ,173,350,523,946,1366,2312
00888600,PORTAGE LAKES CAREER CENTER             ,OH,44685-9554,Public       ,18,38,56,43,110,153
00915600,WAYNE COUNTY SCHOOLS CAREER CENTER      ,OH,44677-9672,Public       ,15,56,71,48,185,233
00941200,FORTIS COLLEGE                          ,OH,44221-2998,Proprietary  ,50,279,329,161,991,1152
00953000,GERBER AKRON BEAUTY SCHOOL              ,OH,44313-6995,Proprietary  ,7,29,36,24,111,135
00953100,SPA SCHOOL (THE)                        ,OH,43214-1524,Proprietary  ,11,69,80,52,223,275
00966000,TIFFIN ACADEMY OF HAIR DESIGN           ,OH,44883-2833,Proprietary  ,5,12,17,31,35,66
00982805,EVEREST INSTITUTE - COLUMBUS            ,OH,43230-6653,Private      ,23,101,124,80,364,444
00994100,BELMONT TECHNICAL COLLEGE               ,OH,43950-9766,Public       ,144,233,377,570,798,1368
00994200,SHAWNEE STATE UNIVERSITY                ,OH,45662-4344,Public       ,414,359,773,3899,1866,5765
01001700,PAYNE THEOLOGICAL SEMINARY              ,OH,45384-0474,Private      ,0,82,82,1,177,178
01002700,JAMES A. RHODES STATE COLLEGE           ,OH,45804-3597,Public       ,268,498,766,1396,1758,3154
01016800,NATIONWIDE BEAUTY ACADEMY               ,OH,43228-1000,Proprietary  ,13,55,68,88,202,290
01028000,OHIO STATE BEAUTY ACADEMY               ,OH,45801-0000,Proprietary  ,28,41,69,101,123,224
01032300,HANNAH E MULLINS SCH-PRAC NRSG          ,OH,44460-2906,Public       ,1,13,14,15,57,72
01034500,CINCINNATI STATE TECH & COMM CLG        ,OH,45223-2690,Public       ,908,2530,3438,4102,8692,12794
01045300,WASHINGTON STATE CMTY COLLEGE           ,OH,45750-9225,Public       ,99,245,344,701,870,1571
01063000,NORTHERN INSTITUTE OF COSMETOLOGY       ,OH,44052-1803,Proprietary  ,8,24,32,19,63,82
01073600,MARION TECHNICAL COLLEGE                ,OH,43302-5694,Public       ,99,355,454,715,1434,2149
01088000,CHATFIELD COLLEGE                       ,OH,45118-9705,Private      ,15,91,106,103,322,425
01088100,STARK STATE COLLEGE                     ,OH,44720-7299,Public       ,924,2296,3220,3490,8114,11604
01090600,CINCINNATI CLG OF MORTUARY SCIENCE      ,OH,45224-1428,Private      ,9,41,50,82,166,248
01092300,UNION INSTITUTE & UNIVERSITY            ,OH,45206-1925,Private      ,7,513,520,39,1505,1544
01099300,HOBART INSTITUTE OF WELDING TECHNOLOGY  ,OH,45373-2400,Private      ,40,62,102,411,243,654
01104600,CENTRAL OHIO TECHNICAL COLLEGE          ,OH,43055-1767,Public       ,261,663,924,1477,3360,4837
01170300,PENTA COUNTY JOINT VOCATIONAL SCH       ,OH,43551-0000,Public       ,12,40,52,28,107,135
01174400,NATIONAL BEAUTY COLLEGE                 ,OH,44720-0000,Proprietary  ,10,35,45,33,100,133
01174500,OHIO TECHNICAL COLLEGE                  ,OH,44103-1228,Proprietary  ,155,224,379,1281,895,2176
01216600,CAROUSEL BEAUTY COLLEGE                 ,OH,45402-8935,Proprietary  ,21,50,71,85,174,259
01216603,CAROUSEL BEAUTY COLLEGE - OF MIAMI VALLE,OH,45424-2063,Proprietary  ,1,3,4,5,16,21
01224800,CENTRAL SCHOOL OF PRACTICAL NURSING     ,OH,44131-2155,Private      ,14,92,106,36,219,255
01267200,CAROUSEL BEAUTY COLLEGE                 ,OH,45044-5113,Proprietary  ,1,12,13,6,29,35
01275000,EDISON COMMUNITY COLLEGE                ,OH,45356-9239,Public       ,153,444,597,832,1717,2549
01283800,LAURA AND ALVIN SIEGAL COLLEGE OF JUDAIC,OH,44122-7197,Private      ,0,0,0,2,4,6
01284800,MOLER-HOLLYWOOD BEAUTY COLLEGE          ,OH,45202-2577,Proprietary  ,3,38,41,14,82,96
01287000,SOUTHERN STATE COMMUNITY COLLEGE        ,OH,45133-9406,Public       ,269,571,840,946,1624,2570
01289100,ANTONELLI COLLEGE                       ,OH,45202-2592,Proprietary  ,21,126,147,93,428,521
01289600,VIRGINIA MARTI COLLEGE OF ART AND DESIGN,OH,44107-0778,Proprietary  ,15,42,57,87,159,246
01303922,SOUTH UNIVERSITY - CLEVELAND            ,OH,44128-5919,Proprietary  ,37,187,224,81,630,711
01313200,INTERNATIONAL CLG OF BROADCASTING       ,OH,45431-1898,Proprietary  ,19,44,63,54,146,200
02052000,KAPLAN COLLEGE                          ,OH,45439-1984,Proprietary  ,46,350,396,162,1140,1302
02054300,TRUMBULL BUSINESS COLLEGE               ,OH,44484-0000,Proprietary  ,6,53,59,28,253,281
02056800,DAYMAR COLLEGE                          ,OH,45601-1038,Proprietary  ,3,11,14,10,58,68
02056802,DAYMAR COLLEGE - LANCASTER              ,OH,43130-0000,Proprietary  ,5,40,45,20,136,156
02056803,DAYMAR COLLEGE - NEW BOSTON             ,OH,45662-4900,Proprietary  ,2,13,15,6,59,65
02056804,DAYMAR COLLEGE - JACKSON                ,OH,45640-1728,Proprietary  ,3,3,6,6,28,34
02066100,OHIO STATE COLLEGE/BARBER STYLING       ,OH,43213-0000,Proprietary  ,22,103,125,119,308,427
02073300,GALLIA-JACKSON-VINTON SCH ADULT ED      ,OH,45674-0000,Public       ,26,56,82,80,206,286
02110700,CLEVELAND INST OF DENTAL-MED ASST       ,OH,44115-2285,Proprietary  ,42,131,173,118,428,546
02116009,SANFORD-BROWN COLLEGE - MIDDLEBURG HEIGH,OH,44130-8362,Proprietary  ,0,0,0,1,14,15
02116900,UPPER VALLEY JVS                        ,OH,45356-0000,Public       ,12,49,61,41,192,233
02117300,GREAT OAKS INSTITUTE OF TECHNOLOGY      ,OH,45241-1581,Public       ,44,152,196,170,629,799
02128600,THE ART INSTITUTE OF CINCINNATI         ,OH,45246-0000,Proprietary  ,33,30,63,309,219,528
02140700,CANTON CITY SCHOOLS ADULT CAREER & TECH ,OH,44702-1710,Public       ,7,59,66,32,212,244
02158417,"HARRISON COLLEGE - COLUMBUS, OH         ",OH,43123-0000,Proprietary  ,16,70,86,89,464,553
02158500,OHIO BUSINESS COLLEGE                   ,OH,44035-0701,Proprietary  ,24,97,121,95,451,546
02158501,OHIO BUSINESS COLLEGE                   ,OH,44870-9953,Proprietary  ,21,106,127,57,319,376
02158503,OHIO BUSINESS COLLEGE - COLUMBUS        ,OH,43229-3523,Proprietary  ,31,113,144,126,440,566
02158504,OHIO BUSINESS COLLEGE - DAYTON          ,OH,45417-4094,Proprietary  ,0,0,0,20,82,102
02168100,TRI-COUNTY JOINT VOCATIONAL SCHOOL      ,OH,45764-0000,Public       ,11,53,64,35,131,166
02187900,ASHTABULA CO JOINT VOC SCH ADULT ED     ,OH,44047-0000,Public       ,21,69,90,32,164,196
02189000,MID-EAST CAREER & TECH CENTERS-ADULT ED ,OH,43701-4600,Public       ,23,118,141,124,320,444
02190700,FORTIS COLLEGE                          ,OH,45459-0000,Proprietary  ,66,484,550,209,1837,2046
02192100,BUTLER TECHNOLOGY AND CAREER DEVELOPMENT,OH,45011-0000,Public       ,49,171,220,163,474,637
02196300,COLLINS CAREER CENTER                   ,OH,45619-0000,Public       ,44,187,231,185,570,755
02210800,MEDINA COUNTY CAREER CENTER             ,OH,44256-0000,Public       ,7,27,34,28,93,121
02220500,GOD'S BIBLE SCHOOL & COLLEGE            ,OH,45210-0000,Private      ,38,35,73,172,102,274
02220800,CAREER & TECHNOLOGY EDUCATION CENTERS OF,OH,43055-0000,Public       ,32,92,124,123,286,409
02239800,PIONEER CAREER & TECHNOLOGY CENTER      ,OH,44875-9704,Public       ,3,5,8,8,27,35
02245600,WARREN COUNTY CAREER CENTER             ,OH,45036-0000,Public       ,23,82,105,67,202,269
02246300,INSTITUTE OF MEDICAL-DENTAL TECH        ,OH,45246-3317,Proprietary  ,59,234,293,171,658,829
02263700,MIAMI VALLEY CAREER TECHNOLOGY CTR      ,OH,45315-0000,Public       ,27,120,147,100,364,464
02269400,EASTERN HILLS ACAD OF HAIR DESIGN       ,OH,45255-0000,Proprietary  ,0,0,0,4,14,18
02269500,WESTERN HILLS SCHOOL OF BEAUTY & HAIR DE,OH,45211-0000,Proprietary  ,14,80,94,45,209,254
02272700,COLUMBIANA COUNTY CAREER CENTER         ,OH,44432-0000,Public       ,22,83,105,47,170,217
02287900,RAPHAEL'S SCHOOL OF BEAUTY CULTURE      ,OH,44446-0000,Proprietary  ,23,71,94,64,161,225
02301400,OHIO VALLEY COLLEGE OF TECHNOLOGY       ,OH,43920-9139,Proprietary  ,24,61,85,83,190,273
02304700,TRI-RIVERS CAREER CENTER                ,OH,43302-0000,Public       ,9,58,67,48,239,287
02311200,AMERICAN SCHOOL OF TECHNOLOGY           ,OH,43229-0000,Proprietary  ,28,109,137,83,402,485
02315500,TOLEDO ACADEMY OF BEAUTY CULTURE - EAST ,OH,43616-0000,Proprietary  ,7,41,48,23,111,134
02324400,ALLSTATE HAIRSTYLING & BARBER CLG       ,OH,44113-0000,Proprietary  ,23,66,89,67,253,320
02328500,MOLER-PICKENS BEAUTY COLLEGE            ,OH,45014-0000,Proprietary  ,1,22,23,5,41,46
02334300,EMPIRE BEAUTY SCHOOL                    ,OH,45239-3926,Proprietary  ,32,90,122,96,233,329
02336300,KNOX COUNTY CAREER CENTER               ,OH,43050-4298,Public       ,7,54,61,41,208,249
02336700,CUYAHOGA VALLEY CAREER CENTER           ,OH,44141-1296,Public       ,11,69,80,47,198,245
02337700,PROFESSIONAL SKILLS INSTITUTE           ,OH,43607-0000,Proprietary  ,32,142,174,96,490,586
02351500,WILLOUGHBY EASTLAKE SCH OF PRAC NSG     ,OH,44094-0000,Public       ,6,55,61,26,183,209
02352800,POLARIS CAREER CENTER-ADULT ED DEPT     ,OH,44130-0000,Public       ,43,144,187,92,327,419
02354200,SCIOTO COUNTY JOINT VOCATIONAL SCH      ,OH,45648-0000,Public       ,22,98,120,85,238,323
02359803,ITT TECHNICAL INSTITUTE -               ,OH,45212-2273,Proprietary  ,0,1,1,0,1,1
02454400,NORTHEAST OHIO MEDICAL UNIVERSITY       ,OH,44272-9621,Public       ,5,46,51,129,946,1075
02497800,GREENE COUNTY CAREER CENTER             ,OH,45385-0000,Public       ,8,18,26,23,46,69
02519300,OHIO STATE SCH COSMETOLOGY              ,OH,43110-2754,Proprietary  ,27,52,79,101,174,275
02522700,EASTLAND-FAIRFIELD CAREER AND TECHNICAL ,OH,43125-0000,Public       ,16,64,80,50,205,255
02528300,TDDS TECHNICAL INSTITUTE                ,OH,44429-0000,Proprietary  ,17,156,173,55,342,397
02529500,HAMRICK SCHOOL                          ,OH,44256-0000,Proprietary  ,7,86,93,18,196,214
02545800,INNER STATE BEAUTY SCHOOLS              ,OH,44124-0000,Proprietary  ,11,64,75,34,177,211
02553000,SCHOOL OF ADVERTISING ART               ,OH,45440-0000,Proprietary  ,16,4,20,296,39,335
02560000,CASAL AVEDA INSTITUTE                   ,OH,44515-0000,Proprietary  ,21,48,69,111,147,258
02560700,PICKAWAY ROSS CO JOINT VOC TECH SCH     ,OH,45601-0000,Public       ,26,123,149,71,339,410
02562300,APOLLO CAREER CENTER-ADULT EDUC         ,OH,45806-0000,Public       ,25,139,164,71,349,420
02563000,RAPHAELS SCHOOL OF BEAUTY CULTURE       ,OH,44601-2847,Proprietary  ,25,57,82,47,130,177
02568600,MAHONING COUNTY CAREER & TECH CENTR     ,OH,44406-0000,Public       ,8,41,49,39,102,141
02582900,KAPLAN CAREER INSTITUTE                 ,OH,44129-6810,Proprietary  ,0,0,0,6,61,67
02586400,TRUMBULL CAREER & TECH CENTER-ADULT     ,OH,44483-1997,Public       ,11,62,73,32,158,190
02588500,OHIO STATE SCHOOL OF COSMETOLOGY        ,OH,43081-0000,Proprietary  ,23,47,70,102,151,253
02599711,VATTEROTT COLLEGE - CLEVELAND           ,OH,44147-3502,Proprietary  ,16,91,107,51,271,322
02603800,LORAIN COUNTY JVS ADULT CAREER CTR      ,OH,44074-9799,Public       ,24,92,116,58,205,263
02611007,HERITAGE COLLEGE - COLUMBUS             ,OH,43213-4440,Proprietary  ,56,209,265,181,703,884
02620000,SANDUSKY CAREER CENTER                  ,OH,44870-4786,Public       ,10,66,76,22,123,145
03007900,GALLIPOLIS CAREER COLLEGE               ,OH,45631-2600,Proprietary  ,4,34,38,18,121,139
03015100,ALLIANCE HIGH SCH-CMTY SERVICES DIV     ,OH,44601-2899,Public       ,6,44,50,14,81,95
03015300,EHOVE CAREER CENTER                     ,OH,44846-9500,Public       ,23,98,121,77,313,390
03023700,MADISON ADULT CAREER CENTER             ,OH,44905-2718,Public       ,8,52,60,41,167,208
03024300,VALLEY BEAUTY SCHOOL                    ,OH,43725-2332,Proprietary  ,0,1,1,7,10,17
03026511,REMINGTON COLLEGE - CLEVELAND           ,OH,44125-1957,Private      ,33,131,164,122,483,605
03027100,FAIRVIEW ACADEMY                        ,OH,44126-2214,Proprietary  ,4,12,16,11,43,54
03034200,WASHINGTON COUNTY CAREER CENTER ADULT TE,OH,45750-9290,Public       ,15,97,112,85,324,409
03035801,HERITAGE INSTITUTE - HERITAGE COLLEGE/CL,OH,44130-3304,Proprietary  ,22,79,101,54,247,301
03051400,AUBURN CAREER CENTER                    ,OH,44077-9723,Public       ,22,55,77,44,167,211
03051500,US GRANT JOINT VOCATIONAL SCHOOL        ,OH,45106-9502,Public       ,5,19,24,8,30,38
03065900,BUCKEYE CAREER CENTER                   ,OH,44663-9437,Public       ,22,50,72,59,151,210
03067600,RAPHAEL'S SCHOOL OF BEAUTY CULTURE      ,OH,44512-2222,Proprietary  ,25,39,64,45,94,139
03068200,OHIO CENTER FOR BROADCASTING            ,OH,44125-6273,Proprietary  ,15,54,69,45,144,189
03068202,OHIO CENTER FOR BROADCASTING - COLUMBUS ,OH,43213-2571,Proprietary  ,14,76,90,58,205,263
03071900,MOUNT CARMEL COLLEGE OF NURSING         ,OH,43222-1598,Private      ,76,167,243,773,875,1648
03078000,OHIO CENTER FOR BROADCASTING            ,OH,45227-1509,Proprietary  ,10,51,61,33,131,164
03079000,ETI TECHNICAL COLLEGE                   ,OH,44446-4398,Proprietary  ,21,83,104,55,244,299
03084800,DELAWARE AREA CAREER CENTER             ,OH,43015-8969,Public       ,0,13,13,11,38,49
03084801,DELAWARE AREA CAREER CENTER -           ,OH,43015-9001,Public       ,0,7,7,4,22,26
03095600,VANTAGE CAREER CENTER                   ,OH,45891-1378,Public       ,6,32,38,15,83,98
03097000,MERCY COLLEGE OF OHIO                   ,OH,43604-1132,Private      ,99,333,432,597,1380,1977
03100100,PARAMOUNT BEAUTY ACADEMY                ,OH,45662-4136,Proprietary  ,13,36,49,28,92,120
03116200,DAYTON BARBER COLLEGE                   ,OH,45342-4196,Proprietary  ,5,36,41,11,86,97
03116300,OHIO COLLEGE OF MASSOTHERAPY            ,OH,44321-1363,Private      ,4,26,30,20,83,103
03116400,VANGUARD-SENTINELL VOC SCH DISTRICT     ,OH,43420-1197,Public       ,2,15,17,9,50,59
03117000,ASHLAND COUNTY-W HOLMES CAREER CTR      ,OH,44805-0000,Public       ,15,50,65,27,113,140
03319300,CREATIVE IMAGES-A CERTIFIED MATRIX      ,OH,45414-2557,Proprietary  ,26,53,79,109,222,331
03319301,CREATIVE IMAGES-A CERTIFIED MATRIX      ,OH,45459-0000,Proprietary  ,14,44,58,67,163,230
03425300,ROSEDALE BIBLE COLLEGE                  ,OH,43029-9517,Private      ,8,4,12,47,8,55
03457300,ALLEGHENY WESLEYAN COLLEGE              ,OH,44460-9598,Private      ,13,7,20,40,21,61
03468400,NATIONAL INSTITUTE OF MASSOTHERAPY      ,OH,44319-2100,Proprietary  ,3,25,28,10,74,84
03468500,ATS INSTITUTE OF TECHNOLOGY             ,OH,44143-2216,Proprietary  ,18,160,178,49,544,593
03475400,TRI-STATE BIBLE COLLEGE                 ,OH,45680-8402,Private      ,2,37,39,6,55,61
03534400,AMERICAN INST OF ALTERNATIVE MEDICI     ,OH,43229-1113,Proprietary  ,11,137,148,63,645,708
03583300,OHIO INSTITUTE OF ALLIED HEALTH         ,OH,45424-3646,Private      ,2,33,35,6,119,125
03626300,BROWN AVEDA INSTITUTE                   ,OH,44060-6212,Proprietary  ,59,81,140,176,295,471
03700300,REGENCY BEAUTY INSTITUTE - CLEVELAND    ,OH,44094-0000,Proprietary  ,32,86,118,128,345,473
03726300,TEMPLE BAPTIST COLLEGE                  ,OH,45240-0000,Private      ,0,0,0,1,8,9
03747300,BEXLEY HALL SEMINARY                    ,OH,43209-2325,Private      ,1,4,5,2,37,39
03776400,HEALING ARTS INSTITUTE                  ,OH,43551-3138,Proprietary  ,9,20,29,20,62,82
03837300,AVEDA FREDRIC'S INSTITUTE               ,OH,45208-1304,Proprietary  ,36,54,90,121,181,302
04051307,ART INSTITUTE OF PHOENIX (THE) - BROWN M,OH,45215-1107,Proprietary  ,38,205,243,132,718,850
04051308,ART INSTITUTE OF PHOENIX (THE) - BROWN M,OH,44320-4420,Proprietary  ,19,94,113,107,386,493
04051317,ART INSTITUTE OF PHOENIX (THE) - BROWN M,OH,45840-6848,Proprietary  ,84,282,366,278,1289,1567
04051326,ART INSTITUTE OF PHOENIX (THE) - BROWN M,OH,44718-3674,Proprietary  ,31,102,133,88,435,523
04068300,FOUR COUNTY CAREER CENTER               ,OH,43512-9541,Public       ,3,14,17,5,40,45
04074300,HONDROS COLLEGE                         ,OH,43081-3855,Proprietary  ,114,722,836,451,3471,3922
04117300,DAYTON SCHOOL OF MEDICAL MASSAGE        ,OH,45429-1111,Proprietary  ,32,120,152,99,366,465
04118300,NORTHCOAST MEDICAL TRAINING ACADEMY     ,OH,44240-4174,Proprietary  ,21,65,86,63,171,234
04124500,TECHSKILLS                              ,OH,43231-0000,Proprietary  ,13,160,173,49,411,460
04126000,OHIO ACADEMY PAUL MITCHELL PARTNER SCHOO,OH,44087-3107,Proprietary  ,24,47,71,96,188,284
04137800,AVEDA INSTITUTE COLUMBUS                ,OH,43201-2333,Proprietary  ,107,147,254,320,436,756
04138000,INSTITUTE OF THERAPEUTIC MASSAGE        ,OH,45801-4565,Proprietary  ,1,10,11,6,17,23
04149100,PAUL MITCHELL THE SCHOOL CINCINNATI     ,OH,45241-1702,Proprietary  ,48,71,119,142,216,358
04149101,PAUL MITCHELL THE SCHOOL CINCINNATI - TO,OH,43560-2539,Proprietary  ,46,70,116,88,144,232
04151400,VANITY SCHOOL OF COSMETOLOGY            ,OH,44035-0000,Proprietary  ,7,18,25,23,67,90
04152100,TOLEDO RESTAURANT TRAINING CENTER       ,OH,43604-6508,Private      ,7,26,33,14,84,98
04152600,PIKE COUNTY CAREER TECHNOLOGY CENTER    ,OH,45661-9114,Public       ,0,9,9,2,25,27
04153300,OHIO ACADEMY COLUMBUS (THE)             ,OH,43231-6038,Proprietary  ,38,81,119,131,213,344
04166800,SALON PROFESSIONAL ACADEMY (THE)        ,OH,45551-0000,Proprietary  ,16,20,36,53,43,96
04167700,ARTISAN COLLEGE OF COSMETOLOGY (THE)    ,OH,45840-6848,Proprietary  ,1,17,18,15,37,52
04177300,OHIO MEDICAL CAREER COLLEGE             ,OH,45417-4094,Proprietary  ,24,167,191,97,523,620
04185900,ELITE SCHOOL OF COSMETOLOGY             ,OH,44857-2714,Proprietary  ,6,17,23,16,65,81
04189100,SALON INSTITUTE - TOLEDO CAMPUS         ,OH,43615-1731,Proprietary  ,25,30,55,66,92,158
04192200,ATHENA CAREER ACADEMY                   ,OH,43560-2796,Proprietary  ,16,102,118,42,364,406
04206700,ELITE WELDING ACADEMY                   ,OH,45246-1013,Proprietary  ,16,22,38,64,86,150
04215800,MAPLEWOOD AREA JOINT VOCATIONAL SCHOOL  ,OH,44266-9188,Public       ,1,1,2,1,1,2
04220900,NATIONAL PERSONAL TRAINING INSTITUTE OF ,OH,43235-5739,Proprietary  ,10,28,38,25,94,119
04224300,VALOR CHRISTIAN COLLEGE                 ,OH,43216-0800,Private      ,30,117,147,107,332,439
04225700,LABARBERIA INSTITUTE OF HAIR            ,OH,44106-1923,Proprietary  ,12,45,57,34,143,177
04235000,FELBRY SCHOOL OF NURSING                ,OH,43231-2256,Proprietary  ,6,58,64,6,58,64
04244300,ANTIOCH COLLEGE                         ,OH,45387-1683,Private      ,132,49,181,140,54,194
        ,INVALID SCHOOL CODE                     ,  ,00000-0000,,185,1296,1481,637,3242,3879
00134500,ADAMS STATE COLLEGE                     ,CO,81102-2373,Public       ,375,680,1055,2543,2053,4596
00134600,ARAPAHOE COMMUNITY COLLEGE              ,CO,80160-9002,Public       ,710,1520,2230,2824,5113,7937
00134700,COLORADO COLLEGE                        ,CO,80903-3294,Private      ,117,194,311,3349,869,4218
00134800,COLORADO SCHOOL OF MINES                ,CO,80401-1887,Public       ,253,238,491,6647,1278,7925
00134900,UNIVERSITY OF NORTHERN COLORADO         ,CO,80639-0001,Public       ,783,929,1712,10470,4713,15183
00135000,COLORADO STATE UNIVERSITY               ,CO,80523-0100,Public       ,1986,1772,3758,25168,10046,35214
00135200,DENVER  SEMINARY                        ,CO,80120-2192,Private      ,2,169,171,10,643,653
00135300,FORT LEWIS COLLEGE                      ,CO,81301-3999,Public       ,501,308,809,4599,1498,6097
00135400,ILIFF SCHOOL OF THEOLOGY                ,CO,80210-0000,Private      ,1,60,61,8,328,336
00135500,LAMAR COMMUNITY COLLEGE                 ,CO,81052-3999,Public       ,89,117,206,406,252,658
00135800,COLORADO MESA UNIVERSITY                ,CO,81501-3122,Public       ,1121,992,2113,7759,3467,11226
00135900,COLORADO NORTHWESTERN COMMUNITY COLLEGE ,CO,81648-3598,Public       ,111,162,273,503,435,938
00136000,METROPOLITAN STATE UNIVERSITY OF DENVER ,CO,80204-3362,Public       ,2078,3679,5757,11527,14067,25594
00136100,NORTHEASTERN JUNIOR COLLEGE             ,CO,80751-2399,Public       ,200,146,346,1048,421,1469
00136200,OTERO JUNIOR COLLEGE                    ,CO,81050-3346,Public       ,170,275,445,603,608,1211
00136300,REGIS UNIVERSITY                        ,CO,80221-1099,Private      ,141,1172,1313,3797,6869,10666
00136500,COLORADO STATE UNIVERSITY-PUEBLO        ,CO,81001-4901,Public       ,454,595,1049,5928,2671,8599
00136800,TRINIDAD STATE JR COLLEGE               ,CO,81082-2396,Public       ,173,327,500,695,860,1555
00137000,UNIVERSITY OF COLORADO-BOULDER          ,CO,80309-0077,Public       ,1817,1295,3112,28252,8816,37068
00137100,UNIVERSITY OF DENVER                    ,CO,80208-2000,Private      ,349,1134,1483,10251,8988,19239
00137200,WESTERN STATE COLORADO UNIVERSITY       ,CO,81231-0000,Public       ,246,163,409,2454,660,3114
00405702,NATIONAL AMERICAN UNIVERSITY - COLORADO ,CO,80920-4001,Proprietary  ,12,83,95,40,325,365
00405703,NATIONAL AMERICAN UNIVERSITY            ,CO,80222-0000,Proprietary  ,6,34,40,20,191,211
00450300,EVEREST COLLEGE                         ,CO,80916-3548,Private      ,17,150,167,84,624,708
00450600,COLORADO MOUNTAIN COLLEGE               ,CO,81602-0000,Public       ,311,530,841,1788,1805,3593
00450700,EVEREST COLLEGE                         ,CO,80229-4339,Private      ,26,74,100,91,306,397
00450701,"EVEREST COLLEGE- EVEREST COLLEGE, AURORA",CO,80012-5692,Private      ,30,75,105,95,346,441
00450800,UNIVERSITY OF COLORADO DENVER           ,CO,80204-2029,Public       ,1066,2744,3810,10603,14609,25212
00450900,UNIV OF COLORADO AT COLO SPRINGS        ,CO,80918-3735,Public       ,886,1357,2243,9865,6612,16477
00559600,EMILY GRIFFITH OPPORTUNITY SCH          ,CO,80204-2197,Public       ,110,433,543,598,1476,2074
00729700,REDSTONE COLLEGE                        ,CO,80020-9988,Proprietary  ,31,100,131,147,486,633
00732912,ITT TECHNICAL INSTITUTE                 ,CO,80229-5338,Proprietary  ,52,251,303,150,760,910
00754800,WESTWOOD COLLEGE - DENVER NORTH         ,CO,80221-3653,Proprietary  ,39,156,195,150,714,864
00754801,WESTWOOD COLLEGE - DENVER SOUTH         ,CO,80227-3653,Proprietary  ,25,103,128,96,468,564
00758200,AIMS COMMUNITY COLLEGE                  ,CO,80632-0000,Public       ,420,758,1178,1986,2920,4906
00764900,ROCKY MOUNTAIN COLG OF ART & DESIGN     ,CO,80214-0000,Proprietary  ,137,353,490,783,1191,1974
00793300,FRONT RANGE COMMUNITY COLLEGE           ,CO,80031-2199,Public       ,1589,3103,4692,6613,10557,17170
00793806,LINCOLN COLLEGE OF TECHNOLOGY - DENVER  ,CO,80239-3006,Proprietary  ,163,202,365,868,830,1698
00863500,INTELLITEC MEDICAL INSTITUTE            ,CO,80909-0000,Proprietary  ,29,115,144,88,443,531
00887100,CONCORDE CAREER INSTITUTE               ,CO,80203-0000,Proprietary  ,148,357,505,388,1204,1592
00889600,PIKES PEAK COMMUNITY COLLEGE            ,CO,80906-5498,Public       ,1334,3434,4768,4464,10297,14761
00940100,COLORADO CHRISTIAN UNIVERSITY           ,CO,80226-7449,Private      ,225,1433,1658,2066,4682,6748
00954200,COMMUNITY COLLEGE OF DENVER             ,CO,80217-2026,Public       ,1091,2222,3313,5511,8311,13822
00954300,RED ROCKS COMMUNITY COLLEGE             ,CO,80228-1255,Public       ,673,1505,2178,2845,4863,7708
00998100,MORGAN COMMUNITY COLLEGE                ,CO,80701-4399,Public       ,84,214,298,338,635,973
01014800,COLORADO TECHNICAL UNIVERSITY           ,CO,80907-3896,Proprietary  ,94,1172,1266,406,4098,4504
01014802,COLORADO TECHNICAL UNIV - DENVER        ,CO,80111-3201,Proprietary  ,24,314,338,108,952,1060
01014805,COLORADO TECH UNIV - ON LINE            ,CO,80907-0000,Proprietary  ,576,9937,10513,1603,34448,36051
01014812,COLORADO TECHNICAL UNIVERSITY - WESTMINS,CO,80021-3498,Proprietary  ,4,118,122,42,384,426
01157200,COLORADO SCHOOL OF TRADES               ,CO,80215-2996,Proprietary  ,13,62,75,67,263,330
01267000,BEL-REA INST OF ANIMAL TECH             ,CO,80247-3048,Proprietary  ,55,116,171,314,487,801
01285000,INTERNATIONAL SALON AND SPA ACADEMY     ,CO,80918-3684,Proprietary  ,29,83,112,72,248,320
01287500,PICKENS TECHNICAL COLLEGE               ,CO,80011-9307,Public       ,56,213,269,380,727,1107
01300700,NAZARENE BIBLE COLLEGE                  ,CO,80910-3704,Private      ,23,131,154,61,489,550
02078900,ART INSTITUTE OF COLORADO (THE)         ,CO,80203-2983,Proprietary  ,242,384,626,1218,1351,2569
02116300,PUEBLO COMMUNITY COLLEGE                ,CO,81004-0000,Public       ,590,1611,2201,1923,4642,6565
02117500,NAROPA UNIVERSITY                       ,CO,80302-0000,Private      ,55,131,186,404,1091,1495
02156200,DELTA - MONTROSE TECHNICAL COLLEGE      ,CO,81416-0000,Public       ,19,70,89,68,175,243
02165200,SALON PROFESSIONAL ACADEMY (THE)        ,CO,81504-5309,Proprietary  ,13,19,32,54,80,134
02188700,DENVER ACAD OF COURT REPORTING          ,CO,80030-0000,Proprietary  ,0,1,1,0,14,14
02211901,CHEEKS INTERNATIONAL ACADEMY OF BEAUTY C,CO,80525-3053,Proprietary  ,3,24,27,20,47,67
02211902,CHEEKS INTERNATIONAL ACDMY BTY CULT     ,CO,80631-0000,Proprietary  ,7,11,18,20,28,48
02253700,INTELLITEC COLLEGE                      ,CO,80909-0000,Proprietary  ,50,269,319,148,810,958
02267500,GLENWOOD BEAUTY ACADEMY                 ,CO,81601-0000,Proprietary  ,3,16,19,11,36,47
02276900,COMMUNITY COLLEGE OF AURORA             ,CO,80011-9036,Public       ,564,1458,2022,2651,5181,7832
02518500,HAIR DYNAMICS EDUCATION CENTER          ,CO,80525-0000,Proprietary  ,23,57,80,68,137,205
02594300,COLLEGE AMERICA - DENVER                ,CO,80222-3380,Proprietary  ,61,354,415,224,1356,1580
02611000,HERITAGE COLLEGE                        ,CO,80212-7413,Proprietary  ,46,147,193,124,405,529
03006300,INST OF BUSINESS & MEDICAL CAREERS      ,CO,80525-3044,Proprietary  ,98,266,364,330,1178,1508
03010622,VIRGINIA COLLEGE - ECOTECH INSTITUTE - A,CO,80012-4627,Proprietary  ,16,40,56,57,212,269
03014900,PLATT COLLEGE                           ,CO,80014-3141,Proprietary  ,12,72,84,50,263,313
03027400,XENON INTERNATIONAL ACADEMY III         ,CO,80014-1193,Proprietary  ,7,24,31,27,73,100
03030606,UTAH COLLEGE OF MASSAGE THERAPY - DENVER,CO,80031-2921,Proprietary  ,17,32,49,48,94,142
03030607,UTAH COLLEGE OF MASSAGE THERAPY - DENVER,CO,80012-2523,Proprietary  ,25,39,64,71,132,203
03066900,INTELLITEC COLLEGE                      ,CO,81506-3994,Proprietary  ,62,221,283,167,587,754
03068201,OHIO CENTER FOR BROADCASTING - COLORADO ,CO,80214-4129,Proprietary  ,7,45,52,35,103,138
03289300,COLORADO HEIGHTS UNIVERSITY             ,CO,80236-2711,Private      ,29,94,123,131,251,382
03306300,MONTESSORI EDUC CRT OF THE ROCKIES      ,CO,80301-2587,Private      ,0,4,4,6,47,53
03534300,JONES INTERNATIONAL UNIVERSITY          ,CO,80112-3446,Proprietary  ,0,27,27,16,549,565
03545300,UNIVERSITY OF THE ROCKIES               ,CO,80903-3612,Proprietary  ,24,490,514,90,1841,1931
03584400,COLORADO SCHOOL OF HEALING ARTS         ,CO,80226-4332,Proprietary  ,14,53,67,56,213,269
03670300,TONI & GUY HAIRDRESSING ACADEMY         ,CO,80911-0000,Proprietary  ,30,71,101,77,179,256
03686300,COLORADO SCHOOL OF TRADITIONAL CHINESE M,CO,80206-2127,Proprietary  ,2,51,53,16,146,162
03776300,AUGUSTE ESCOFFIER SCHOOL OF CULINARY ART,CO,80305-5961,Proprietary  ,34,125,159,216,353,569
03976300,MASSAGE THERAPY INSTITUTE OF COLORADO   ,CO,80206-2127,Proprietary  ,18,59,77,54,176,230
04080300,ASPEN UNIVERSITY                        ,CO,80246-1930,Proprietary  ,24,293,317,127,999,1126
04093300,ACADEMY OF NATURAL THERAPY              ,CO,80631-3425,Proprietary  ,13,30,43,43,105,148
04121200,INSTITUTE OF TAOIST EDUCATION AND ACUPUN,CO,80027-1028,Private      ,1,13,14,5,35,40
04125100,MONTESSORI CASA INTERNATIONAL           ,CO,80111-5263,Private      ,0,2,2,0,5,5
04127700,AMERICAN SENTINEL UNIVERSITY            ,CO,80014-6510,Proprietary  ,3,388,391,21,1191,1212
04139300,NATIONAL BEAUTY COLLEGE                 ,CO,80221-0000,Proprietary  ,7,33,40,26,105,131
04148300,DENVER SCHOOL OF NURSING                ,CO,80202-1213,Proprietary  ,70,273,343,357,1148,1505
04167100,AVEDA INSTITUTE DENVER                  ,CO,80202-0000,Proprietary  ,70,104,174,239,366,605
04170200,PAUL MITCHELL THE SCHOOL COLORADO SPRING,CO,80903-0000,Proprietary  ,49,122,171,129,346,475
04172500,ROLF INSTITUTE OF STRUCTURAL INTEGRATION,CO,80301-0000,Private      ,3,33,36,6,104,110
04173800,SALON PROFESSIONAL ACADEMY (THE)        ,CO,80918-2932,Proprietary  ,5,38,43,36,125,161
04177100,PIMA MEDICAL INSTITUTE-SOUTH DENVER     ,CO,80231-0000,Proprietary  ,83,190,273,295,693,988
04179700,UNITED BEAUTY COLLEGE                   ,CO,80223-2936,Proprietary  ,11,36,47,34,110,144
04183700,HEALING ARTS INSTITUTE                  ,CO,80525-3479,Proprietary  ,6,30,36,35,110,145
04184900,COLLEGE OF INTERNATIONAL ESTHETICS      ,CO,80002-3754,Proprietary  ,9,52,61,35,136,171
04185000,COLORADO ACADEMY OF VETERINARY TECHNOLOG,CO,80906-4944,Proprietary  ,15,49,64,83,215,298
04185400,NATIONAL PERSONAL TRAINING INSTITUTE OF ,CO,80401-3304,Proprietary  ,8,25,33,25,82,107
04195300,LONGS PEAK ACADEMY                      ,CO,80501-6458,Proprietary  ,7,48,55,31,114,145
04202600,NEW DIMENSIONS BEAUTY ACADEMY           ,CO,80138-9801,Proprietary  ,5,21,26,22,70,92
04208700,COLORADO STATE UNIVERSITY - GLOBAL CAMPU,CO,80111-0000,Public       ,157,2415,2572,563,8856,9419
04218900,ROCKY VISTA UNIVERSITY COLLEGE OF OSTEOP,CO,80134-9498,Proprietary  ,1,44,45,2,627,629
04221400,PAUL MITCHELL THE SCHOOL DENVER         ,CO,80226-7395,Proprietary  ,47,65,112,127,166,293
00267811,BRYANT & STRATTON COLLEGE - VIRGINIA BEA,VA,23462-4417,Proprietary  ,42,237,279,209,999,1208
00370200,AVERETT UNIVERSITY                      ,VA,24541-3692,Private      ,63,341,404,1588,1212,2800
00370300,BLUEFIELD COLLEGE                       ,VA,24605-1799,Private      ,84,145,229,951,697,1648
00370400,BRIDGEWATER COLLEGE                     ,VA,22812-1599,Private      ,89,26,115,3615,204,3819
00370500,COLLEGE OF WILLIAM & MARY               ,VA,23187-8795,Public       ,250,290,540,11075,3770,14845
00370600,CHRISTOPHER NEWPORT UNIVERSITY          ,VA,23606-3072,Public       ,356,230,586,7992,1131,9123
00370700,RICHARD BLAND COLLEGE                   ,VA,23805-7100,Public       ,188,156,344,1498,650,2148
00370800,EASTERN MENNONITE UNIVERSITY            ,VA,22802-2462,Private      ,98,108,206,1342,585,1927
00370900,EMORY & HENRY COLLEGE                   ,VA,24327-0010,Private      ,60,34,94,1567,214,1781
00371100,FERRUM COLLEGE                          ,VA,24088-2612,Private      ,129,49,178,2585,285,2870
00371200,TIDEWATER COMMUNITY COLLEGE             ,VA,23510-1910,Public       ,2689,6726,9415,10187,21173,31360
00371300,HAMPDEN-SYDNEY COLLEGE                  ,VA,23943-0128,Private      ,67,13,80,1813,74,1887
00371400,HAMPTON UNIVERSITY                      ,VA,23668-0099,Private      ,497,552,1049,8738,2952,11690
00371500,HOLLINS UNIVERSITY                      ,VA,24020-0000,Private      ,39,72,111,1297,538,1835
00371900,LONGWOOD UNIVERSITY                     ,VA,23909-1899,Public       ,224,135,359,5915,951,6866
00372000,LYNCHBURG COLLEGE                       ,VA,24501-3199,Private      ,180,198,378,3403,1134,4537
00372100,JAMES MADISON UNIVERSITY                ,VA,22807-3780,Public       ,1066,374,1440,24319,3079,27398
00372300,MARY BALDWIN COLLEGE                    ,VA,24401-3610,Private      ,91,295,386,1546,1213,2759
00372400,MARYMOUNT UNIVERSITY                    ,VA,22207-4224,Private      ,185,386,571,2626,2108,4734
00372600,AMERICAN NATIONAL UNIVERSITY            ,VA,24153-4524,Proprietary  ,74,637,711,334,2942,3276
00372700,NORTHERN VA CMTY CLG                    ,VA,22003-3743,Public       ,3842,5345,9187,17519,19493,37012
00372800,OLD DOMINION UNIVERSITY                 ,VA,23529-0052,Public       ,1583,2749,4332,19230,14663,33893
00373200,RADFORD UNIVERSITY                      ,VA,24142-6905,Public       ,701,377,1078,11209,2666,13875
00373300,RANDOLPH-MACON COLLEGE                  ,VA,23005-5505,Private      ,91,17,108,2615,144,2759
00373400,RANDOLPH COLLEGE                        ,VA,24503-1526,Private      ,91,44,135,1129,211,1340
00373500,VIRGINIA COMMONWEALTH UNIVERSITY        ,VA,23284-9004,Public       ,1700,1969,3669,25520,13533,39053
00373600,ROANOKE COLLEGE                         ,VA,24153-3794,Private      ,125,36,161,3377,253,3630
00373700,SHENANDOAH UNIVERSITY                   ,VA,22601-5195,Private      ,202,346,548,3175,2293,5468
00373800,SOUTHERN VIRGINIA UNIVERSITY            ,VA,24416-3038,Private      ,138,82,220,1130,340,1470
00374200,SWEET BRIAR COLLEGE                     ,VA,24595-9998,Private      ,28,18,46,703,65,768
00374300,UNION PRESBYTERIAN SEMINARY             ,VA,23227-0000,Private      ,1,23,24,1,80,81
00374400,UNIVERSITY OF RICHMOND                  ,VA,23173-0001,Private      ,105,286,391,6692,2377,9069
00374500,UNIVERSITY OF VIRGINIA - SFS            ,VA,22903-0000,Public       ,390,604,994,21541,7715,29256
00374600,UNIVERSITY OF MARY WASHINGTON           ,VA,22401-5358,Public       ,240,219,459,5786,1323,7109
00374700,UNIV OF VIRGINIA'S COLLEGE AT WISE      ,VA,24293-4412,Public       ,131,110,241,1762,545,2307
00374800,EASTERN SHORE COMMUNITY COLLEGE         ,VA,23410-3001,Public       ,76,119,195,305,420,725
00374900,GEORGE MASON UNIVERSITY                 ,VA,22030-4444,Public       ,1008,1879,2887,24864,14357,39221
00375100,PATRICK HENRY COMMUNITY COLLEGE         ,VA,24112-5311,Public       ,262,525,787,1126,1578,2704
00375300,VIRGINIA MILITARY INSTITUTE             ,VA,24450-2138,Public       ,106,16,122,2084,95,2179
00375400,VIRGINIA POLYTECH INST & STATE UNIV     ,VA,24061-2000,Public       ,1097,646,1743,27831,4656,32487
00375800,DANVILLE COMMUNITY COLLEGE              ,VA,24541-4004,Public       ,367,651,1018,1331,1916,3247
00375900,J. SARGEANT REYNOLDS COMMUNITY CLG      ,VA,23285-0000,Public       ,1138,2793,3931,4784,9993,14777
00376000,VIRGINIA WESTERN CMTY COLLEGE           ,VA,24038-0000,Public       ,563,1072,1635,3087,3667,6754
00376100,WYTHEVILLE COMMUNITY COLLEGE            ,VA,24382-3308,Public       ,236,387,623,1179,1346,2525
00376200,VIRGINIA UNIVERSITY OF LYNCHBURG        ,VA,24501-6400,Private      ,62,146,208,442,484,926
00376400,VIRGINIA STATE UNIVERSITY               ,VA,23806-0001,Public       ,635,548,1183,8585,3020,11605
00376500,NORFOLK STATE UNIVERSITY                ,VA,23504-8000,Public       ,569,1179,1748,5901,5529,11430
00376600,VIRGINIA UNION UNIVERSITY               ,VA,23220-1711,Private      ,365,337,702,3752,1559,5311
00376700,VIRGINIA WESLEYAN COLLEGE               ,VA,23502-5599,Private      ,171,164,335,2202,716,2918
00376800,WASHINGTON & LEE UNIVERSITY             ,VA,24450-0303,Private      ,96,24,120,2938,864,3802
00400400,JOHN TYLER COMMUNITY COLLEGE            ,VA,23831-5316,Public       ,1034,1687,2721,4000,5481,9481
00450301,EVEREST COLLEGE -  MCLEAN               ,VA,22182-2214,Private      ,2,9,11,12,63,75
00498800,CENTRAL VIRGINIA COMMUNITY COLLEGE      ,VA,24502-2498,Public       ,406,613,1019,1693,2088,3781
00499200,MILLER-MOTTE TECHNICAL COLLEGE          ,VA,24505-0000,Proprietary  ,87,404,491,202,819,1021
00499600,DABNEY S LANCASTER COMMUNITY CLG        ,VA,24422-1000,Public       ,82,119,201,496,450,946
00522300,NEW RIVER COMMUNITY COLLEGE             ,VA,24084-1127,Public       ,296,475,771,1503,1841,3344
00662200,COLLEGE OF HEALTH SCIENCES - CHRV       ,VA,24031-0000,Private      ,42,123,165,629,1021,1650
00681900,BLUE RIDGE COMMUNITY COLLEGE            ,VA,24486-0080,Public       ,348,575,923,2019,2165,4184
00687100,THOMAS NELSON COMMUNITY COLLEGE         ,VA,23670-0000,Public       ,931,2120,3051,3737,7882,11619
00709900,VIRGINIA HIGHLANDS COMMUNITY CLG        ,VA,24210-4210,Public       ,205,340,545,995,1283,2278
00726000,SOUTHWEST VIRGINIA COMMUNITY CLG        ,VA,24641-0000,Public       ,280,517,797,1132,1506,2638
00865900,LORD FAIRFAX COMMUNITY COLLEGE          ,VA,22645-0047,Public       ,538,796,1334,2091,2531,4622
00866000,GERMANNA COMMUNITY COLLEGE              ,VA,22508-0339,Public       ,627,920,1547,2873,3506,6379
00866100,SOUTHSIDE VIRGINIA CMTY CLG             ,VA,23821-2930,Public       ,529,789,1318,1404,2224,3628
00915900,PAUL D CAMP COMMUNITY COLLEGE           ,VA,23851-0737,Public       ,110,354,464,425,1042,1467
00916000,RAPPAHANNOCK COMMUNITY COLLEGE          ,VA,23149-2616,Public       ,280,448,728,870,1251,2121
00926700,EVEREST COLLEGE                         ,VA,23606-4203,Private      ,9,130,139,58,473,531
00926701,EVEREST COLLEGE - CHESAPEAKE            ,VA,23320-2637,Private      ,24,207,231,94,590,684
00942000,SANFORD-BROWN COLLEGE                   ,VA,22102-4301,Proprietary  ,1,9,10,5,35,40
00953500,STAUNTON SCHOOL OF COSMETOLOGY          ,VA,24401-4323,Proprietary  ,2,11,13,22,45,67
00953700,VIRGINIA SCH OF HAIR DESIGN             ,VA,23669-0000,Proprietary  ,7,44,51,31,144,175
00962900,MOUNTAIN EMPIRE COMMUNITY COLLEGE       ,VA,24219-0700,Public       ,231,523,754,963,1460,2423
00992800,PIEDMONT VIRGINIA COMMUNITY COLLEGE     ,VA,22902-7589,Public       ,363,702,1065,1712,2468,4180
01004300,BON SECOURS MEMORIAL COLLEGE OF NURSING ,VA,23227-4612,Private      ,22,123,145,266,761,1027
01019800,ECPI UNIVERSITY                         ,VA,23462-6542,Proprietary  ,275,1743,2018,853,5421,6274
01019802,ECPI UNIVERSITY - NEWPORT NEWS          ,VA,23606-4298,Proprietary  ,91,510,601,364,1712,2076
01019807,ECPI UNIVERSITY - MANASSAS              ,VA,20109-2665,Proprietary  ,77,211,288,219,698,917
01019813,ECPI UNIVERSITY - CULINARY INSTITUTE OF ,VA,23513-2448,Proprietary  ,30,94,124,184,350,534
01019814,ECPI UNIVERSITY - VIRGINIA BEACH HEALTH ,VA,23462-6540,Proprietary  ,28,147,175,88,647,735
01019815,ECPI UNIVERSITY - RICHMOND SOUTH        ,VA,23236-3659,Proprietary  ,88,288,376,283,872,1155
01019816,ECPI UNIVERSITY - INNSBROOK             ,VA,23060-3359,Proprietary  ,36,105,141,146,395,541
01019817,ECPI UNIVERSITY - RICHMOND WEST         ,VA,23294-3730,Proprietary  ,47,186,233,198,633,831
01033800,EASTERN VIRGINIA MEDICAL SCHOOL         ,VA,23501-1980,Public       ,16,191,207,74,1860,1934
01159600,SYLVAIN MELLOUL INTERNATIONAL HAIR ACADE,VA,24502-2652,Proprietary  ,9,25,34,59,117,176
01162601,WESTWOOD COLLEGE - SOUTH BAY - ARLINGTON,VA,22203-4167,Proprietary  ,35,117,152,129,458,587
01162602,WESTWOOD COLLEGE - SOUTH BAY - ANNANDALE,VA,22003-2602,Proprietary  ,19,90,109,76,378,454
01274400,SOUTHSIDE REGIONAL MED CTR PROF SCHOOLS ,VA,23803-5133,Proprietary  ,8,50,58,100,259,359
02053000,LIBERTY UNIVERSITY                      ,VA,24502-0000,Private      ,2297,24723,27020,22808,77922,100730
02108800,WARDS CORNER BEAUTY ACADEMY             ,VA,23505-0000,Proprietary  ,21,66,87,40,183,223
02111600,DANVILLE REGIONAL MEDICAL CENTER SCHOOL ,VA,24541-0000,Proprietary  ,9,17,26,38,69,107
02128700,CENTRAL SCHOOL OF PRACTICAL NURSING     ,VA,23502-2230,Public       ,16,65,81,66,246,312
02140000,RIVERSIDE SCHOOL OF HEALTH CAREERS      ,VA,23608-3802,Private      ,21,109,130,144,603,747
02149901,PAUL MITCHELL THE SCHOOL-JACKSONVILLE - ,VA,22102-0000,Proprietary  ,30,60,90,68,152,220
02149902,PAUL MITCHELL THE SCHOOL-JACKSONVILLE - ,VA,22192-0000,Proprietary  ,32,56,88,94,150,244
02175800,LYNCHBURG GENERAL HOSP SCH OF NURSG     ,VA,24501-0000,Private      ,20,73,93,102,261,363
02197600,WOODROW WILSON REHABILITATION CTR       ,VA,22939-0000,Public       ,15,8,23,41,29,70
02242400,HENRICO CTY ST MARYS HOSP PRAC NRSG     ,VA,23075-0000,Public       ,1,7,8,8,61,69
02320900,TIDEWATER TECH                          ,VA,23502-1747,Proprietary  ,69,275,344,210,802,1012
02334400,CENTURA COLLEGE                         ,VA,23452-0000,Proprietary  ,73,443,516,237,1316,1553
02342700,FORTIS COLLEGE                          ,VA,23502-4101,Proprietary  ,48,220,268,166,724,890
02342701,FORTIS COLLEGE - RICHMOND CAMPUS        ,VA,23230-0000,Proprietary  ,68,205,273,194,768,962
02358500,BON SECOURS SAINT MARY'S HOSPITAL SCHOOL,VA,23227-4612,Private      ,9,67,76,90,271,361
02538800,SUFFOLK BEAUTY ACADEMY                  ,VA,23434-0000,Proprietary  ,5,27,32,24,96,120
02541200,STRATFORD UNIVERSITY                    ,VA,22043-0000,Proprietary  ,153,844,997,584,3168,3752
02541201,STRATFORD UNIVERSITY-WOODBRIDGE         ,VA,22192-0000,Proprietary  ,0,0,0,54,246,300
02588900,MEDTECH INSTITUTE                       ,VA,22042-3013,Proprietary  ,123,325,448,294,962,1256
02610100,WASHINGTON COUNTY ADULT SKILL CTR       ,VA,24210-2346,Public       ,10,42,52,31,109,140
02617508,EVEREST COLLEGE - WOODBRIDGE            ,VA,22192-6808,Private      ,52,163,215,155,543,698
03002400,GRAHAM WEBB INTERNATIONAL ACAD HAIR     ,VA,22209-2129,Proprietary  ,6,27,33,19,102,121
03010700,BAR PALMA BEAUTY CAREERS  ACADEMY       ,VA,24014-2255,Proprietary  ,8,30,38,39,101,140
03042800,"VIRGINIA BEACH CITY SCHOOLS, SCH.-PR.NSG",VA,23456-0038,Public       ,11,41,52,46,149,195
03091300,REGENT UNIVERSITY                       ,VA,23464-9800,Private      ,234,2221,2455,1915,7726,9641
03092700,SKYLINE COLLEGE                         ,VA,24012-1603,Proprietary  ,9,50,59,36,175,211
03096500,SPRINGFIELD BEAUTY ACADEMY              ,VA,22003-3016,Proprietary  ,1,17,18,6,42,48
03106500,SENTARA COLLEGE OF HEALTH SCIENCES      ,VA,23320-2843,Private      ,36,170,206,218,865,1083
03116900,BAPTIST THEOLOGICAL SEM.-RICHMOND       ,VA,23227-0000,Private      ,1,31,32,4,121,125
03126300,AVIATION INSTITUTE OF MAINTENANCE       ,VA,23320-5987,Proprietary  ,19,95,114,75,323,398
03126400,CENTURA COLLEGE                         ,VA,23235-5230,Proprietary  ,34,219,253,111,678,789
03127500,ADVANCED TECHNOLOGY INSTITUTE           ,VA,23462-2409,Proprietary  ,106,165,271,459,570,1029
03280400,VIRGINIA SCHOOL OF MASSAGE              ,VA,22903-0000,Proprietary  ,12,35,47,27,80,107
03409500,CHESTER CAREER COLLEGE                  ,VA,23836-2516,Proprietary  ,17,89,106,74,304,378
03455300,CRESCENT COSMETOLOGY UNIVERSITY         ,VA,23666-3115,Proprietary  ,3,10,13,12,36,48
03559300,APPALACHIAN SCHOOL OF LAW               ,VA,24614-0000,Private      ,3,38,41,12,240,252
03645400,RUDY & KELLY ACADEMY OF HAIR AND NA     ,VA,23464-6857,Proprietary  ,36,71,107,123,283,406
03654300,CAREER TRAINING SOLUTIONS               ,VA,22406-1014,Proprietary  ,24,162,186,119,540,659
03709300,EDWARD VIA VIRGINIA CLG OSTEOPATHIC MED ,VA,24060-6360,Private      ,1,38,39,4,1061,1065
03862600,VIRGINIA BAPTIST COLLEGE                ,VA,22407-0000,Private      ,13,29,42,37,88,125
03872400,INSTITUTE FOR THE PSYCHOLOGICAL SCIENCES,VA,22202-3609,Private      ,2,26,28,12,154,166
03876300,CULPEPER COSMETOLOGY TRAINING CENTER    ,VA,22701-3155,Public       ,7,12,19,23,39,62
03883400,AVIATION INSTITUTE OF MAINTENANCE       ,VA,20110-4156,Proprietary  ,13,49,62,69,193,262
03966300,VIRGINIA BEACH THEOLOGICAL SEMINARY     ,VA,23464-6847,Private      ,1,14,15,4,40,44
04038400,AVI CAREER INSTITUTE                    ,VA,22066-1839,Proprietary  ,3,28,31,4,54,58
04110300,UNIVERSITY OF MANAGEMENT AND TECHNOLOGY ,VA,22209-1609,Proprietary  ,6,124,130,25,443,468
04124000,DOMINION SCHOOL OF HAIR DESIGN          ,VA,23062-2221,Proprietary  ,4,9,13,14,33,47
04127300,COLUMBIA COLLEGE                        ,VA,22031-4413,Proprietary  ,19,301,320,44,473,517
04137300,CAYCE/REILLY SCHOOL OF MASSOTHERAPY     ,VA,23451-2061,Private      ,5,29,34,10,86,96
04140000,GLOBAL HEALTH NURSE TRAINING SERVICES   ,VA,22314-4585,Proprietary  ,4,96,100,42,525,567
04153800,BETHEL COLLEGE                          ,VA,23666-3122,Private      ,8,45,53,30,119,149
04156200,INSTITUTE OF ADVANCED MEDICAL ESTHETICS ,VA,23294-4701,Proprietary  ,7,19,26,20,82,102
04169400,NORTHERN VIRGINIA SCHOOL OF THERAPEUTIC ,VA,22046-4302,Proprietary  ,8,46,54,39,133,172
04171500,COSMOPOLITAN BEAUTY & TECH SCHOOL       ,VA,22003-3204,Proprietary  ,3,40,43,14,131,145
04179900,TOMORROW'S IMAGE BARBER ACADEMY OF VIRGI,VA,23602-5532,Proprietary  ,3,29,32,10,68,78
04180600,APPALACHIAN COLLEGE OF PHARMACY         ,VA,24631-9210,Private      ,2,40,42,21,251,272
04214700,LUCKES BEAUTY ACADEMY                   ,VA,23601-1303,Proprietary  ,5,32,37,23,82,105
04218600,VIRGINIA TECH CARILION SCHOOL OF MEDICIN,VA,24016-4950,Private      ,26,32,58,201,420,621
04219000,IGLOBAL UNIVERSITY                      ,VA,22003-2400,Proprietary  ,1,9,10,3,26,29
04220100,NATIONAL PERSONAL TRAINING INSTITUTE    ,VA,22182-2412,Proprietary  ,5,20,25,13,57,70
04220400,CHRYSM INSTITUTE OF ESTHETICS (THE)     ,VA,23462-3650,Proprietary  ,12,61,73,22,156,178
04221000,"STANDARD HEALTHCARE SERVICES, COLLEGE OF",VA,22046-4612,Proprietary  ,4,82,86,15,289,304
04235400,SAINT MICHAEL COLLEGE OF ALLIED HEALTH  ,VA,22309-2348,Proprietary  ,6,55,61,19,158,177
04238700,DERMAL SCIENCE INTERNATIONAL AESTHETICS ,VA,20190-5226,Proprietary  ,6,23,29,10,89,99
04241500,WAVE LEADERSHIP COLLEGE                 ,VA,23454-2140,Private      ,11,20,31,25,45,70
00107000,THUNDERBIRD SCHOOL OF GLOBAL MANAGEMENT ,AZ,85306-6000,Private      ,0,0,0,5,51,56
00107100,ARIZONA WESTERN COLLEGE                 ,AZ,85366-0000,Public       ,702,1009,1711,4440,4061,8501
00107200,COCHISE COLLEGE                         ,AZ,85607-6190,Public       ,280,748,1028,1621,2534,4155
00107300,EASTERN ARIZONA COLLEGE                 ,AZ,85552-0769,Public       ,301,435,736,1509,1302,2811
00107400,GRAND CANYON UNIVERSITY                 ,AZ,85017-3030,Proprietary  ,1791,21732,23523,21181,59637,80818
00107600,GLENDALE COMMUNITY COLLEGE              ,AZ,85302-3090,Public       ,2117,3092,5209,10306,12099,22405
00107700,MESA COMMUNITY COLLEGE                  ,AZ,85202-4866,Public       ,2327,4137,6464,9727,14140,23867
00107800,PHOENIX COLLEGE                         ,AZ,85013-4234,Public       ,1198,3010,4208,6275,11180,17455
00107900,YAVAPAI COLLEGE                         ,AZ,86301-3297,Public       ,296,797,1093,1868,3511,5379
00108100,ARIZONA STATE UNIV (ALL CAMPUSES)       ,AZ,85287-0412,Public       ,5299,10597,15896,63354,54440,117794
00108200,NORTHERN ARIZONA UNIVERSITY             ,AZ,86011-0001,Public       ,1796,2720,4516,30746,14635,45381
00108300,UNIVERSITY OF ARIZONA                   ,AZ,85721-0066,Public       ,2620,2851,5471,36624,16419,53043
00165701,MIDWESTERN UNIVERSITY                   ,AZ,85308-0000,Private      ,30,271,301,201,4286,4487
00446700,TUCSON COLLEGE                          ,AZ,85711-3781,Proprietary  ,58,151,209,202,476,678
00711300,ARIZONA CHRISTIAN UNIVERSITY            ,AZ,85032-7097,Private      ,170,163,333,1285,590,1875
00726600,PIMA COUNTY COMMUNITY COLLEGE           ,AZ,85709-1110,Public       ,2239,3827,6066,9678,13058,22736
00728300,CENTRAL ARIZONA COLLEGE                 ,AZ,85228-0000,Public       ,737,1043,1780,2801,3690,6491
00732911,ITT TECHNICAL INSTITUTE                 ,AZ,85282-9272,Proprietary  ,102,577,679,387,2074,2461
00732990,ITT TECHNICAL INSTITUTE                 ,AZ,85704-5829,Proprietary  ,156,691,847,529,2142,2671
00822100,UNIVERSAL TECHNICAL INSTITUTE           ,AZ,85323-7946,Proprietary  ,1529,1700,3229,12640,9839,22479
00824600,DINÉ COLLEGE                            ,AZ,86556-0126,Public       ,183,393,576,611,1066,1677
00830300,GATEWAY COMMUNITY COLLEGE               ,AZ,85034-1795,Public       ,645,1930,2575,3403,7024,10427
00830302,MARICOPA SKILL CENTER                   ,AZ,85034-0000,Public       ,96,309,405,406,1062,1468
00830400,SCOTTSDALE COMMUNITY COLLEGE            ,AZ,85250-0000,Public       ,755,1176,1931,3716,4148,7864
00886400,ARIZONA ACADEMY OF BEAUTY               ,AZ,85712-5021,Proprietary  ,11,53,64,64,154,218
01085800,AVALON SCHOOL OF COSMETOLOGY            ,AZ,85210-4010,Proprietary  ,127,238,365,432,751,1183
01168900,REFRIGERATION SCHOOL                    ,AZ,85034-0000,Proprietary  ,56,324,380,135,830,965
01180200,ARIZONA ACADEMY OF BEAUTY-NORTH         ,AZ,85705-2720,Proprietary  ,7,43,50,33,97,130
01186200,NORTHLAND PIONEER COLLEGE               ,AZ,86025-0610,Public       ,144,349,493,574,1378,1952
01186400,MOHAVE COMMUNITY COLLEGE                ,AZ,86409-1238,Public       ,301,864,1165,1159,2927,4086
01218400,INTERNATIONAL ACADEMY OF HAIR DESIGN    ,AZ,85282-6730,Proprietary  ,15,51,66,40,131,171
02065300,PRESCOTT COLLEGE                        ,AZ,86301-0000,Private      ,44,197,241,420,844,1264
02098800,UNIVERSITY OF PHOENIX                   ,AZ,85040-0000,Proprietary  ,3573,73184,76757,10062,183725,193787
02100500,UNIVERSAL TECHNICAL INSTITUTE           ,AZ,85027-0000,Proprietary  ,1396,1658,3054,11603,9751,21354
02100600,CARRINGTON COLLEGE                      ,AZ,85015-4096,Proprietary  ,475,1241,1716,1427,3893,5320
02113800,ROBERTO-VENN SCH OF LUTHIERY            ,AZ,85040-0000,Proprietary  ,8,12,20,30,44,74
02146600,SOUTH MOUNTAIN COMMUNITY COLLEGE        ,AZ,85040-0000,Public       ,606,1113,1719,2565,3660,6225
02160305,COLLINS COLLEGE                         ,AZ,85040-4000,Proprietary  ,13,52,65,66,184,250
02160306,INTERNATIONAL ACADEMY OF DESIGN AND TECH,AZ,85281-6705,Proprietary  ,4,17,21,33,78,111
02171500,WESTERN INTERNATIONAL UNIVERSITY        ,AZ,85021-0000,Proprietary  ,14,426,440,73,1118,1191
02177500,RIO SALADO COMMUNITY COLLEGE            ,AZ,85281-6948,Public       ,716,3948,4664,2589,12331,14920
02199900,AMERICAN INDIAN CLG-ASSEMBLIES GOD      ,AZ,85021-0000,Private      ,23,33,56,69,111,180
02217100,PIMA MEDICAL INSTITUTE                  ,AZ,85716-0000,Proprietary  ,1013,2515,3528,3018,7871,10889
02218800,BROOKLINE COLLEGE                       ,AZ,85021-5815,Proprietary  ,108,562,670,330,1787,2117
02218804,BROOKLINE COLLEGE - MESA                ,AZ,85204-4448,Proprietary  ,60,208,268,176,606,782
02218805,BROOKLINE COLLEGE - TUCSON              ,AZ,85711-5444,Proprietary  ,42,222,264,168,605,773
02263100,ANTHEM COLLEGE                          ,AZ,85014-4973,Proprietary  ,15,78,93,98,270,368
02280500,CHARLES OF ITALY BEAUTY COLLEGE         ,AZ,86403-0000,Proprietary  ,9,23,32,34,83,117
02295000,EVEREST COLLEGE                         ,AZ,85021-1610,Proprietary  ,22,163,185,242,2263,2505
02295002,EVEREST COLLEGE - MESA                  ,AZ,85206-4704,Proprietary  ,11,115,126,100,590,690
02306807,ARIZONA AUTOMOTIVE INSTITUTE            ,AZ,85301-3503,Proprietary  ,185,392,577,470,1200,1670
02317800,AMERICAN INSTITUTE OF TECHNOLOGY        ,AZ,85043-0000,Proprietary  ,40,365,405,180,850,1030
02491500,SOUTHWEST UNIVERSITY OF VISUAL ARTS     ,AZ,85716-0000,Proprietary  ,53,113,166,160,229,389
02533200,FRANK LLOYD WRIGHT SCHOOL OF ARCHITECTUR,AZ,85261-4430,Private      ,4,8,12,22,41,63
02559000,UNIVERSITY OF ADVANCING TECHNOLOGY      ,AZ,85283-0000,Proprietary  ,109,138,247,889,578,1467
02582700,CORTIVA INSTITUTE - TUCSON              ,AZ,85710-3503,Proprietary  ,38,91,129,85,243,328
02616700,LE CORDON BLEU COLLEGE OF CULINARY ARTS ,AZ,85251-2729,Proprietary  ,156,616,772,672,2791,3463
02623600,PARADISE VALLEY COMMUNITY COLLEGE       ,AZ,85032-1210,Public       ,785,1304,2089,3364,4396,7760
02623800,CORTIVA INSTITUTE - SCOTTSDALE          ,AZ,85257-4218,Proprietary  ,12,41,53,23,118,141
03005000,SAFFORD COLLEGE OF BEAUTY CULTURE       ,AZ,85546-3309,Proprietary  ,3,7,10,13,31,44
03010613,VIRGINIA COLLEGE - GOLF ACADEMY OF AMERI,AZ,85225-3412,Proprietary  ,3,22,25,27,86,113
03030604,UTAH COLLEGE OF MASSAGE THERAPY - ARIZON,AZ,85282-0000,Proprietary  ,29,69,98,63,174,237
03030605,UTAH COLLEGE OF MASSAGE THERAPY - ARIZON,AZ,85051-3470,Proprietary  ,40,86,126,89,224,313
03034400,CONSERVATORY RECORDING ARTS & SCIS      ,AZ,85282-1707,Proprietary  ,114,108,222,517,516,1033
03072200,CHANDLER-GILBERT COMMUNITY COLLEGE      ,AZ,85225-2499,Public       ,1283,1670,2953,5220,5561,10781
03076400,BRYMAN SCHOOL OF ARIZONA (THE)          ,AZ,85029-4919,Proprietary  ,5,45,50,32,180,212
03097800,CARSTEN INSTITUTE OF HAIR & BEAUTY      ,AZ,85282-5404,Proprietary  ,25,57,82,82,160,242
03100400,COCONINO COUNTY COMMUNITY COLLEGE       ,AZ,86001-0000,Public       ,322,523,845,1984,1848,3832
03107000,SOUTHWEST CLG OF NATUROPATHIC MED       ,AZ,85282-0000,Private      ,5,87,92,14,560,574
03115000,ARIZONA COLLEGE OF ALLIED HEALTH        ,AZ,85302-3843,Proprietary  ,134,448,582,340,1112,1452
03120300,COLLEGE AMERICA                         ,AZ,86004-3936,Proprietary  ,92,352,444,384,1325,1709
03156300,ESTRELLA MOUNTAIN COMMUNITY COLLEGE     ,AZ,85392-1010,Public       ,1146,1688,2834,5022,6152,11174
03347300,INTERNATIONAL BAPTIST COLLEGE           ,AZ,85282-6799,Private      ,17,10,27,41,28,69
03445300,HDS TRUCK DRIVING INSTITUTE             ,AZ,85731-0000,Proprietary  ,6,56,62,13,117,130
03478400,PHOENIX SEMINARY                        ,AZ,85018-7611,Private      ,1,28,29,8,166,174
03572300,EAST VALLEY INSTITUTE OF TECHNOLOGY     ,AZ,85201-6910,Public       ,74,165,239,338,574,912
03593300,SOUTHWEST INSTITUTE OF HEALING ARTS     ,AZ,85281-3658,Proprietary  ,34,440,474,145,1391,1536
03617500,PHOENIX INSTITUTE OF HERBAL MEDICINE & A,AZ,85012-0000,Proprietary  ,9,114,123,45,357,402
03695500,ARIZONA SCHOOL OF ACUPUNCTURE AND ORIENT,AZ,85712-1100,Proprietary  ,1,21,22,17,61,78
03784400,TOHONO O'ODHAM COMMUNITY COLLEGE        ,AZ,85634-3129,Public       ,23,39,62,77,106,183
03813300,NORTHCENTRAL UNIVERSITY                 ,AZ,86314-2336,Proprietary  ,15,2490,2505,67,7027,7094
03814300,TURNING POINT BEAUTY COLLEGE            ,AZ,85222-4229,Proprietary  ,8,22,30,20,53,73
04051300,ART INSTITUTE OF PHOENIX (THE)          ,AZ,85021-2859,Proprietary  ,1083,3030,4113,4423,12959,17382
04051306,ART INSTITUTE OF PHOENIX (THE) - ART INS,AZ,85712-2732,Proprietary  ,62,110,172,361,504,865
04051325,ART INSTITUTE OF PHOENIX (THE) - BROWN M,AZ,85712-5300,Proprietary  ,37,174,211,138,610,748
04051327,ART INSTITUTE OF PHOENIX (THE) - BROWN M,AZ,85029-1348,Proprietary  ,26,65,91,139,350,489
04059300,TUCSON COLLEGE OF BEAUTY                ,AZ,85705-2451,Proprietary  ,11,44,55,57,131,188
04120900,ARIZONA CULINARY INSTITUTE              ,AZ,85259-4939,Proprietary  ,26,74,100,172,285,457
04131400,ARIZONA SUMMIT LAW SCHOOL               ,AZ,85004-4418,Proprietary  ,10,267,277,61,1020,1081
04148700,AMERICAN INSTITUTE OF INTERIOR DESIGN   ,AZ,85268-3827,Proprietary  ,4,25,29,26,63,89
04152900,STUDIO ACADEMY OF BEAUTY (THE)          ,AZ,85224-3600,Proprietary  ,49,108,157,130,321,451
04157400,NATIONAL PARALEGAL COLLEGE              ,AZ,85014-1262,Proprietary  ,13,304,317,71,1245,1316
04174100,PAUL MITCHELL THE SCHOOL PHOENIX        ,AZ,85017-1919,Proprietary  ,40,82,122,159,284,443
04174200,ALL BEAUTY COLLEGE                      ,AZ,86426-8326,Proprietary  ,12,28,40,37,132,169
04175300,PENROSE ACADEMY                         ,AZ,85254-4065,Proprietary  ,35,52,87,100,173,273
04177500,PURE AESTHETICS                         ,AZ,85711-2328,Proprietary  ,6,34,40,25,86,111
04194500,AVEDA INSTITUTE TUCSON                  ,AZ,85719-4876,Proprietary  ,37,80,117,110,190,300
04194501,AVEDA INSTITUTE TUCSON - PHOENIX        ,AZ,85284-1064,Proprietary  ,39,76,115,111,203,314
04217600,SESSIONS COLLEGE FOR PROFESSIONAL DESIGN,AZ,85281-2840,Proprietary  ,6,57,63,20,170,190
04233100,ARIZONA SCHOOL OF INTEGRATIVE STUDIES   ,AZ,86324-3106,Proprietary  ,1,18,19,10,50,60
04233101,ARIZONA SCHOOL OF INTEGRATIVE STUDIES - ,AZ,86001-5510,Proprietary  ,5,20,25,29,71,100
04233102,ARIZONA SCHOOL OF INTEGRATIVE STUDIES - ,AZ,86303-4711,Proprietary  ,4,25,29,24,83,107
04233103,ARIZONA SCHOOL OF INTEGRATIVE STUDIES - ,AZ,85705-8330,Proprietary  ,7,26,33,31,109,140
04244900,SONORAN DESERT INSTITUTE                ,AZ,85258-3376,Proprietary  ,3,47,50,3,47,50
04246400,AVENTIS COLLEGE                         ,AZ,85282-1118,Proprietary  ,0,0,0,1,5,6
00142800,DELAWARE STATE UNIVERSITY               ,DE,19901-2277,Public       ,411,436,847,8084,2375,10459
00142900,GOLDEY BEACOM COLLEGE                   ,DE,19808-1993,Private      ,92,141,233,680,525,1205
00143100,UNIVERSITY OF DELAWARE                  ,DE,19716-0099,Public       ,896,486,1382,26327,3065,29392
00143300,WESLEY COLLEGE                          ,DE,19901-3875,Private      ,183,140,323,2848,837,3685
00331301,WIDENER UNIV SCHOOL OF LAW - DE         ,DE,19803-0000,Private      ,7,121,128,53,921,974
00705300,DELAWARE TECHNICAL COMMUNITY COLLEGE - O,DE,19947-0000,Public       ,10,25,35,10,25,35
00794800,WILMINGTON UNIVERSITY                   ,DE,19720-6491,Private      ,619,2861,3480,3174,10047,13221
01172700,DELAWARE TECHNICAL COMMUNITY COLLEGE    ,DE,19901-8736,Public       ,1269,2145,3414,7213,8773,15986
01172703,DELAWARE TECHNICAL COMMUNITY COLLEGE -  ,DE,19801-2412,Public       ,6,13,19,6,13,19
01172704,DELAWARE TECHNICAL COMMUNITY COLLEGE -  ,DE,19713-2197,Public       ,2,10,12,2,10,12
02125200,SCHOOL OF NURSING BEEBE MEDICAL CENTER  ,DE,19958-1462,Private      ,9,22,31,72,113,185
02190400,SCHILLING DOUGLAS SCH OF HAIR DSGN      ,DE,19711-0000,Proprietary  ,19,24,43,80,93,173
02586902,STAR TECHNICAL INSTITUTE -              ,DE,19901-4615,Proprietary  ,1,22,23,19,93,112
03025800,DAWN TRAINING CENTRE                    ,DE,19805-1511,Proprietary  ,33,149,182,97,431,528
03543300,HARRIS SCHOOL OF BUSINESS               ,DE,19803-5341,Proprietary  ,43,168,211,90,336,426
03702300,DELAWARE LEARNING INSTITUTE OF COSMETOLO,DE,19939-9759,Proprietary  ,13,22,35,36,83,119
04130700,ACADEMY OF MASSAGE AND BODYWORK         ,DE,19701-1321,Proprietary  ,8,25,33,26,77,103
04139800,DELAWARE COLLEGE OF ART & DESIGN        ,DE,19801-3007,Private      ,44,38,82,403,169,572
04171100,PAUL MITCHELL THE SCHOOL-DELAWARE       ,DE,19702-5108,Proprietary  ,37,34,71,96,109,205
        ,FEDERAL STUDENT AID USE ONLY            ,DC,20202-0000,,0,0,0,0,1,1
00143400,AMERICAN UNIVERSITY                     ,DC,20016-8020,Private      ,294,934,1228,13846,8737,22583
00143700,CATHOLIC UNIVERSITY OF AMERICA          ,DC,20064-0002,Private      ,215,481,696,5229,2272,7501
00143711,"CATHOLIC UNIV AMERICA, LAW SCHOOL       ",DC,20064-0000,Private      ,2,82,84,43,923,966
00144100,UNIV OF THE DISTRICT OF COLUMBIA        ,DC,20008-0000,Public       ,374,1298,1672,2719,5986,8705
00144102,UNIV OF THE DIST OF COLU -SCHOOL OF LAW ,DC,20008-1173,Public       ,6,105,111,73,831,904
00144300,GALLAUDET UNIVERSITY                    ,DC,20002-3695,Private      ,135,199,334,918,1093,2011
00144400,GEORGE WASHINGTON UNIVERSITY            ,DC,20052-2353,Private      ,546,1934,2480,14261,11087,25348
00144402,GEORGE WASHINGTON UNIV LAW SCHL         ,DC,20052-0000,Private      ,7,263,270,73,3657,3730
00144403,GEORGE WASHINGTON UNIV SCH MED          ,DC,20052-0000,Private      ,9,130,139,95,1564,1659
00144437,GEORGE WASHINGTON UNIVERSITY            ,DC,20006-4804,Private      ,0,0,0,524,281,805
00144500,GEORGETOWN UNIVERSITY                   ,DC,20057-1252,Private      ,367,811,1178,12255,4362,16617
00144501,"GEORGETOWN UNIV, SCH OF MEDICINE        ",DC,20007-0000,Private      ,6,77,83,67,1209,1276
00144502,GEORGETOWN UNIVERSITY - GRADUATE SCHOOL ,DC,20057-0004,Private      ,5,639,644,64,4073,4137
00144503,GEORGETOWN UNIV LAW CENTER              ,DC,20001-0000,Private      ,7,273,280,56,4787,4843
00144800,HOWARD UNIVERSITY                       ,DC,20059-0001,Private      ,696,987,1683,15580,8320,23900
00145900,STRAYER UNIVERSITY                      ,DC,20005-2603,Proprietary  ,498,10006,10504,1591,42036,43627
00146000,TRINITY UNIVERSITY                      ,DC,20017-1004,Private      ,109,617,726,1379,2373,3752
00146400,WESLEY THEOLOGICAL SEMINARY             ,DC,20016-0000,Private      ,0,71,71,0,352,352
00207701,JOHNS HOPKINS UNIV SCH ADV INTL STU     ,DC,20036-0000,Private      ,6,121,127,75,1368,1443
01280300,DOMINICAN HOUSE OF STUDIES              ,DC,20017-1584,Private      ,0,3,3,1,20,21
02132800,NAT'L CONSERVATORY DRAMATIC ARTS        ,DC,20007-2758,Private      ,3,9,12,15,48,63
03104300,CAREER BLAZERS LEARNING CENTER OF WASHIN,DC,20037-1881,Proprietary  ,31,301,332,54,607,661
03218300,POTOMAC COLLEGE                         ,DC,20016-1860,Proprietary  ,13,58,71,46,218,264
03409600,BENNETT CAREER INSTITUTE                ,DC,20017-1754,Proprietary  ,32,108,140,89,307,396
03750300,TECHNICAL LEARNING CENTERS              ,DC,20006-3749,Proprietary  ,60,272,332,141,639,780
04114400,INSTITUTE OF WORLD POLITICS (THE)       ,DC,20036-1464,Private      ,0,32,32,7,144,151
04142700,PONTIFICAL JOHN PAUL II INSTITUTE FOR ST,DC,20064-0001,Private      ,0,4,4,1,19,20
04190000,RADIANS COLLEGE                         ,DC,20005-3542,Proprietary  ,18,222,240,68,984,1052
04202500,GRADUATE SCHOOL                         ,DC,20024-2520,Private      ,1,45,46,8,125,133
00154100,ABRAHAM BALDWIN AGRICULTURAL CLG        ,GA,31794-0000,Public       ,544,406,950,3323,1553,4876
00154200,AGNES SCOTT COLLEGE                     ,GA,30030-3770,Private      ,55,94,149,1549,490,2039
00154300,DARTON COLLEGE                          ,GA,31707-3098,Public       ,972,1862,2834,3953,6415,10368
00154400,ALBANY STATE UNIVERSITY                 ,GA,31705-2796,Public       ,828,1332,2160,6470,4980,11450
00154500,ANDREW COLLEGE                          ,GA,39840-1395,Private      ,90,20,110,418,83,501
00154600,ARMSTRONG ATLANTIC STATE UNIVERSITY     ,GA,31419-1997,Public       ,805,1316,2121,6440,6072,12512
00154700,POINT UNIVERSITY                        ,GA,30344-1999,Private      ,228,226,454,1082,968,2050
00155400,BERRY COLLEGE                           ,GA,30149-5007,Private      ,167,67,234,3979,335,4314
00155500,THOMAS UNIVERSITY                       ,GA,31792-7499,Private      ,126,384,510,512,1288,1800
00155600,BRENAU UNIVERSITY                       ,GA,30501-3668,Private      ,174,815,989,1647,3509,5156
00155700,BREWTON PARKER COLLEGE                  ,GA,30445-0000,Private      ,106,50,156,503,167,670
00155800,COLLEGE OF COASTAL GEORGIA              ,GA,31520-3644,Public       ,484,634,1118,2468,2241,4709
00155900,CLARK ATLANTA UNIVERSITY                ,GA,30314-4385,Private      ,1028,1086,2114,10064,5279,15343
00156000,COLUMBIA THEOLOGICAL SEMINARY           ,GA,30031-0000,Private      ,4,48,52,9,226,235
00156100,COLUMBUS STATE UNIVERSITY               ,GA,31907-5645,Public       ,991,1552,2543,6751,6553,13304
00156200,GEORGIA PERIMETER COLLEGE               ,GA,30021-0000,Public       ,3705,5190,8895,15046,19696,34742
00156300,EMMANUEL COLLEGE                        ,GA,30639-0000,Private      ,138,48,186,938,160,1098
00156400,EMORY UNIVERSITY                        ,GA,30322-1960,Private      ,461,1197,1658,13747,9855,23602
00156600,FORT VALLEY STATE UNIVERSITY            ,GA,31030-3298,Public       ,530,677,1207,3815,2640,6455
00156800,INTERDENOMINATIONAL THEOLOGY CENTER     ,GA,30314-0000,Private      ,4,131,135,7,456,463
00156900,GEORGIA INSTITUTE OF TECHNOLOGY         ,GA,30332-0325,Public       ,1223,1105,2328,23900,6181,30081
00157100,GEORGIA MILITARY COLLEGE                ,GA,31061-3398,Public       ,1857,2434,4291,5539,6653,12192
00157200,GEORGIA SOUTHERN UNIVERSITY             ,GA,30460-8065,Public       ,2053,1556,3609,23261,7968,31229
00157300,GEORGIA SOUTHWESTERN STATE UNIV         ,GA,31709-4693,Public       ,343,463,806,2706,2151,4857
00157400,GEORGIA STATE UNIVERSITY                ,GA,30303-3010,Public       ,4583,5423,10006,34154,25962,60116
00157500,GORDON COLLEGE                          ,GA,30204-1762,Public       ,857,664,1521,4298,2578,6876
00157700,KENNESAW STATE UNIVERSITY               ,GA,30144-5591,Public       ,3766,3474,7240,30912,17148,48060
00157706,KENNESAW STATE UNIVERSITY - MARIETTA CAM,GA,30060-2855,Public       ,623,916,1539,4214,3187,7401
00157800,LAGRANGE COLLEGE                        ,GA,30240-2999,Private      ,141,114,255,1546,557,2103
00157900,GEORGIA REGENTS UNIVERSITY              ,GA,30912-0004,Public       ,567,950,1517,5304,6347,11651
00158000,MERCER UNIVERSITY                       ,GA,31207-0003,Private      ,584,1700,2284,6322,8471,14793
00158100,MIDDLE GEORGIA STATE COLLEGE            ,GA,31014-1599,Public       ,946,1201,2147,6160,5408,11568
00158200,MOREHOUSE COLLEGE                       ,GA,30314-3773,Private      ,443,290,733,4117,1274,5391
00158500,UNIVERSITY OF NORTH GEORGIA             ,GA,30597-0001,Public       ,1994,1117,3111,14568,5472,20040
00158600,OGLETHORPE UNIVERSITY                   ,GA,30319-2737,Private      ,152,126,278,2302,612,2914
00158700,PAINE COLLEGE                           ,GA,30901-3182,Private      ,214,180,394,1051,639,1690
00158800,PIEDMONT COLLEGE                        ,GA,30535-5644,Private      ,161,416,577,1270,1672,2942
00158900,REINHARDT UNIVERSITY                    ,GA,30183-2981,Private      ,210,160,370,1561,691,2252
00159000,SAVANNAH STATE UNIVERSITY               ,GA,31404-5298,Public       ,1223,965,2188,8166,3806,11972
00159100,SHORTER UNIVERSITY                      ,GA,30165-4298,Private      ,234,414,648,1797,1925,3722
00159200,SOUTH GEORGIA STATE COLLEGE             ,GA,31533-8104,Public       ,581,432,1013,2307,1503,3810
00159400,SPELMAN COLLEGE                         ,GA,30314-4399,Private      ,466,300,766,6314,1544,7858
00159600,TOCCOA FALLS COLLEGE                    ,GA,30598-0001,Private      ,158,91,249,838,269,1107
00159700,TRUETT MCCONNELL COLLEGE                ,GA,30528-1264,Private      ,128,76,204,856,237,1093
00159800,UNIVERSITY OF GEORGIA                   ,GA,30602-6114,Public       ,3687,1909,5596,32359,11217,43576
00159900,VALDOSTA STATE UNIVERSITY               ,GA,31698-0001,Public       ,1818,1651,3469,11820,6849,18669
00160000,WESLEYAN COLLEGE                        ,GA,31210-4407,Private      ,79,183,262,592,687,1279
00160100,UNIV OF WEST GEORGIA                    ,GA,30118-0002,Public       ,1802,1438,3240,14121,6642,20763
00160200,GEORGIA COLLEGE & STATE UNIVERSITY      ,GA,31061-0490,Public       ,873,520,1393,7611,2219,9830
00160400,YOUNG HARRIS COLLEGE                    ,GA,30582-4137,Private      ,169,29,198,1590,150,1740
00348400,COVENANT COLLEGE                        ,GA,30750-4164,Private      ,74,22,96,1227,113,1340
00395600,DALTON STATE COLLEGE                    ,GA,30720-3797,Public       ,574,610,1184,4422,3046,7468
00402400,GEORGIA NORTHWESTERN TECHNICAL COLLEGE  ,GA,30161-6757,Public       ,772,1592,2364,2682,5365,8047
00411700,GRADY HEALTH SYSTEM                     ,GA,30303-3050,Public       ,42,188,230,170,796,966
00489808,MCCANN SCHOOL OF BUSINESS & TECHNOLOGY -,GA,31210-0246,Proprietary  ,10,53,63,44,187,231
00525400,LANIER TECHNICAL COLLEGE                ,GA,30566-3499,Public       ,530,908,1438,1745,3357,5102
00525600,WIREGRASS GEORGIA TECHNICAL COLLEGE     ,GA,31602-0929,Public       ,583,1353,1936,1484,3886,5370
00551100,COASTAL PINES TECHNICAL COLLEGE         ,GA,31501-4016,Public       ,304,833,1137,739,1880,2619
00551102,COASTAL PINES TECHNICAL COLLEGE - JESUP ,GA,31545-4465,Public       ,0,0,0,68,257,325
00559900,AUGUSTA TECHNICAL COLLEGE               ,GA,30906-3399,Public       ,807,1951,2758,2140,5459,7599
00560000,ATHENS TECHNICAL COLLEGE                ,GA,30601-1579,Public       ,730,1153,1883,2676,3999,6675
00560100,ALBANY TECHNICAL COLLEGE                ,GA,31701-2648,Public       ,644,2218,2862,1613,5387,7000
00561500,SOUTHERN REGIONAL TECHNICAL COLLEGE     ,GA,31792-2622,Public       ,429,825,1254,1096,2406,3502
00561506,SOUTHERN REGIONAL TECHNL COLG - MOULTRIE,GA,31788-0000,Public       ,120,284,404,353,893,1246
00561700,SOUTH GEORGIA TECHNICAL COLLEGE         ,GA,31709-8167,Public       ,368,628,996,883,1330,2213
00561800,SAVANNAH TECHNICAL COLLEGE              ,GA,31405-5594,Public       ,836,2181,3017,2351,6445,8796
00561900,NORTH GEORGIA TECHNICAL COLLEGE         ,GA,30523-0000,Public       ,534,679,1213,1640,2241,3881
00562000,CHATTAHOOCHEE TECHNICAL COLLEGE         ,GA,30060-3398,Public       ,2002,3113,5115,5835,9681,15516
00562100,SOUTHERN CRESCENT TECHNICAL COLLEGE     ,GA,30223-2097,Public       ,899,1871,2770,2271,5363,7634
00562200,GEORGIA PIEDMONT TECHNICAL COLLEGE      ,GA,30021-2397,Public       ,510,1883,2393,1473,6064,7537
00562400,COLUMBUS TECHNICAL COLLEGE              ,GA,31904-6572,Public       ,679,1538,2217,1831,4340,6171
00576300,CENTRAL GEORGIA TECHNICAL COLLEGE       ,GA,31206-0000,Public       ,1333,3611,4944,2849,8115,10964
00854300,ATLANTA TECHNICAL COLLEGE               ,GA,30310-4499,Public       ,833,3393,4226,2749,10729,13478
00897600,CLAYTON STATE UNIVERSITY                ,GA,30260-0285,Public       ,1079,2133,3212,6415,8859,15274
00927000,ART INSTITUTE OF ATLANTA (THE)          ,GA,30328-1649,Proprietary  ,1254,1384,2638,5975,5238,11213
00950700,GEORGIA HIGHLANDS COLLEGE               ,GA,30162-0000,Public       ,1188,1030,2218,4957,3779,8736
00982806,EVEREST INSTITUTE - JONESBORO           ,GA,30236-0000,Private      ,29,156,185,90,478,568
00982807,EVEREST INSTITUTE - MARIETTA            ,GA,30067-8340,Private      ,43,191,234,116,591,707
00982808,EVEREST INSTITUTE - EVEREST COLLEGE- ATL,GA,30331-2620,Private      ,72,383,455,273,1183,1456
00982811,EVEREST INSTITUTE - NORCROSS            ,GA,30093-2813,Private      ,32,183,215,124,613,737
01031903,FORTIS INSTITUTE - FORTIS COLLEGE       ,GA,30080-7630,Proprietary  ,87,252,339,206,687,893
01048700,WEST GEORGIA TECHNICAL COLLEGE          ,GA,30182-6476,Public       ,945,1650,2595,3922,6612,10534
01077100,GUPTON JONES COLLEGE                    ,GA,30035-4022,Private      ,54,144,198,145,344,489
01099700,EAST GEORGIA COLLEGE                    ,GA,30401-2699,Public       ,814,427,1241,3229,1358,4587
01107400,BAINBRIDGE COLLEGE                      ,GA,39819-8400,Public       ,371,747,1118,1062,2183,3245
01157400,BAUDER COLLEGE                          ,GA,30313-2439,Proprietary  ,19,102,121,95,485,580
01205100,PRO WAY HAIR SCHOOL                     ,GA,30083-2884,Proprietary  ,32,137,169,68,260,328
01216500,ATLANTA METROPOLITAN COLLEGE            ,GA,30310-4498,Public       ,1045,2081,3126,3550,6855,10405
01246109,LINCOLN COLLEGE OF TECHNOLOGY - MARIETTA,GA,30067-8638,Proprietary  ,36,132,168,111,426,537
01303900,SOUTH UNIVERSITY                        ,GA,31406-4881,Proprietary  ,708,6517,7225,2136,17195,19331
02060900,BROWN CLG OF COURT REPORTING & M.T.     ,GA,30318-2570,Proprietary  ,14,123,137,41,422,463
02074800,LIFE UNIVERSITY                         ,GA,30060-0000,Private      ,130,462,592,688,2884,3572
02113613,AMERICAN INTERCONTINENTAL UNIVERSITY    ,GA,30328-1649,Proprietary  ,123,628,751,487,2362,2849
02116000,SANFORD-BROWN COLLEGE                   ,GA,30328-4803,Proprietary  ,23,131,154,141,713,854
02141500,SAVANNAH COLLEGE OF ART & DESIGN        ,GA,31402-3146,Private      ,1283,1000,2283,11162,4222,15384
02202800,AUGUSTA AREA DIET INTERN UNIV HOSP      ,GA,30901-0000,Private      ,4,23,27,19,90,109
02217200,PORTFOLIO CENTER                        ,GA,30309-0000,Proprietary  ,13,40,53,42,109,151
02266200,AMERICAN PROFESSIONAL INSTITUTE         ,GA,31201-3185,Private      ,9,45,54,38,190,228
02284300,INTERACTIVE COLLEGE OF TECHNOLOGY       ,GA,30341-0000,Proprietary  ,81,588,669,175,1364,1539
02284308,INTERACTIVE LEARNING SYSTEMS            ,GA,30260-0000,Proprietary  ,18,82,100,38,201,239
02284309,INTERACTIVE COLLEGE OF TECHNOLOGY       ,GA,30501-0000,Proprietary  ,26,117,143,89,300,389
02285500,"CREATIVE CIRCUS, THE                    ",GA,30324-0000,Proprietary  ,14,60,74,74,279,353
02288400,GWINNETT TECHNICAL COLLEGE              ,GA,30043-5702,Public       ,839,1874,2713,3783,8341,12124
02313902,WESTWOOD COLLEGE - O'HARE AIRPORT - ATLA,GA,30345-2807,Proprietary  ,22,157,179,113,622,735
02321400,ROFFLER-MOLER HAIRSTYLING COLLEGE       ,GA,30062-0000,Proprietary  ,20,29,49,53,104,157
02482100,MOREHOUSE SCHOOL OF MEDICINE            ,GA,30310-0000,Private      ,27,85,112,168,924,1092
02520000,INTERNATIONAL SCH SKIN & NAILCARE       ,GA,30342-1119,Proprietary  ,25,150,175,69,364,433
02559315,(UNITED EDUCATION INSTITUTE) - UEI MORRO,GA,30260-2941,Proprietary  ,28,91,119,45,216,261
02577000,PAUL MITCHELL THE SCHOOL - ESANI        ,GA,30076-1507,Proprietary  ,65,109,174,149,263,412
02577700,BEAUTY COLLEGE OF AMERICA               ,GA,30297-0000,Proprietary  ,16,60,76,57,137,194
02580200,ATLANTA SCHOOL OF MASSAGE               ,GA,30338-0000,Proprietary  ,45,213,258,154,665,819
02583000,GWINNETT COLLEGE OF BUSINESS            ,GA,30047-3447,Proprietary  ,28,174,202,105,642,747
02614206,MILLER - MOTTE TECHNICAL COLLEGE - COLUM,GA,31907-3222,Proprietary  ,84,408,492,205,1088,1293
02614207,MILLER - MOTTE TECHNICAL COLLEGE - AUGUS,GA,30907-0921,Proprietary  ,63,322,385,165,1002,1167
03005400,GEORGIA CAREER INSTITUTE                ,GA,30013-2076,Proprietary  ,88,231,319,225,605,830
03010619,VIRGINIA COLLEGE - AUGUSTA              ,GA,30909-5515,Proprietary  ,56,227,283,209,947,1156
03010623,VIRGINIA COLLEGE - MACON                ,GA,31206-3180,Proprietary  ,34,195,229,142,667,809
03022601,WESTERN CULINARY INSTITUTE - LE CORDON B,GA,30084-5893,Proprietary  ,99,259,358,467,1091,1558
03030000,OGEECHEE TECHNICAL COLLEGE              ,GA,30458-8049,Public       ,428,810,1238,1510,2725,4235
03042700,LAURUSTECHNICAL INSTITUTE               ,GA,30030-1506,Proprietary  ,0,0,0,16,95,111
03066500,SOUTHEASTERN TECHNICAL COLLEGE          ,GA,30474-8817,Public       ,258,495,753,738,1519,2257
03076300,BEULAH HEIGHTS BIBLE COLLEGE            ,GA,30316-1873,Private      ,11,298,309,35,716,751
03079202,WESTWOOD COLLEGE - ATLANTA MIDTOWN      ,GA,30309-2848,Proprietary  ,99,341,440,341,1148,1489
03089100,GEORGIA INSTITUTE OF COSMETOLOGY        ,GA,30606-3152,Proprietary  ,67,147,214,194,405,599
03090600,COBB BEAUTY COLLEGE                     ,GA,30144-2828,Proprietary  ,17,49,66,77,169,246
03100900,LUTHER RICE UNIVERSITY                  ,GA,30038-2454,Private      ,11,238,249,43,1015,1058
03102000,RIVERTOWN SCHOOL OF BEAUTY              ,GA,31904-4747,Proprietary  ,28,109,137,78,275,353
03104500,ATLANTA INSTITUTE OF MUSIC              ,GA,30096-4988,Proprietary  ,78,105,183,289,328,617
03116100,VOGUE BEAUTY AND BARBER SCHOOL          ,GA,30141-2226,Proprietary  ,15,77,92,57,225,282
03155500,OCONEE FALL LINE TECHNICAL COLLEGE      ,GA,31082-6179,Public       ,278,747,1025,537,1593,2130
03173300,ATLANTA'S JOHN MARSHALL LAW SCHOOL      ,GA,30309-0000,Proprietary  ,12,264,276,66,1436,1502
03418300,GWINNETT COLLEGE-SANDY SPRINGS          ,GA,30328-3161,Proprietary  ,30,109,139,90,324,414
03445500,FAYETTE BEAUTY ACADEMY                  ,GA,30214-1191,Proprietary  ,10,61,71,37,164,201
03523300,AVIATION INSTITUTE OF MAINTENANCE       ,GA,30096-5038,Proprietary  ,100,298,398,269,838,1107
03635300,CARVER BIBLE COLLEGE                    ,GA,30331-1300,Private      ,13,68,81,45,202,247
03804400,MEDTECH INSTITUTE                       ,GA,30339-6040,Proprietary  ,30,144,174,99,466,565
03812300,OMNITECH INSTITUTE                      ,GA,30035-1206,Proprietary  ,17,88,105,35,188,223
04021300,AUGUSTA SCHOOL OF MASSAGE               ,GA,30809-0000,Proprietary  ,3,22,25,15,71,86
04051331,ART INSTITUTE OF PHOENIX (THE) - BROWN M,GA,30319-3054,Proprietary  ,35,117,152,156,399,555
04142900,GEORGIA GWINNETT COLLEGE                ,GA,30043-7409,Public       ,1777,1255,3032,11857,7347,19204
04147000,PAUL MITCHELL THE SCHOOL ATLANTA        ,GA,30318-5241,Proprietary  ,106,184,290,377,632,1009
04147700,LAKE LANIER SCHOOL OF MASSAGE           ,GA,30501-4546,Proprietary  ,11,58,69,30,146,176
04149900,PROFILE INSTITUTE OF BARBER-STYLING     ,GA,30315-8459,Proprietary  ,15,91,106,41,248,289
04150900,PROCESS INSTITUTE OF COSMETOLOGY (THE)  ,GA,30043-7344,Proprietary  ,24,54,78,88,148,236
04152300,GEORGIA BEAUTY ACADEMY                  ,GA,30721-3952,Proprietary  ,20,51,71,72,148,220
04156500,GEORGIA CHRISTIAN UNIVERSITY            ,GA,30047-3778,Private      ,9,39,48,48,111,159
04160200,ATLANTA BEAUTY ACADEMY                  ,GA,30340-1334,Proprietary  ,14,93,107,86,283,369
04203800,WOODRUFF MEDICAL TRAINING AND TESTING   ,GA,30033-6103,Proprietary  ,12,83,95,33,249,282
04204500,ELAINE STERLING INSTITUTE(THE)          ,GA,30342-2633,Proprietary  ,11,81,92,40,201,241
04206400,HELMS COLLEGE                           ,GA,31206-5309,Private      ,30,132,162,98,337,435
04206600,SAE INSTITUTE OF TECHNOLOGY - ATLANTA   ,GA,30303-1736,Proprietary  ,103,219,322,349,620,969
04218000,UNITED MEDICAL AND BUSINESS INSTITUTE   ,GA,30344-6977,Proprietary  ,17,71,88,34,161,195
04221100,NEW HORIZONS MEDICAL INSTITUTE          ,GA,30071-2965,Proprietary  ,19,99,118,56,373,429
04242300,DALTON INSTITUTE OF ESTHETICS AND COSMET,GA,30720-8402,Proprietary  ,2,4,6,2,4,6
04245200,PACIFIC INSTITUTE OF TECHNOLOGY         ,GA,30260-1756,Proprietary  ,2,17,19,2,17,19
00149911,EVEREST COLLEGE - MERRIONETTE PARK      ,IL,60803-4517,Private      ,0,0,0,19,51,70
00162800,AMERICAN ACADEMY OF ART                 ,IL,60604-4302,Proprietary  ,52,65,117,875,343,1218
00163300,AUGUSTANA COLLEGE                       ,IL,61201-2296,Private      ,68,39,107,4651,284,4935
00163400,AURORA UNIVERSITY                       ,IL,60506-4892,Private      ,276,703,979,4514,3746,8260
00163600,SOUTHWESTERN ILLINOIS COLLEGE           ,IL,62221-5899,Public       ,997,1696,2693,4242,5743,9985
00163800,BLACK HAWK COLLEGE                      ,IL,61265-5899,Public       ,358,587,945,2501,2438,4939
00163900,BLACKBURN COLLEGE                       ,IL,62626-1498,Private      ,46,19,65,967,190,1157
00164000,PRAIRIE STATE COLLEGE                   ,IL,60411-8226,Public       ,601,1140,1741,3126,4673,7799
00164100,BRADLEY UNIVERSITY                      ,IL,61625-0002,Private      ,177,211,388,8430,1222,9652
00164300,SPOON RIVER COLLEGE                     ,IL,61520-8907,Public       ,94,135,229,797,811,1608
00164700,CITY COLLEGES OF CHICAGO                ,IL,60606-6998,Public       ,363,1114,1477,3878,6034,9912
00164800,TRUMAN COLLEGE                          ,IL,60640-5691,Public       ,413,1249,1662,2938,5313,8251
00164900,RICHARD J DALEY COLLEGE                 ,IL,60652-1299,Public       ,508,1020,1528,3642,4439,8081
00165000,CITY COLLEGES OF CHICAGO-MALCOLM X      ,IL,60612-3197,Public       ,708,2077,2785,4879,8752,13631
00165200,HAROLD WASHINGTON COLLEGE               ,IL,60601-2403,Public       ,1242,1967,3209,8945,8934,17879
00165400,KENNEDY KING COLLEGE                    ,IL,60621-3798,Public       ,477,1722,2199,2719,6825,9544
00165500,WRIGHT COLLEGE                          ,IL,60634-1591,Public       ,880,1389,2269,5984,6230,12214
00165700,MIDWESTERN UNIVERSITY                   ,IL,60515-1200,Private      ,4,143,147,118,3716,3834
00165900,ROSALIND FRANKLIN UNIVERSITY OF MEDICINE,IL,60064-3095,Private      ,5,110,115,69,2720,2789
00166100,CHICAGO THEOLOGICAL SEMINARY            ,IL,60637-0000,Private      ,4,57,61,20,261,281
00166300,SPERTUS COLLEGE                         ,IL,60605-1995,Private      ,0,4,4,1,41,42
00166400,UNIVERSITY OF ST FRANCIS                ,IL,60435-6188,Private      ,86,471,557,2081,2357,4438
00166500,COLUMBIA COLLEGE                        ,IL,60605-1996,Private      ,980,754,1734,13526,4817,18343
00166600,CONCORDIA UNIVERSITY                    ,IL,60305-1499,Private      ,72,780,852,3084,3785,6869
00166900,DANVILLE AREA COMMUNITY COLLEGE         ,IL,61832-5199,Public       ,179,412,591,870,1349,2219
00167100,DEPAUL UNIVERSITY                       ,IL,60604-2287,Private      ,839,1914,2753,24322,15018,39340
00167400,EASTERN ILLINOIS UNIVERSITY             ,IL,61920-3099,Public       ,543,441,984,10514,3326,13840
00167500,ELGIN COMMUNITY COLLEGE                 ,IL,60123-7193,Public       ,647,869,1516,4192,3724,7916
00167600,ELMHURST COLLEGE                        ,IL,60126-3296,Private      ,228,261,489,4091,1563,5654
00167800,EUREKA COLLEGE                          ,IL,61530-9976,Private      ,40,21,61,1180,177,1357
00168100,HIGHLAND COMMUNITY COLLEGE              ,IL,61032-9341,Public       ,143,227,370,913,870,1783
00168200,GARRETT-EVANGELICAL THEOLOGICAL SEM     ,IL,60201-0000,Private      ,0,52,52,3,186,189
00168400,GREENVILLE COLLEGE                      ,IL,62246-1199,Private      ,59,99,158,1587,461,2048
00168500,HEBREW THEOLOGICAL COLLEGE              ,IL,60077-3263,Private      ,28,1,29,450,28,478
00168800,ILLINOIS COLLEGE                        ,IL,62650-2299,Private      ,38,16,54,1833,233,2066
00168900,ILLINOIS COLLEGE OF OPTOMETRY           ,IL,60616-3878,Private      ,2,39,41,41,639,680
00169100,ILLINOIS INSTITUTE OF TECHNOLOGY        ,IL,60616-0000,Private      ,152,393,545,4044,2259,6303
00169103,CHICAGO KENT COLLEGE OF LAW             ,IL,60661-0000,Private      ,3,133,136,68,1405,1473
00169200,ILLINOIS STATE UNIVERSITY               ,IL,61790-1000,Public       ,1117,640,1757,24682,4949,29631
00169300,NORTHEASTERN ILLINOIS UNIV              ,IL,60625-4699,Public       ,436,1273,1709,7446,7981,15427
00169400,CHICAGO STATE UNIVERSITY                ,IL,60628-1598,Public       ,458,1682,2140,5668,10588,16256
00169600,ILLINOIS WESLEYAN UNIVERSITY            ,IL,61701-0000,Private      ,65,41,106,3342,240,3582
00169800,JOHN MARSHALL LAW SCHOOL                ,IL,60604-0000,Private      ,7,324,331,64,1868,1932
00169900,JOLIET JUNIOR COLLEGE                   ,IL,60431-8938,Public       ,868,1203,2071,7276,5719,12995
00170000,JUDSON UNIVERSITY                       ,IL,60123-1498,Private      ,45,181,226,1124,865,1989
00170100,KASKASKIA COLLEGE                       ,IL,62801-7878,Public       ,300,556,856,1407,1626,3033
00170300,KENDALL COLLEGE                         ,IL,60622-4278,Proprietary  ,80,279,359,944,1514,2458
00170400,KNOX COLLEGE                            ,IL,61401-4999,Private      ,35,8,43,2845,142,2987
00170500,ILLINOIS VALLEY COMMUNITY COLLEGE       ,IL,61348-9692,Public       ,154,304,458,1393,1374,2767
00170600,LAKE FOREST COLLEGE                     ,IL,60045-2399,Private      ,37,29,66,2634,262,2896
00170700,LEWIS UNIVERSITY                        ,IL,60446-2200,Private      ,239,675,914,6182,3652,9834
00170800,LINCOLN CHRISTIAN UNIVERSITY            ,IL,62656-2167,Private      ,31,118,149,428,580,1008
00170900,LINCOLN COLLEGE                         ,IL,62656-1699,Private      ,81,82,163,1296,628,1924
00171000,LOYOLA UNIVERSITY CHICAGO               ,IL,60626-0000,Private      ,528,1300,1828,19751,10445,30196
00171200,LUTHERAN SCHOOL OF THEOL AT CHICAGO     ,IL,60615-0000,Private      ,0,21,21,6,66,72
00171600,MACCORMAC COLLEGE                       ,IL,60602-4405,Private      ,12,52,64,62,242,304
00171700,MACMURRAY COLLEGE                       ,IL,62650-2590,Private      ,35,38,73,880,270,1150
00172100,MCCORMICK THEOLOGICAL SEMINARY          ,IL,60615-5108,Private      ,0,23,23,3,133,136
00172200,MCKENDREE UNIVERSITY                    ,IL,62254-1299,Private      ,123,332,455,2152,1460,3612
00172300,MEADVILLE LOMBARD THEOLOGICAL SCHOOL    ,IL,60637-1602,Private      ,0,7,7,0,112,112
00172400,MILLIKIN UNIVERSITY                     ,IL,62522-2084,Private      ,73,127,200,3152,833,3985
00172500,MONMOUTH COLLEGE                        ,IL,61462-1963,Private      ,34,18,52,2249,183,2432
00172700,MOODY BIBLE INSTITUTE                   ,IL,60610-3214,Private      ,247,406,653,2244,1872,4116
00172800,MORTON COLLEGE                          ,IL,60804-4398,Public       ,474,492,966,2801,2045,4846
00173200,NATIONAL UNIV OF HEALTH SCIENCES        ,IL,60148-4583,Private      ,4,139,143,49,789,838
00173300,NATIONAL-LOUIS UNIVERSITY               ,IL,60603-3032,Private      ,52,1263,1315,480,5534,6014
00173400,NORTH CENTRAL COLLEGE                   ,IL,60540-4690,Private      ,112,136,248,5136,878,6014
00173500,NORTH PARK UNIVERSITY                   ,IL,60625-4895,Private      ,178,362,540,3607,1954,5561
00173600,NORTHERN BAPTIST THEOL SEMINARY         ,IL,60148-0000,Private      ,0,20,20,2,75,77
00173700,NORTHERN ILLINOIS UNIVERSITY            ,IL,60115-2854,Public       ,1235,1409,2644,23162,9791,32953
00173900,NORTHWESTERN UNIV                       ,IL,60208-0001,Private      ,305,1210,1515,19424,9452,28876
00174100,OLIVET NAZARENE UNIVERSITY              ,IL,60914-2271,Private      ,172,571,743,4079,2552,6631
00174200,IL EASTERN COMM COLGS-OLNEY CENTRAL     ,IL,62450-1099,Public       ,56,129,185,529,533,1062
00174500,QUINCY UNIVERSITY                       ,IL,62301-2699,Private      ,49,62,111,1618,471,2089
00174600,ROBERT MORRIS UNIVERSITY ILLINOIS       ,IL,60605-1225,Private      ,320,767,1087,5407,4516,9923
00174700,ROCK VALLEY COLLEGE                     ,IL,61114-5699,Public       ,390,834,1224,3526,3997,7523
00174800,ROCKFORD UNIVERSITY                     ,IL,61108-2393,Private      ,86,228,314,1536,1185,2721
00174900,ROOSEVELT UNIVERSITY                    ,IL,60605-1394,Private      ,306,956,1262,5597,6018,11615
00175000,DOMINICAN UNIVERSITY                    ,IL,60305-1066,Private      ,102,276,378,4172,1907,6079
00175200,SAUK VALLEY COMMUNITY COLLEGE           ,IL,61021-9112,Public       ,165,246,411,1026,916,1942
00175300,SCHOOL OF ART INSTITUTE OF CHICAGO      ,IL,60603-3013,Private      ,208,233,441,4272,2335,6607
00175600,SHIMER COLLEGE                          ,IL,60616-3893,Private      ,16,7,23,100,59,159
00175700,SOUTHEASTERN ILLINOIS COLLEGE           ,IL,62946-4925,Public       ,74,174,248,620,707,1327
00175800,SOUTHERN ILL UNIV-CARBONDALE            ,IL,62901-0000,Public       ,849,1372,2221,18132,8042,26174
00175900,SOUTHERN ILL UNIV-EDWARDSVILLE          ,IL,62026-1060,Public       ,948,946,1894,14594,5989,20583
00175924,SO IL UNIV-SCHL OF DENTAL MEDICINE      ,IL,62002-0000,Public       ,4,29,33,12,197,209
00176500,UNIVERSITY OF ST MARY OF THE LAKE       ,IL,60060-0000,Private      ,1,4,5,4,17,21
00176700,BENEDICTINE UNIVERSITY                  ,IL,60532-0900,Private      ,203,690,893,3655,3590,7245
00176800,ST XAVIER UNIVERSITY                    ,IL,60655-3199,Private      ,196,471,667,6803,2981,9784
00176900,SOUTH SUBURBAN COLLEGE                  ,IL,60473-9978,Public       ,600,1338,1938,2938,5005,7943
00177100,TRINITY CHRISTIAN COLLEGE               ,IL,60463-0929,Private      ,55,133,188,1336,881,2217
00177200,TRINITY INTERNATIONAL UNIVERSITY        ,IL,60015-1283,Private      ,55,191,246,917,937,1854
00177300,TRITON COLLEGE                          ,IL,60171-1995,Public       ,868,1167,2035,4592,4540,9132
00177400,UNIVERSITY OF CHICAGO                   ,IL,60637-1476,Private      ,558,424,982,17985,3598,21583
00177401,UNIV OF CHICAGO PRITZKER SCH OF MED     ,IL,60637-0000,Private      ,4,47,51,76,585,661
00177403,"UNIV OF CHICAGO, BOOTH SCH OF BUS       ",IL,60637-0000,Private      ,12,307,319,114,1205,1319
00177405,UNIVERSITY OF CHICAGO GRADUATE          ,IL,60637-0000,Private      ,16,358,374,147,4417,4564
00177500,UNIV OF ILLINOIS @ URBANA-CHAMPAIGN     ,IL,61820-5796,Public       ,1018,873,1891,34270,8341,42611
00177600,UNIV OF ILLINOIS AT CHICAGO             ,IL,60607-0000,Public       ,1099,1966,3065,28751,17842,46593
00177800,VANDERCOOK COLLEGE OF MUSIC             ,IL,60616-3731,Private      ,14,9,23,166,99,265
00177900,IL EASTERN COMM COLGS-WABASH VALLEY     ,IL,62863-2699,Public       ,52,57,109,483,312,795
00178000,WESTERN ILLINOIS UNIVERSITY             ,IL,61455-1390,Public       ,625,639,1264,13644,4631,18275
00178100,WHEATON COLLEGE                         ,IL,60187-5535,Private      ,61,94,155,3019,535,3554
00178300,WORSHAM COLLEGE OF MORTUARY SCIENCE     ,IL,60090-2646,Proprietary  ,11,37,48,81,149,230
00396100,HARPER COLLEGE                          ,IL,60067-7398,Public       ,909,1159,2068,5752,4285,10037
00456000,GEM CITY COLLEGE                        ,IL,62301-4949,Proprietary  ,8,10,18,27,43,70
00456800,MIDSTATE COLLEGE                        ,IL,61614-3558,Proprietary  ,14,166,180,104,789,893
00621400,BLESSING RIEMAN COLLEGE OF NURSING      ,IL,62301-0000,Private      ,8,25,33,158,205,363
00621401,BLESSING HOSPITAL - SCHOOL OF MEDICAL LA,IL,62305-7005,Private      ,2,7,9,14,34,48
00621402,BLESSING HOSPITAL - SCHOOL OF RADIOLOGIC,IL,62305-7005,Private      ,1,12,13,22,38,60
00622500,TRINITY COLLEGE OF NURSING AND HEALTH SC,IL,61201-5317,Private      ,8,28,36,158,253,411
00622800,METHODIST COLLEGE                       ,IL,61603-3716,Private      ,18,73,91,301,587,888
00624000,ST FRANCIS MED CLG OF NRSG              ,IL,61603-3783,Private      ,15,61,76,359,518,877
00638500,CHAMBERLAIN COLLEGE OF NURSING          ,IL,60101-0000,Proprietary  ,380,5848,6228,2762,28908,31670
00665600,COLLEGE OF DUPAGE                       ,IL,60137-6599,Public       ,2062,2266,4328,12250,9088,21338
00675300,ILLINOIS CENTRAL COLLEGE                ,IL,61635-0001,Public       ,545,1125,1670,4231,4234,8465
00693100,WAUBONSEE COMMUNITY COLLEGE             ,IL,60554-0000,Public       ,625,883,1508,3587,3354,6941
00711800,PARKLAND COLLEGE                        ,IL,61821-1899,Public       ,530,723,1253,4228,3208,7436
00711900,REND LAKE COLLEGE                       ,IL,62846-9801,Public       ,158,261,419,1101,1033,2134
00717000,LINCOLN LAND COMMUNITY COLLEGE          ,IL,62794-9256,Public       ,336,754,1090,2837,3364,6201
00726500,CARL SANDBURG COLLEGE                   ,IL,61401-9576,Public       ,76,233,309,1154,1201,2355
00730307,LINCOLN COLLEGE OF TECHNOLOGY - MELROSE ,IL,60160-1605,Proprietary  ,81,108,189,630,455,1085
00754900,COYNE AMERICAN INSTITUTE                ,IL,60607-1300,Proprietary  ,74,218,292,320,864,1184
00764400,LAKE LAND COLLEGE                       ,IL,61938-9366,Public       ,194,451,645,2065,1857,3922
00768400,KISHWAUKEE COLLEGE                      ,IL,60150-9699,Public       ,347,356,703,2233,1818,4051
00769000,KANKAKEE COMMUNITY COLLEGE              ,IL,60901-6505,Public       ,261,594,855,1506,2093,3599
00769100,MCHENRY COUNTY COLLEGE                  ,IL,60012-2761,Public       ,408,455,863,2352,1938,4290
00769200,MORAINE VALLEY COMMUNITY COLLEGE        ,IL,60465-0937,Public       ,925,1069,1994,7387,5339,12726
00769300,SHAWNEE COMMUNITY COLLEGE               ,IL,62992-9725,Public       ,131,276,407,640,824,1464
00769400,COLLEGE OF LAKE COUNTY                  ,IL,60030-1198,Public       ,985,1346,2331,4817,4279,9096
00807600,JOHN A LOGAN COLLEGE                    ,IL,62918-2500,Public       ,298,549,847,1792,2068,3860
00809003,EVEREST COLLEGE - BEDFORD PARK          ,IL,60629-5819,Proprietary  ,2,21,23,40,95,135
00825900,EDUCATORS OF BEAUTY                     ,IL,61081-3611,Proprietary  ,1,1,2,26,27,53
00825901,EDUCATORS OF BEAUTY                     ,IL,61104-0000,Proprietary  ,3,0,3,45,46,91
00832800,ALVAREITA'S COLLEGE OF COSMETOLOGY      ,IL,62025-2041,Proprietary  ,0,0,0,29,36,65
00869402,RASMUSSEN COLLEGE - ROCKFORD            ,IL,61108-2513,Proprietary  ,26,231,257,190,1141,1331
00869403,RASMUSSEN COLLEGE - AURORA              ,IL,60506-6219,Proprietary  ,32,181,213,139,684,823
00869404,RASMUSSEN COLLEGE - ROMEOVILLE          ,IL,60446-0000,Proprietary  ,37,239,276,181,1032,1213
00869418,RASMUSSEN COLLEGE -  MOKENA             ,IL,60448-0000,Proprietary  ,16,123,139,63,558,621
00888000,MORRISON INSTITUTE OF TECHNOLOGY        ,IL,61270-2959,Private      ,4,6,10,128,37,165
00893800,GRAHAM HOSPITAL SCH OF NURSING          ,IL,61520-2497,Private      ,8,12,20,33,73,106
00893900,CANNELLA SCHOOL OF HAIR DESIGN          ,IL,60406-2130,Proprietary  ,9,19,28,32,69,101
00914500,GOVERNORS STATE UNIVERSITY              ,IL,60466-0975,Public       ,285,1160,1445,2836,7181,10017
00923200,CATHOLIC THEOLOGICAL UNION              ,IL,60615-0000,Private      ,0,18,18,7,53,60
00933300,UNIV OF ILLINOIS AT SPRINGFIELD         ,IL,62703-5407,Public       ,197,560,757,2920,3095,6015
00947500,EDUCATORS OF BEAUTY                     ,IL,61301-2404,Proprietary  ,0,0,0,20,23,43
00959500,CANNELLA SCHOOL OF HAIR DESIGN          ,IL,60617-4303,Proprietary  ,8,38,46,64,173,237
00976700,OLIVE-HARVEY COLLEGE                    ,IL,60628-1696,Public       ,375,972,1347,1936,4210,6146
00978600,IL EASTERN COMM COLGS-LINCOLN TRAIL     ,IL,62454-5708,Public       ,53,82,135,383,360,743
00980000,RUSH UNIVERSITY                         ,IL,60612-3806,Private      ,35,317,352,396,3296,3692
00989600,OAKTON COMMUNITY COLLEGE                ,IL,60016-1268,Public       ,501,736,1237,3914,3136,7050
00998700,SAINT ANTHONY COLLEGE OF NURSING        ,IL,61108-2468,Private      ,15,57,72,210,451,661
01002000,LEWIS AND CLARK COMMUNITY COLLEGE       ,IL,62035-2466,Public       ,574,666,1240,2316,2235,4551
01050100,LAKEVIEW  COLLEGE OF NURSING            ,IL,61832-3781,Private      ,8,38,46,213,318,531
01069500,TRI-COUNTY BEAUTY ACADEMY               ,IL,62056-2036,Proprietary  ,2,4,6,12,17,29
01071000,CAPITAL AREA SCH OF PRAC NRSG           ,IL,62707-0000,Public       ,8,115,123,65,438,503
01072700,DEVRY UNIVERSITY                        ,IL,60618-5994,Proprietary  ,1017,9234,10251,7445,57316,64761
01083600,PIVOT POINT ACADEMY                     ,IL,60626-0000,Proprietary  ,19,62,81,134,247,381
01087900,RICHLAND COMMUNITY COLLEGE              ,IL,62521-8513,Public       ,220,496,716,1133,1820,2953
01091303,ROCKFORD CAREER COLLEGE                 ,IL,61108-3900,Proprietary  ,66,230,296,321,986,1307
01181000,TAYLOR BUSINESS INSTITUTE               ,IL,60606-5111,Proprietary  ,15,44,59,45,155,200
01185800,EVEREST COLLEGE                         ,IL,60077-1074,Private      ,3,22,25,29,85,114
01185802,EVEREST COLLEGE - BURR RIDGE            ,IL,60527-7826,Private      ,1,10,11,15,42,57
01185803,EVEREST COLLEGE - MELROSE PARK          ,IL,60160-1526,Private      ,2,43,45,54,142,196
01236200,NORTHWESTERN COLLEGE                    ,IL,60630-2298,Proprietary  ,143,601,744,1550,3197,4747
01238500,BLOOMINGTON-NORMAL SCH RADIOGRAPHY      ,IL,61761-4604,Private      ,3,14,17,23,46,69
01258400,ILLINOIS INSTITUTE OF ART (THE)         ,IL,60654-1593,Proprietary  ,473,494,967,3513,2804,6317
01281300,JOHN WOOD COMMUNITY COLLEGE             ,IL,62305-0401,Public       ,167,322,489,1117,1201,2318
01308800,CAPRI OAK FOREST COLLEGE OF BEAUTY      ,IL,60452-2798,Proprietary  ,26,34,60,92,106,198
02055200,HARRINGTON COLLEGE OF DESIGN            ,IL,60606-3433,Proprietary  ,4,28,32,174,352,526
02068100,ADLER SCH OF PROFESSIONAL PSYCHLGY      ,IL,60601-0000,Private      ,8,285,293,98,1636,1734
02069300,VATTEROTT COLLEGE                       ,IL,62305-5938,Proprietary  ,9,53,62,65,220,285
02073200,TELSHE YESHIVA-CHICAGO                  ,IL,60625-0000,Private      ,7,2,9,41,11,52
02074400,IL EASTERN COMM COLGS-FRONTIER          ,IL,62837-0000,Public       ,24,69,93,170,260,430
02113600,AMERICAN INTERCONTINENTAL UNIVERSITY    ,IL,60192-3713,Proprietary  ,380,6161,6541,1092,20275,21367
02117400,BECK AREA CAREER CENTER                 ,IL,62278-0000,Public       ,3,31,34,27,136,163
02124400,UNIVERSITY OF SPA & COSMETOLOGY ART     ,IL,62704-0000,Proprietary  ,25,65,90,100,187,287
02150600,COSMETOLOGY AND SPA INSTITUTE (THE)     ,IL,60014-4003,Proprietary  ,34,58,92,87,143,230
02155300,THE CHICAGO SCHOOL OF PROF PSYCHOLOGY   ,IL,60610-4705,Private      ,17,841,858,93,5301,5394
02160300,INTERNATIONAL ACAD OF DESIGN & TECH     ,IL,60602-3319,Proprietary  ,15,40,55,155,212,367
02168600,EAST WEST UNIVERSITY                    ,IL,60605-0000,Private      ,42,127,169,1176,1166,2342
02179900,ARGOSY UNIVERSITY                       ,IL,60601-7757,Proprietary  ,1397,8589,9986,4696,24943,29639
02185400,ST AUGUSTINE COLLEGE                    ,IL,60640-0000,Private      ,85,287,372,674,1930,2604
02192400,MR JOHNS SCHOOL OF COSMETOLOGY          ,IL,62521-0000,Proprietary  ,12,22,34,28,76,104
02202600,CANNELLA SCHOOL OF HAIR DESIGN          ,IL,60181-1321,Proprietary  ,2,9,11,15,40,55
02214100,RESURRECTION UNIVERSITY                 ,IL,60302-2519,Private      ,8,110,118,251,893,1144
02228100,MAC DANIEL'S BEAUTY SCHOOL              ,IL,60640-0000,Proprietary  ,10,23,33,45,97,142
02261200,HAIR PROFESSIONALS ACAD COSMETOLOGY     ,IL,60118-0000,Proprietary  ,10,73,83,40,192,232
02261201,HAIR PROFESSIONALS ACADEMY OF COSMETOLOG,IL,60118-9333,Proprietary  ,2,8,10,4,15,19
02262100,HAIR PROFESSIONALS SCH COSMETOLOGY      ,IL,60543-0000,Proprietary  ,10,16,26,28,37,65
02291200,CANNELLA SCHOOL OF HAIR DESIGN          ,IL,60639-0000,Proprietary  ,8,28,36,53,147,200
02295500,CANNELLA SCHOOL OF HAIR DESIGN          ,IL,60120-0000,Proprietary  ,1,9,10,12,52,64
02297500,OEHRLEIN SCHOOL OF COSMETOLOGY          ,IL,61611-0000,Proprietary  ,9,31,40,49,81,130
02312300,LA' JAMES COLLEGE HAIRSTYLING           ,IL,61244-0000,Proprietary  ,1,10,11,12,42,54
02313900,WESTWOOD COLLEGE - O'HARE AIRPORT       ,IL,60631-2801,Proprietary  ,40,76,116,209,490,699
02317300,CONCEPT COLLEGE OF COSMETOLOGY          ,IL,61832-0000,Proprietary  ,17,32,49,30,87,117
02319200,LAKE FOREST GRAD SCHL OF MGMT           ,IL,60045-4824,Private      ,0,61,61,6,165,171
02323300,PROFESSIONAL'S CHOICE HAIR DSN ACAD     ,IL,60435-0000,Proprietary  ,11,11,22,33,47,80
02332200,HAIR PROFESSIONALS CAREER COLLEGE       ,IL,60178-0000,Proprietary  ,9,20,29,17,46,63
02349400,ALVAREITA'S COLLEGE OF COSMETOLOGY      ,IL,62035-0000,Proprietary  ,0,0,0,5,3,8
02349500,CANNELLA SCHOOL OF HAIR DESIGN          ,IL,60632-0000,Proprietary  ,15,52,67,103,210,313
02352200,LE CORDON BLEU COLLEGE OF CULINARY ARTS ,IL,60610-3050,Proprietary  ,109,316,425,708,1400,2108
02498200,G SKIN & BEAUTY INSTITUTE               ,IL,60523-1805,Proprietary  ,34,84,118,88,258,346
02498201,HAIR PROFESSIONALS ACADEMY OF COSMETOLOG,IL,60563-0000,Proprietary  ,4,13,17,15,38,53
02522800,FOX COLLEGE                             ,IL,60638-1999,Proprietary  ,40,53,93,390,475,865
02536700,BELL MAR BEAUTY COLLEGE                 ,IL,60650-0000,Proprietary  ,8,15,23,30,61,91
02556100,ENVIRONMENTAL TECHNICAL INSTITUTE       ,IL,60143-0000,Proprietary  ,20,74,94,43,168,211
02556600,NILES SCHOOL OF COSMETOLOGY             ,IL,60714-0000,Proprietary  ,5,20,25,14,40,54
02573700,INSTITUTE FOR CLINICAL SOCIAL WORK      ,IL,60605-1229,Private      ,3,47,50,44,241,285
02584900,"FIRST INSTITUTE, INC.                   ",IL,60014-7489,Proprietary  ,25,56,81,78,193,271
02587700,HAIR PROFESSIONALS CAREER COLLEGE       ,IL,60465-1929,Proprietary  ,11,30,41,38,72,110
02599716,VATTEROTT COLLEGE - FAIRVIEW HEIGHTS    ,IL,62208-2029,Proprietary  ,64,190,254,177,644,821
02622700,KNOWLEDGE SYSTEMS INSTITUTE             ,IL,60076-0000,Private      ,0,1,1,1,8,9
03002000,HAIRMASTERS INST OF COSMETOLOGY         ,IL,61701-5547,Proprietary  ,10,34,44,27,59,86
03027702,PACIFIC COLLEGE OF ORIENTAL MEDICINE - C,IL,60601-7296,Proprietary  ,5,44,49,15,214,229
03065300,TREND SETTERS COLL OF COSMETOLOGY       ,IL,60915-0000,Proprietary  ,9,26,35,43,74,117
03065301,PAUL MITCHELL THE SCHOOL TINLEY PARK    ,IL,60477-6273,Proprietary  ,39,60,99,150,208,358
03072701,WESTWOOD COLLEGE - RIVER OAKS           ,IL,60409-5503,Proprietary  ,19,104,123,136,481,617
03072702,WESTWOOD COLLEGE OF TECHNOLOGY          ,IL,60602-0000,Proprietary  ,31,134,165,219,750,969
03078400,CAMEO BEAUTY ACADEMY                    ,IL,60453-3196,Proprietary  ,13,34,47,43,90,133
03079200,WESTWOOD COLLEGE - DUPAGE               ,IL,60517-2321,Proprietary  ,24,62,86,126,304,430
03082900,ROSEL SCHOOL OF COSMETOLOGY             ,IL,60659-1913,Proprietary  ,6,60,66,42,117,159
03083800,HEARTLAND COMMUNITY COLLEGE             ,IL,61761-9446,Public       ,303,441,744,2501,1897,4398
03098000,ST JOHN'S COLLEGE OF NURSING            ,IL,62702-5321,Private      ,6,41,47,122,235,357
03098002,ST JOHN'S HOSP SCH MED TECH             ,IL,62769-5324,Private      ,1,19,20,21,67,88
03099700,CAIN'S BARBER COLLEGE                   ,IL,60615-3510,Proprietary  ,23,76,99,100,338,438
03099800,ILLINOIS SCHOOL OF HEALTH CAREERS       ,IL,60604-0000,Proprietary  ,0,0,0,132,330,462
03101800,ILLINOIS CENTER FOR BROADCASTING        ,IL,60148-7015,Proprietary  ,17,78,95,79,201,280
03128500,NATIONAL LATINO EDUCATION INSTITUTE     ,IL,60609-2205,Private      ,11,31,42,57,115,172
03199300,CHRISTIAN LIFE COLLEGE                  ,IL,60056-2522,Private      ,2,7,9,14,20,34
03368300,MIDWEST TECHNICAL INSTITUTE             ,IL,62707-8805,Proprietary  ,314,1058,1372,1037,2827,3864
03416300,COMPUTER SYSTEMS INSTITUTE              ,IL,60077-0000,Proprietary  ,128,436,564,358,1078,1436
03448300,BUSINESS INDUSTRIAL RESOURCES           ,IL,60659-1298,Proprietary  ,18,50,68,32,75,107
03455700,CORTIVA INSTITUTE - CHICAGO             ,IL,60602-3315,Proprietary  ,46,114,160,146,329,475
03455701,CORTIVA INSTITUTE - CHICAGO             ,IL,60014-6285,Proprietary  ,3,14,17,16,49,65
03490301,PAUL MITCHELL THE SCHOOL CHICAGO        ,IL,60607-0000,Proprietary  ,66,128,194,460,574,1034
03490302,PAUL MITCHELL THE SCHOOL ESCANABA - PAUL,IL,60148-0000,Proprietary  ,25,33,58,119,137,256
03510300,ERIKSON INSTITUTE                       ,IL,60654-4510,Private      ,0,23,23,7,330,337
03643300,"MR. JOHN'S SCHOOL OF JACKSONVILLE,  INC,",IL,62650-3488,Proprietary  ,6,5,11,16,19,35
03684300,NORTHSHORE UNIVERSITY HEALTHSYSTEM SCHOO,IL,60201-9872,Private      ,1,9,10,10,54,64
03881400,EUROPEAN MASSAGE THERAPY SCHOOL         ,IL,60077-2269,Proprietary  ,7,53,60,22,116,138
03891300,SOMA INSTITUTE - THE NATIONAL SCHOOL OF ,IL,60604-4466,Proprietary  ,15,49,64,38,120,158
03914300,"CALC, INSTITUTE OF TECHNOLOGY           ",IL,62002-5946,Proprietary  ,14,79,93,31,174,205
04117500,SOLEX MEDICAL ACADEMY                   ,IL,60090-3104,Proprietary  ,0,7,7,5,16,21
04117600,LARRY'S BARBER COLLEGE                  ,IL,60628-2322,Proprietary  ,20,106,126,104,368,472
04118400,CHICAGO ORT TECHNICAL INSTITUTE         ,IL,60077-3210,Private      ,15,83,98,55,221,276
04124700,AMBRIA COLLEGE OF NURSING               ,IL,60192-3712,Proprietary  ,30,215,245,121,824,945
04136900,UNIVERSITY OF AESTHETICS (THE)          ,IL,60622-2151,Proprietary  ,4,20,24,11,62,73
04137000,UNIVERSITY OF AESTHETICS & COSMETOLOGY (,IL,60515-4607,Proprietary  ,8,18,26,19,47,66
04137500,TRICOCI UNIVERSITY OF BEAUTY CULTURE    ,IL,60656-1805,Proprietary  ,32,64,96,206,285,491
04139000,MIDWESTERN CAREER COLLEGE               ,IL,60606-3103,Proprietary  ,23,191,214,65,535,600
04141000,AVEDA INSTITUTE CHICAGO                 ,IL,60647-0000,Proprietary  ,39,58,97,212,332,544
04147100,TRICOCI UNIVERSITY OF BEAUTY CULTURE    ,IL,60048-2906,Proprietary  ,28,34,62,97,117,214
04147200,TRICOCI UNIVERSITY OF BEAUTY CULTURE    ,IL,60455-1824,Proprietary  ,24,49,73,92,176,268
04147300,TRICOCI UNIVERSITY OF BEAUTY CULTURE    ,IL,60139-3119,Proprietary  ,24,17,41,101,110,211
04147400,TRICOCI UNIVERSITY OF BEAUTY CULTURE    ,IL,61614-4831,Proprietary  ,11,33,44,63,132,195
04147500,TRICOCI UNIVERSITY OF BEAUTY CULTURE    ,IL,61108-2337,Proprietary  ,16,31,47,80,143,223
04160600,PAUL MITCHELL THE SCHOOL NORMAL         ,IL,61761-0000,Proprietary  ,21,23,44,89,97,186
04167800,INNOVATIONS DESIGN ACADEMY              ,IL,61520-2625,Proprietary  ,4,16,20,20,54,74
04168500,SOLEX COLLEGE                           ,IL,60090-3192,Proprietary  ,6,72,78,15,175,190
04170800,UNITY COSMETOLOGY COLLEGE               ,IL,61764-9652,Proprietary  ,6,5,11,14,22,36
04174900,SKIN CARE AND SPA INSTITUTE             ,IL,60077-2200,Proprietary  ,6,41,47,14,100,114
04175000,UNIVERSAL SPA TRAINING ACADEMY          ,IL,60515-0000,Proprietary  ,8,38,46,24,114,138
04175800,J RENEE CAREER FACILITATION             ,IL,60014-7986,Proprietary  ,5,40,45,16,132,148
04179100,PCCTI  IT & HEALTHCARE                  ,IL,60523-0000,Proprietary  ,6,147,153,23,442,465
04187400,COSMETOLOGY CONCEPTS                    ,IL,60452-2501,Proprietary  ,29,86,115,79,214,293
04189200,SALON PROFESSIONAL ACADEMY (THE)        ,IL,60404-8789,Proprietary  ,14,11,25,35,51,86
04189400,SHEAR LEARNING ACADEMY OF COSMETOLOGY   ,IL,62523-1208,Proprietary  ,0,11,11,7,32,39
04189600,STATE CAREER SCHOOL                     ,IL,60085-5129,Proprietary  ,10,49,59,40,116,156
04192000,CURVE METRIC SCHOOL OF HAIR DESIGN      ,IL,60707-1118,Proprietary  ,4,10,14,10,33,43
04195600,TRIBECA FLASHPOINT MEDIA ARTS ACADEMY   ,IL,60602-2716,Proprietary  ,57,84,141,415,287,702
04224400,NETWORKS BARBER COLLEGE                 ,IL,60409-3401,Proprietary  ,5,12,17,12,33,45
04224500,TRENZ BEAUTY ACADEMY                    ,IL,60409-0000,Proprietary  ,6,23,29,17,63,80
04225300,CREATIVE TOUCH COSMETOLOGY SCHOOL       ,IL,62298-1609,Proprietary  ,1,5,6,7,13,20
04227900,MORTHLAND COLLEGE                       ,IL,62896-2742,Private      ,29,15,44,140,40,180
04229900,DEBUTANTES SCHOOL OF COSMETOLOGY AND NAI,IL,60115-3301,Proprietary  ,3,20,23,23,59,82
04232300,HVAC TECHNICAL INSTITUTE                ,IL,60632-4457,Proprietary  ,18,48,66,58,159,217
11072707,DEVRY UNIVERSITY - DOWNERS              ,IL,60515-0000,Proprietary  ,57,683,740,422,4668,5090
00195100,ALICE LLOYD COLLEGE                     ,KY,41844-9703,Private      ,31,23,54,1223,232,1455
00195200,ASBURY COLLEGE                          ,KY,40390-1198,Private      ,90,142,232,1721,699,2420
00195300,ASBURY THEOLOGICAL SEMINARY             ,KY,40390-0000,Private      ,0,295,295,18,1145,1163
00195400,BELLARMINE UNIVERSITY                   ,KY,40205-1877,Private      ,139,358,497,5464,1926,7390
00195500,BEREA COLLEGE                           ,KY,40403-0000,Private      ,61,77,138,3020,767,3787
00195800,BRESCIA UNIVERSITY                      ,KY,42301-3023,Private      ,32,168,200,1077,982,2059
00195900,CAMPBELLSVILLE UNIVERSITY               ,KY,42718-2799,Private      ,142,350,492,2835,1708,4543
00196000,SPALDING UNIVERSITY                     ,KY,40203-2188,Private      ,83,389,472,1462,2662,4124
00196100,CENTRE COLLEGE                          ,KY,40422-1394,Private      ,41,22,63,2481,142,2623
00196200,UNIVERSITY OF THE CUMBERLANDS           ,KY,40769-1372,Private      ,88,757,845,2649,3836,6485
00196300,EASTERN KENTUCKY UNIVERSITY             ,KY,40475-3102,Public       ,963,1793,2756,14655,10055,24710
00196400,GEORGETOWN COLLEGE                      ,KY,40324-1628,Private      ,89,219,308,1923,698,2621
00196500,KENTUCKY CHRISTIAN UNIVERSITY           ,KY,41143-2205,Private      ,50,58,108,1014,291,1305
00196800,KENTUCKY STATE UNIVERSITY               ,KY,40601-2355,Public       ,219,340,559,2720,1767,4487
00196900,KENTUCKY WESLEYAN COLLEGE               ,KY,42301-6057,Private      ,67,62,129,1350,365,1715
00197100,LEXINGTON THEOLOGICAL SEMINARY          ,KY,40508-0000,Private      ,0,17,17,7,68,75
00197200,LINDSEY WILSON COLLEGE                  ,KY,42728-1223,Private      ,72,241,313,2981,1687,4668
00197400,LOUISVILLE PRESBYTERIAN THEOL SEM       ,KY,40205-0000,Private      ,0,21,21,14,150,164
00197500,MIDWAY UNIVERSITY                       ,KY,40347-1120,Private      ,28,254,282,526,1375,1901
00197600,MOREHEAD STATE UNIVERSITY               ,KY,40351-1689,Public       ,627,968,1595,8345,4622,12967
00197700,MURRAY STATE UNIVERSITY                 ,KY,42071-0009,Public       ,584,752,1336,7800,4165,11965
00197900,WEST KENTUCKY CMNTY & TECHNICAL COLG    ,KY,42002-7380,Public       ,315,801,1116,2105,3548,5653
00198000,UNIVERSITY OF PIKEVILLE                 ,KY,41501-1194,Private      ,89,150,239,2412,1569,3981
00198300,ST. CATHARINE COLLEGE                   ,KY,40061-9499,Private      ,44,36,80,746,291,1037
00198700,TRANSYLVANIA UNIVERSITY                 ,KY,40508-1797,Private      ,30,39,69,2063,273,2336
00198800,UNION COLLEGE                           ,KY,40906-1499,Private      ,55,161,216,1269,674,1943
00198900,UNIVERSITY OF KENTUCKY                  ,KY,40506-0054,Public       ,1617,1466,3083,26196,9610,35806
00198901,UNIV OF KY-COLLEGE OF DENTISTRY         ,KY,40536-0000,Public       ,4,12,16,54,297,351
00198902,UNIV OF KY-COLLEGE OF MEDICINE          ,KY,40536-0000,Public       ,10,37,47,95,605,700
00199000,ASHLAND COMMUNITY AND TECHNICAL COLLEGE ,KY,41101-3683,Public       ,255,756,1011,1392,2562,3954
00199100,ELIZABETHTOWN COMMUNITY  AND TECHNICAL C,KY,42701-3081,Public       ,418,1057,1475,2549,4075,6624
00199300,HENDERSON COMMUNITY COLLEGE             ,KY,42420-4699,Public       ,100,317,417,639,1191,1830
00199400,HOPKINSVILLE COMMUNITY COLLEGE          ,KY,42241-2621,Public       ,174,955,1129,966,3387,4353
00199600,BIG SANDY COMMUNITY AND TECHNICAL COLG  ,KY,41653-1815,Public       ,252,674,926,2106,2872,4978
00199700,SOMERSET COMMUNITY COLLEGE              ,KY,42501-2973,Public       ,339,1195,1534,2840,5607,8447
00199800,SOUTHEAST KENTUCKY COMMUNITY AND TECHNIC,KY,40823-1099,Public       ,228,658,886,1247,2009,3256
00199900,UNIVERSITY OF LOUISVILLE                ,KY,40292-0000,Public       ,1097,1595,2692,16749,11704,28453
00200100,THOMAS MORE COLLEGE                     ,KY,41017-3495,Private      ,121,137,258,1625,705,2330
00200200,WESTERN KENTUCKY UNIVERSITY             ,KY,42101-3576,Public       ,1528,1735,3263,16496,8724,25220
00461800,SPENCERIAN COLLEGE                      ,KY,40216-2605,Proprietary  ,58,308,366,409,1256,1665
00461900,SULLIVAN UNIVERSITY                     ,KY,40205-3000,Proprietary  ,158,879,1037,1690,4650,6340
00493402,DAYMAR COLLEGE - BOWLING GREEN          ,KY,42101-4063,Proprietary  ,17,141,158,99,427,526
00493406,DAYMAR COLLEGE - RUSSELLVILLE           ,KY,42276-1622,Proprietary  ,7,24,31,15,76,91
00524400,BLUEGRASS COMMUNITY & TECHNICAL COLLEGE ,KY,40506-0235,Public       ,892,1952,2844,5475,8231,13706
00527100,BOWLING GREEN TECHNICAL COLLEGE         ,KY,42101-3601,Public       ,311,723,1034,1952,3154,5106
00527300,GATEWAY COMMUNITY & TECHNOLOGY COLL     ,KY,41011-0000,Public       ,340,948,1288,1656,3458,5114
00696000,MAYSVILLE CMNTY & TECHNCL COLG          ,KY,41056-8910,Public       ,205,682,887,1193,2612,3805
00696100,JEFFERSON COMMUNITY AND TECHNICAL COLLEG,KY,40202-2005,Public       ,1034,2212,3246,6693,11064,17757
00696200,HAZARD COMMUNITY COLLEGE                ,KY,41701-2402,Public       ,128,433,561,1281,2040,3321
00696203,KY TECH-KNOTT CO. TECHNOLOGY CTR        ,KY,41822-0000,Public       ,0,3,3,3,16,19
00696204,KY TECH-LESLIE COUNTY AREA TECH CTR     ,KY,41749-0000,Public       ,2,3,5,7,13,20
00696205,KY TECH-LEE COUNTY AREA TECH CTR        ,KY,41311-0000,Public       ,0,3,3,1,7,8
00696206,KY TECH-LETCHER CNTY AREA TECH CTR      ,KY,41858-0000,Public       ,8,24,32,26,63,89
00696207,KY TECH-BREATHITT COUNTY VOC ED CTR     ,KY,41339-0000,Public       ,1,15,16,17,51,68
00736205,MEDTECH COLLEGE - LEXINGTON             ,KY,40511-1200,Proprietary  ,28,185,213,124,640,764
00842500,DAYMAR COLLEGE                          ,KY,42001-0000,Proprietary  ,3,24,27,21,107,128
00901000,MADISONVILLE COMMUNITY COLLEGE          ,KY,42431-9199,Public       ,180,447,627,1053,1976,3029
00927500,NORTHERN KENTUCKY UNIVERSITY            ,KY,41099-0001,Public       ,957,1212,2169,11089,6608,17697
00931300,DAYMAR COLLEGE                          ,KY,42301-5830,Proprietary  ,10,135,145,56,654,710
00931302,DAYMAR COLLEGE - LOUISVILLE             ,KY,40219-1973,Proprietary  ,0,0,0,34,61,95
00931305,DAYMAR COLLEGE - BELLEVUE               ,KY,41073-2416,Proprietary  ,2,9,11,4,26,30
00931309,DAYMAR COLLEGE - LOUISVILLE EAST        ,KY,40245-1629,Proprietary  ,0,0,0,11,28,39
00931310,DAYMAR COLLEGE -  MADISONVILLE          ,KY,42431-0000,Proprietary  ,14,57,71,30,169,199
01042400,SALON PROFESSIONAL ACADEMY THE          ,KY,40502-0000,Proprietary  ,13,69,82,98,264,362
01048901,NATIONAL COLLEGE - FLORENCE CAMPUS      ,KY,41042-1812,Proprietary  ,3,33,36,32,167,199
01048902,NATIONAL COLLEGE - PIKEVILLE CAMPUS     ,KY,41501-1518,Proprietary  ,17,86,103,149,478,627
01048903,NATIONAL COLLEGE - DANVILLE CAMPUS      ,KY,40422-1517,Proprietary  ,3,51,54,32,228,260
01048904,NATIONAL COLLEGE - RICHMOND CAMPUS      ,KY,40475-2309,Proprietary  ,6,57,63,46,247,293
01048906,NATIONAL COLLEGE - LOUISVILLE CAMPUS    ,KY,40216-4147,Proprietary  ,13,101,114,82,520,602
01048907,NATIONAL COLLEGE - LEXINGTON CAMPUS     ,KY,40509-2256,Proprietary  ,6,88,94,59,418,477
01172500,COLLINS SCHOOL OF COSMETOLOGY           ,KY,40965-2809,Proprietary  ,3,18,21,25,49,74
01208800,SULLIVAN COLLEGE OF TECHNOLOGY AND DESIG,KY,40218-4528,Proprietary  ,65,173,238,529,766,1295
01272300,KY TECH-WAYNE COUNTY AREA TECH CTR      ,KY,42633-1088,Public       ,1,2,3,6,8,14
02159100,"APPALACHIAN BEAUTY SCHOOL, INC.         ",KY,41503-0000,Proprietary  ,4,23,27,29,67,96
02251500,TREND SETTERS ACAD OF BEAUTY CULT       ,KY,40258-0000,Proprietary  ,13,59,72,57,190,247
02275000,JENNY LEA ACADEMY OF COSMETOLOGY        ,KY,40831-0000,Proprietary  ,13,50,63,46,159,205
02284306,INTERACTIVE LEARNING SYSTEMS            ,KY,41042-0000,Proprietary  ,7,34,41,18,98,116
02323700,PAT WILSON'S BEAUTY COLLEGE             ,KY,42420-0000,Proprietary  ,1,26,27,3,60,63
02337200,PJ'S COLLEGE OF COSMETOLOGY             ,KY,42101-0000,Proprietary  ,26,90,116,110,372,482
02340800,PAUL MITCHELL THE SCHOOL LEXINGTON      ,KY,40514-1545,Proprietary  ,48,73,121,201,272,473
02351700,PAUL MITCHELL THE SCHOOL - LOUISVILLE   ,KY,40222-0000,Proprietary  ,33,69,102,200,301,501
02491100,BECKFIELD COLLEGE                       ,KY,41042-0000,Proprietary  ,65,460,525,245,1823,2068
02518900,BARRETT & COMPANY SCH HAIR DESIGN       ,KY,40356-0000,Proprietary  ,7,30,37,33,112,145
02526100,JENNY LEA ACADEMY OF COSMETOLOGY        ,KY,41858-0000,Proprietary  ,8,23,31,35,61,96
02535600,CLEAR CREEK BAPTIST BIBLE COLLEGE       ,KY,40977-0000,Private      ,9,43,52,48,121,169
02551100,PJ'S COLLEGE OF COSMETOLOGY             ,KY,42141-2434,Proprietary  ,13,12,25,44,66,110
02560800,SOUTHEAST SCHOOL OF COSMETOLOGY         ,KY,40962-0000,Proprietary  ,3,27,30,30,64,94
03002100,KENTUCKY MOUNTAIN BIBLE COLLEGE         ,KY,41385-0010,Private      ,12,12,24,51,33,84
03007000,FRONTIER SCH OF MIDWIFERY&FAMILY NU     ,KY,41749-0000,Private      ,0,478,478,10,1677,1687
03026200,HEAD'S WEST KENTUCKY BEAUTY COLLEGE     ,KY,42431-0000,Proprietary  ,6,24,30,22,80,102
03029200,NU-TEK ACADEMY OF BEAUTY                ,KY,40353-9767,Proprietary  ,4,8,12,14,30,44
03034500,OWENSBORO COMMUNITY & TECHNICAL COLLEGE ,KY,42303-1899,Public       ,223,558,781,1624,2196,3820
03083700,GALEN HEALTH INSTITUTES                 ,KY,40207-1047,Proprietary  ,208,1273,1481,936,5975,6911
03611300,BRIGHTON CENTER'S CENTER FOR EMPLOY     ,KY,41071-1968,Private      ,0,29,29,6,70,76
03804300,BELLEFONTE ACADEMY OF BEAUTY            ,KY,41169-2015,Proprietary  ,13,63,76,33,124,157
03885300,EMPLOYMENT SOLUTIONS                    ,KY,40517-3260,Private      ,17,71,88,60,270,330
04038300,ATA CAREER EDUCATION                    ,KY,40223-3832,Proprietary  ,59,247,306,192,911,1103
04038701,IDEAL BEAUTY ACADEMY - LOUISVILLE       ,KY,40223-5606,Proprietary  ,9,24,33,56,103,159
04051316,ART INSTITUTE OF PHOENIX (THE) - ATS - (,KY,41017-2136,Proprietary  ,5,16,21,31,154,185
04051319,ART INSTITUTE OF PHOENIX (THE) - BROWN M,KY,40219-1916,Proprietary  ,14,50,64,137,382,519
04051320,ART INSTITUTE OF PHOENIX (THE) - BROWN M,KY,42240-3579,Proprietary  ,8,47,55,34,220,254
04123900,LEXINGTON HEALING ARTS ACADEMY          ,KY,40503-1932,Proprietary  ,6,53,59,40,170,210
04177600,LINDSEY INSTITUTE OF COSMETOLOGY        ,KY,42103-8036,Proprietary  ,12,24,36,76,89,165
04177700,TRI-STATE INSTITUTE OF HAIR DESIGN      ,KY,40744-5234,Proprietary  ,4,35,39,29,110,139
04178000,SIMMONS COLLEGE OF KENTUCKY             ,KY,40203-3322,Private      ,34,101,135,100,282,382
04204800,AMERICAN COLLEGE OF BARBERING           ,KY,40229-2862,Proprietary  ,8,48,56,45,163,208
04229300,MEDQUEST COLLEGE                        ,KY,40243-1882,Proprietary  ,32,67,99,95,207,302
04240600,TRI-STATE BARBER COLLEGE                ,KY,41101-7746,Proprietary  ,1,5,6,1,5,6
04247700,REGINA WEBB ACADEMY                     ,KY,42104-4457,Proprietary  ,1,7,8,1,7,8
00200300,CENTENARY COLLEGE OF LOUISIANA          ,LA,71104-3396,Private      ,104,90,194,874,334,1208
00200400,DILLARD UNIVERSITY                      ,LA,70122-3097,Private      ,299,312,611,2783,1303,4086
00200500,NICHOLLS STATE UNIVERSITY               ,LA,70310-0001,Public       ,541,697,1238,5715,2796,8511
00200600,GRAMBLING STATE UNIVERSITY              ,LA,71245-2215,Public       ,885,1168,2053,4805,3852,8657
00200700,LOUISIANA COLLEGE                       ,LA,71359-0000,Private      ,178,165,343,1070,612,1682
00200800,LOUISIANA TECH UNIVERSITY               ,LA,71272-0001,Public       ,1339,823,2162,8786,2947,11733
00201000,LOUISIANA STATE UNIV & A&M COLG         ,LA,70803-5710,Public       ,2952,1733,4685,27470,8396,35866
00201100,LOUISIANA STATE UNIV-ALEXANDRIA         ,LA,71302-9121,Public       ,406,533,939,2383,2008,4391
00201200,LOUISIANA STATE UNIV-EUNICE             ,LA,70535-6726,Public       ,318,357,675,2078,1594,3672
00201300,LOUISIANA STATE UNIV-SHREVEPORT         ,LA,71115-2399,Public       ,560,1340,1900,2772,4371,7143
00201400,LA STATE UNIV HEALTH SCIENCES CTR       ,LA,70112-2223,Public       ,71,208,279,639,2515,3154
00201500,(THE) UNIVERSITY OF NEW ORLEANS         ,LA,70148-0001,Public       ,1134,1629,2763,6698,6334,13032
00201600,LOYOLA UNIVERSITY NEW ORLEANS           ,LA,70118-6195,Private      ,401,590,991,4463,2514,6977
00201700,MCNEESE STATE UNIVERSITY                ,LA,70609-4510,Public       ,583,752,1335,5926,3580,9506
00201900,NEW ORLEANS BAPTIST THEOL SEMINARY      ,LA,70126-0000,Private      ,7,70,77,59,231,290
00202000,UNIVERSITY OF LOUISIANA AT MONROE       ,LA,71209-9001,Public       ,832,1043,1875,7089,4541,11630
00202100,NORTHWESTERN STATE UNIVERSITY           ,LA,71497-0001,Public       ,816,1505,2321,5841,5315,11156
00202200,NOTRE DAME SEMINARY                     ,LA,70118-0000,Private      ,0,10,10,8,27,35
00202300,OUR LADY OF HOLY CROSS COLLEGE          ,LA,70131-7399,Private      ,118,408,526,670,1423,2093
00202400,SOUTHEASTERN LOUISIANA UNIV             ,LA,70402-0001,Public       ,1823,1354,3177,11300,5247,16547
00202500,SOUTHERN UNIVERSITY A & M COLLEGE       ,LA,70813-9374,Public       ,1296,1637,2933,8349,6615,14964
00202600,SOUTHERN UNIV NEW ORLEANS               ,LA,70126-0002,Public       ,532,1285,1817,2280,4364,6644
00202700,ST JOSEPH SEMINARY COLLEGE              ,LA,70457-9990,Private      ,24,12,36,63,18,81
00202900,TULANE UNIVERSITY                       ,LA,70118-5698,Private      ,559,958,1517,12730,6420,19150
00203100,UNIV OF LOUISIANA AT LAFAYETTE          ,LA,70504-0001,Public       ,2004,1448,3452,15921,6563,22484
00203200,XAVIER UNIVERSITY OF LOUISIANA          ,LA,70125-1098,Private      ,480,422,902,5099,1997,7096
00462100,AYERS CAREER COLLEGE                    ,LA,71108-5845,Proprietary  ,29,110,139,72,379,451
00462500,DELGADO COMMUNITY COLLEGE               ,LA,70119-0000,Public       ,2289,5099,7388,7712,16614,24326
00546700,SOWELA TECHNICAL COMMUNITY COLLEGE      ,LA,70616-6950,Public       ,420,618,1038,1665,1913,3578
00546702,SOWELA TECHNICAL COMMUNITY COLLEGE - MOR,LA,70546-1327,Public       ,21,41,62,97,119,216
00548800,CAPITAL AREA TECHNICAL COLLEGE          ,LA,70807-0000,Public       ,91,215,306,268,675,943
00548812,LOUISIANA TECH COLG-FOLKES CAMPUS       ,LA,70748-0000,Public       ,10,19,29,23,55,78
00548817,LOUISIANA TEC CLG-JUMONVILLE MEM CP     ,LA,70760-0000,Public       ,10,11,21,22,37,59
00548842,LOUISIANA TECHNICAL COLLEGE - WESTSIDE C,LA,70765-0733,Public       ,14,38,52,38,97,135
00548900,CENTRAL LOUISIANA TECHNICAL COLLEGE     ,LA,71302-3137,Public       ,203,480,683,574,1299,1873
00552600,SOUTH CENTRAL LOUISIANA TECHNICAL COLG  ,LA,70381-2148,Public       ,37,82,119,105,285,390
00552602,SOUTH CENTRAL LOUISIANA TECHNICAL COLG  ,LA,70302-4336,Public       ,30,68,98,106,239,345
00552603,SOUTH CENTRAL LOUISIANA TECHNICAL COLG  ,LA,70084-6632,Public       ,123,198,321,417,569,986
00576100,L. E. FLETCHER TECHNICAL COMMUNITY COLLE,LA,70360-2863,Public       ,281,368,649,1239,1205,2444
00675600,NORTHSHORE TECHNICAL COLLEGE            ,LA,70427-5866,Public       ,338,517,855,838,1188,2026
00768600,SOUTHERN UNIV AT SHREVEPORT/BOSSIER     ,LA,71107-4795,Public       ,570,1133,1703,1704,2812,4516
00806700,LSU HEALTH SCIENCES CENTR-SHREVEPOR     ,LA,71130-3932,Public       ,41,154,195,283,1096,1379
00989800,DEMMON SCHOOL OF BEAUTY                 ,LA,70607-2128,Proprietary  ,6,31,37,33,95,128
00997500,NORTHWEST LOUISIANA TECHNICAL COLLEGE   ,LA,71055-2422,Public       ,101,164,265,275,454,729
00997503,NORTHWEST LOUISIANA TECHNICAL COLLEGE   ,LA,71137-8527,Public       ,107,427,534,298,1061,1359
00997504,NORTHWEST LOUISIANA TECHNICAL COLLEGE   ,LA,71052-1236,Public       ,35,61,96,72,148,220
00997505,NORTHWEST LOUISIANA TECHNICAL COLLEGE   ,LA,71449-0790,Public       ,21,47,68,49,94,143
00997506,NORTHWEST LOUISIANA TECHNICAL COLLEGE   ,LA,71458-0657,Public       ,72,142,214,205,317,522
01109700,CLOYD'S BEAUTY SCHOOL #1                ,LA,71291-3131,Proprietary  ,10,34,44,38,113,151
01163100,"D-JAY'S SCHL OF BEAUTY, ARTS & SCI      ",LA,70806-0000,Proprietary  ,17,29,46,49,111,160
01184100,JOHN JAY BEAUTY COLLEGE                 ,LA,70124-2592,Proprietary  ,18,62,80,83,193,276
01282300,PAT GOINS RUSTON BEAUTY SCHOOL          ,LA,71270-4301,Proprietary  ,14,21,35,45,69,114
01287900,PAT GOINS BENTON ROAD BEAUTY SCHOOL     ,LA,71111-4838,Proprietary  ,7,35,42,22,97,119
01288000,CELEBRITY STYLIST BEAUTY SCHOOL         ,LA,71201-5167,Proprietary  ,13,29,42,38,88,126
01288001,CELEBRITY BARBER SCHOOL                 ,LA,71201-5133,Proprietary  ,6,15,21,6,18,24
02055400,BOSSIER PARISH COMMUNITY COLLEGE        ,LA,71111-0000,Public       ,1151,2220,3371,3388,5994,9382
02055500,DELTA SCH OF BUSINESS & TECHNOLOGY      ,LA,70601-0000,Proprietary  ,25,98,123,111,366,477
02117800,AVEDA INSTITUTE LAFAYETTE               ,LA,70503-3246,Proprietary  ,32,62,94,174,241,415
02166100,NUNEZ COMMUNITY COLLEGE                 ,LA,70043-0000,Public       ,308,814,1122,756,1892,2648
02166200,ITI TECHNICAL COLLEGE                   ,LA,70817-0000,Proprietary  ,181,304,485,535,855,1390
02197500,BATON ROUGE SCHOOL OF COMPUTERS         ,LA,70809-8188,Proprietary  ,20,32,52,79,147,226
02234000,CAMERON COLLEGE                         ,LA,70119-0000,Proprietary  ,25,132,157,64,313,377
02258400,AVEDA INSTITUTE BATON ROUGE             ,LA,70816-2246,Proprietary  ,52,86,138,214,260,474
02260200,DIESEL DRIVING ACADEMY                  ,LA,71109-5617,Proprietary  ,20,166,186,58,430,488
02265600,JOHN JAY KENNER ACADEMY                 ,LA,70062-0000,Proprietary  ,12,29,41,34,96,130
02269300,STEVENSON'S ACADEMY OF HAIR DESIGN      ,LA,70116-0000,Proprietary  ,15,63,78,43,179,222
02327800,PINEVILLE BEAUTY SCHOOL                 ,LA,71360-0000,Proprietary  ,10,23,33,58,67,125
02335700,BATON ROUGE GENERAL MEDICAL CENTER      ,LA,70806-3889,Private      ,19,51,70,96,155,251
02335701,BATON ROUGE GEN MED CTR SCH NSG         ,LA,70821-0000,Private      ,14,86,100,105,314,419
02335702,BATON ROUGE GEN MED CTR-RAD TECH        ,LA,70806-0000,Private      ,12,45,57,76,141,217
02338000,"CLOYD'S BEAUTY SCHOOL #2, INC           ",LA,71202-3539,Proprietary  ,9,38,47,36,105,141
02352500,"CLOYD'S BEAUTY SCHOOL #3, INC           ",LA,71201-3211,Proprietary  ,9,35,44,36,106,142
02358600,"STAGE ONE THE HAIR SCHOOL, INC.         ",LA,70605-0000,Proprietary  ,12,44,56,74,148,222
02518300,SOUTH LOUISIANA BEAUTY COLLEGE          ,LA,70363-0000,Proprietary  ,11,14,25,35,44,79
02536400,LOUISIANA ACADEMY OF BEAUTY             ,LA,70535-0000,Proprietary  ,9,23,32,36,53,89
02538300,DELTA COLLEGE OF ARTS & TECH INC        ,LA,70806-1529,Proprietary  ,66,162,228,215,588,803
02538301,DELTA COLLEGE OF ARTS & TECHNOLOGY - LAF,LA,70508-6831,Proprietary  ,29,120,149,129,388,517
02548500,COSMETOLOGY TRAINING CENTER             ,LA,70503-0000,Proprietary  ,22,40,62,85,129,214
02554800,VANGUARD COLLEGE OF COSMETOLOGY         ,LA,70458-8823,Proprietary  ,70,105,175,199,279,478
02582200,"GUY'S ACADEMY HAIR, SKIN & NAILS        ",LA,71105-2404,Proprietary  ,14,37,51,49,120,169
02600900,AVEDA INSTITUTE                         ,LA,70433-2922,Proprietary  ,315,519,834,1018,1495,2513
02601000,AMERICAN SCHOOL OF BUSINESS             ,LA,71105-5646,Proprietary  ,13,69,82,35,151,186
02601100,OPELOUSAS SCHOOL OF COSMETOLOGY         ,LA,70570-6156,Proprietary  ,9,18,27,32,63,95
02619200,DENHAM SPRINGS BEAUTY COLLEGE           ,LA,70726-3829,Proprietary  ,14,25,39,60,86,146
03010400,CRESCENT CITY SCH GAMING & BARTENDG     ,LA,70119-5507,Proprietary  ,32,273,305,98,628,726
03010624,VIRGINIA COLLEGE - BATON ROUGE          ,LA,70815-8604,Proprietary  ,42,139,181,155,536,691
03023500,CAMELOT CAREER COLLEGE                  ,LA,70805-7539,Proprietary  ,33,115,148,91,233,324
03026514,REMINGTON COLLEGE - LAFAYETTE           ,LA,70508-5760,Private      ,22,80,102,144,314,458
03026515,REMINGTON COLLEGE - BATON ROUGE         ,LA,70816-4040,Private      ,20,65,85,102,242,344
03027300,BLALOCK'S PROFESSIONAL BEAUTY COLLEGE   ,LA,71108-3246,Proprietary  ,1,23,24,21,59,80
03030900,DIESEL DRIVING ACADEMY                  ,LA,70815-8109,Proprietary  ,24,174,198,64,442,506
03106200,OUR LADY OF THE LAKE COLLEGE            ,LA,70808-4345,Private      ,169,495,664,1007,1760,2767
03294300,BLUE CLIFF SCH THERAPEUTIC MASSAGE      ,LA,70002-3458,Proprietary  ,286,1019,1305,595,2438,3033
03294303,BLUE CLIFF COLLEGE - LAFAYETTE          ,LA,70508-3256,Proprietary  ,26,90,116,121,323,444
03294306,BLUE CLIFF COLLEGE - SHREVEPORT         ,LA,71105-6520,Proprietary  ,43,196,239,107,501,608
03332600,DELTA COLLEGE                           ,LA,70433-9042,Proprietary  ,35,106,141,136,351,487
03332601,DELTA COLLEGE - SLIDELL                 ,LA,70460-2624,Proprietary  ,42,145,187,131,464,595
03356300,MEDICAL TRAINING COLLEGE                ,LA,70816-5820,Proprietary  ,57,109,166,162,327,489
03480300,FORTIS COLLEGE - BATON ROUGE            ,LA,70809-1908,Proprietary  ,51,155,206,156,538,694
03498400,OMEGA INSTITUTE OF COSMETOLOGY          ,LA,70360-0000,Proprietary  ,6,25,31,46,59,105
03727500,MOORE CAREER COLLEGE                    ,LA,70808-4191,Proprietary  ,5,35,40,29,105,134
03730300,BATON ROUGE COMMUNITY COLLEGE           ,LA,78806-4129,Public       ,1709,2276,3985,6113,7134,13247
03789300,UNITECH TRAINING ACADEMY                ,LA,70503-5132,Proprietary  ,86,198,284,279,722,1001
03789301,UNITECH TRAINING ACADEMY - WEST MONROE  ,LA,71291-2913,Proprietary  ,31,149,180,108,482,590
03789302,UNITECH TRAINING ACADEMY - HOUMA        ,LA,70363-5556,Proprietary  ,28,59,87,83,190,273
03789303,UNITECH TRAINING ACADEMY -  ALEXANDRIA  ,LA,71303-3625,Proprietary  ,24,108,132,113,329,442
03789304,UNITECH TRAINING ACADEMY - LAKE CHARLES ,LA,70601-7887,Proprietary  ,30,104,134,128,350,478
03789305,UNITECH TRAINING ACADEMY - METAIRIE     ,LA,70003-0000,Proprietary  ,15,82,97,15,82,97
03789400,RIVER PARISHES COMMUNITY COLLEGE        ,LA,70778-0310,Public       ,321,374,695,1015,1031,2046
03795300,CASSIA BEAUTY COLLEGE                   ,LA,70126-0000,Proprietary  ,3,19,22,23,71,94
03810500,COURT REPORTING INSTITUTE OF LOUISI     ,LA,70816-0000,Proprietary  ,2,18,20,11,61,72
03956300,SOUTH LOUISIANA COMMUNITY COLLEGE       ,LA,70506-0000,Public       ,933,1188,2121,3844,4458,8302
04040300,COMPASS CAREER COLLEGE                  ,LA,70403-0653,Proprietary  ,94,183,277,209,416,625
04112300,LOUISIANA CULINARY INSTITUTE            ,LA,70816-4109,Proprietary  ,41,61,102,230,288,518
04130100,LOUISIANA DELTA COMMUNITY COLLEGE       ,LA,71203-3618,Public       ,508,949,1457,1940,3248,5188
04149500,A & W HEALTHCARE EDUCATORS              ,LA,70122-3146,Proprietary  ,12,85,97,43,316,359
04151600,MY-LE'S BEAUTY COLLEGE                  ,LA,70056-3150,Proprietary  ,4,39,43,21,87,108
04217000,HEALTHCARE TRAINING INSTITUTE           ,LA,70062-7630,Proprietary  ,12,62,74,29,179,208
04225900,SETTING THE STANDARD BARBERING AND NATUR,LA,71109-4124,Proprietary  ,4,15,19,7,35,42
04226000,BOS-MAN'S BARBER COLLEGE                ,LA,71106-2653,Proprietary  ,9,33,42,28,89,117
04234600,PARK PLACE PREMIER BARBER SCHOOL        ,LA,70122-3808,Proprietary  ,10,27,37,24,88,112
04245400,INFINITY COLLEGE                        ,LA,70501-8833,Proprietary  ,6,60,66,12,70,82
04248400,ACADEMY OF INTERACTIVE ENTERTAINMENT    ,LA,70506-4293,Private      ,4,9,13,4,9,13
00143600,CAPITOL COLLEGE                         ,MD,20708-9759,Private      ,31,115,146,474,552,1026
00205700,ALLEGANY COLLEGE OF MARYLAND            ,MD,21502-2596,Public       ,267,373,640,2556,1818,4374
00205800,ANNE ARUNDEL COMMUNITY COLLEGE          ,MD,21012-1895,Public       ,1046,1973,3019,4877,7504,12381
00206100,BALTIMORE CITY COMMUNITY COLLEGE        ,MD,21215-7893,Public       ,586,2123,2709,3442,8795,12237
00206200,BOWIE STATE UNIVERSITY                  ,MD,20715-9465,Public       ,660,1096,1756,7125,5732,12857
00206300,COMMUNITY COLLEGE OF BALTIMORE COUNTY   ,MD,21228-5381,Public       ,1985,3972,5957,9435,15642,25077
00206400,COLLEGE OF SOUTHERN MARYLAND            ,MD,20646-0910,Public       ,650,1139,1789,3636,4505,8141
00206500,NOTRE DAME OF MARYLAND UNIVERSITY       ,MD,21210-2476,Private      ,52,290,342,1023,1864,2887
00206700,WASHINGTON ADVENTIST UNIVERSITY         ,MD,20912-7796,Private      ,113,191,304,691,808,1499
00206800,COPPIN STATE UNIVERSITY                 ,MD,21216-3698,Public       ,341,1002,1343,3557,5359,8916
00207100,FREDERICK COMMUNITY COLLEGE             ,MD,21702-9745,Public       ,376,646,1022,2125,2663,4788
00207200,FROSTBURG STATE UNIVERSITY              ,MD,21532-1099,Public       ,344,261,605,6667,1931,8598
00207300,GOUCHER COLLEGE                         ,MD,21204-2794,Private      ,74,157,231,3112,848,3960
00207400,HAGERSTOWN COMMUNITY COLLEGE            ,MD,21742-6514,Public       ,324,671,995,1931,2627,4558
00207500,HARFORD COMMUNITY COLLEGE               ,MD,21015-1696,Public       ,337,607,944,2489,2787,5276
00207600,HOOD COLLEGE                            ,MD,21701-8575,Private      ,74,138,212,2136,792,2928
00207700,JOHNS HOPKINS UNIVERSITY                ,MD,21218-2693,Private      ,169,394,563,9878,2385,12263
00207702,JOHNS HOPKINS UNIV SCH ARTS/SCI/ENG     ,MD,21218-0000,Private      ,108,597,705,5351,2381,7732
00207703,JOHNS HOPKINS UNIV SCH OF BUS/ED        ,MD,21046-0000,Private      ,10,227,237,81,1327,1408
00207705,JOHNS HOPKINS BLOOMBERG SCH OF PH       ,MD,21205-0000,Private      ,12,119,131,87,1629,1716
00207706,JOHNS HOPKINS UNIV SCH OF MEDICINE      ,MD,21205-0000,Private      ,37,74,111,335,997,1332
00207707,JOHNS HOPKINS UNIV SCH OF NURSING       ,MD,21205-0000,Private      ,31,227,258,317,1693,2010
00207708,JOHNS HOPKINS UNIV PEABODY CONSERV      ,MD,21202-2397,Private      ,18,47,65,510,429,939
00207764,JOHNS HOPKINS UNIVERSITY - CAREY BUSINES,MD,21202-4649,Private      ,4,187,191,53,872,925
00207800,LOYOLA UNIVERSITY MARYLAND              ,MD,21210-2699,Private      ,231,441,672,9695,2716,12411
00208000,MARYLAND INST COLLEGE OF ART            ,MD,21217-4191,Private      ,115,96,211,2573,946,3519
00208300,MORGAN STATE UNIVERSITY                 ,MD,21251-0002,Public       ,923,1304,2227,10748,6852,17600
00208600,MOUNT SAINT MARY'S UNIVERSITY           ,MD,21727-7799,Private      ,74,90,164,3922,528,4450
00208700,NER ISRAEL RABBINICAL COLLEGE           ,MD,21208-1198,Private      ,9,7,16,78,39,117
00208900,PRINCE GEORGES COMMUNITY COLLEGE        ,MD,20774-2199,Public       ,1283,2439,3722,6696,10803,17499
00209100,SALISBURY UNIVERSITY                    ,MD,21801-6862,Public       ,516,336,852,11173,2612,13785
00209200,ST JOHN'S COLLEGE                       ,MD,21404-0000,Private      ,17,34,51,504,165,669
00209500,ST. MARY'S COLLEGE OF MARYLAND          ,MD,20686-3001,Public       ,75,54,129,2459,354,2813
00209600,ST MARY'S SEMINARY & UNIV               ,MD,21210-1994,Private      ,2,7,9,26,61,87
00209900,TOWSON UNIVERSITY                       ,MD,21252-0002,Public       ,978,1013,1991,22938,8699,31637
00210200,UNIVERSITY OF BALTIMORE                 ,MD,21201-5779,Public       ,216,1125,1341,2345,7312,9657
00210300,"UNIVERSITY OF MARYLAND, COLLEGE PARK    ",MD,20742-5145,Public       ,1283,2028,3311,34689,13304,47993
00210400,"UNIVERSITY OF MARYLAND, BALTIMORE       ",MD,21201-1691,Public       ,243,1116,1359,4835,10497,15332
00210500,UMBC                                    ,MD,21250-0002,Public       ,575,906,1481,11101,6011,17112
00210600,UNIVERSITY MARYLAND EASTERN SHORE       ,MD,21853-4053,Public       ,387,309,696,5773,2369,8142
00210700,STEVENSON UNIVERSITY                    ,MD,21153-0641,Private      ,194,340,534,6627,2062,8689
00210800,WASHINGTON COLLEGE                      ,MD,21620-1197,Private      ,68,12,80,3033,124,3157
00210900,MCDANIEL COLLEGE                        ,MD,21157-4390,Private      ,53,104,157,3170,741,3911
00458612,KAPLAN COLLEGE                          ,MD,21742-2797,Proprietary  ,49,329,378,189,1597,1786
00465000,CHESAPEAKE COLLEGE                      ,MD,21679-0008,Public       ,169,324,493,1260,1448,2708
00691100,MONTGOMERY COLLEGE                      ,MD,20850-1195,Public       ,1668,2189,3857,12080,11809,23889
00734100,INTERNATIONAL BEAUTY SCHOOL             ,MD,21502-2370,Proprietary  ,0,0,0,4,12,16
00744700,DEL-MAR-VA BEAUTY ACADEMY               ,MD,21804-0000,Proprietary  ,9,30,39,41,112,153
00749100,TESST COLLEGE OF TECHNOLOGY             ,MD,21227-1063,Proprietary  ,86,269,355,291,1050,1341
00793600,LINCOLN TECHNICAL INSTITUTE             ,MD,21046-1544,Proprietary  ,122,193,315,459,695,1154
00817500,HOWARD COMMUNITY COLLEGE                ,MD,21044-3197,Public       ,671,1117,1788,4122,4935,9057
00826300,AWARD BEAUTY SCHOOL                     ,MD,21740-5624,Proprietary  ,23,116,139,49,193,242
00830800,CECIL COLLEGE                           ,MD,21901-1999,Public       ,197,343,540,1205,1388,2593
00907906,EVEREST COLLEGE- EVEREST INSTITUTE      ,MD,20910-3737,Private      ,0,0,0,38,159,197
01001400,GARRETT COMMUNITY COLLEGE               ,MD,21541-1265,Public       ,87,61,148,858,309,1167
01031900,FORTIS INSTITUTE                        ,MD,21204-2538,Proprietary  ,153,533,686,576,2258,2834
01041000,TESST COLLEGE OF TECHNOLOGY             ,MD,21286-2201,Proprietary  ,33,110,143,120,447,567
01164400,UNIV OF MARYLAND UNIVERSITY COLLEGE     ,MD,20783-8078,Public       ,534,9891,10425,2681,37067,39748
01164402,U OF MD UNIVERSITY COLLEGE - EUROPE     ,MD,20832-0000,Public       ,37,224,261,378,883,1261
01164404,U OF MD UNIVERSITY COLLEGE - ASIA       ,MD,31207-0000,Public       ,10,236,246,100,909,1009
02073900,WOR-WIC COMMUNITY COLLEGE               ,MD,21804-0000,Public       ,314,695,1009,1548,2378,3926
02083600,TESST COLLEGE OF TECHNOLOGY             ,MD,20705-2698,Proprietary  ,55,135,190,146,426,572
02127900,SOJOURNER-DOUGLASS COLLEGE              ,MD,21205-1802,Private      ,8,72,80,61,731,792
02155100,MARYLAND COLLEGE OF ART AND DESIGN      ,MD,20902-0000,Private      ,30,37,67,128,142,270
02269700,"COLORLAB ACADEMY OF HAIR, THE           ",MD,21014-3639,Proprietary  ,12,31,43,32,76,108
02331000,MARYLAND BEAUTY ACADEMY OF ESSEX        ,MD,21221-0000,Proprietary  ,13,71,84,62,192,254
02333000,HAIR ACADEMY                            ,MD,20784-0000,Proprietary  ,57,169,226,111,418,529
02343800,MONTGOMERY BEAUTY SCHOOL                ,MD,20901-0000,Proprietary  ,21,76,97,89,197,286
02494700,BALTIMORE STUDIO OF HAIR DESIGN         ,MD,21201-0000,Proprietary  ,14,80,94,80,247,327
02495000,ROBERT PAUL ACAD COSMTGY ARTS & SCI     ,MD,21093-0000,Proprietary  ,17,9,26,43,55,98
02495100,MARYLAND BEAUTY ACADEMY                 ,MD,21136-0000,Proprietary  ,4,23,27,18,60,78
02545400,NORTH AMERICAN TRADE SCHOOLS            ,MD,21244-0069,Proprietary  ,61,293,354,169,794,963
02573800,"L' ACADEMIE DE CUISINE, INC.            ",MD,20877-0000,Proprietary  ,10,42,52,62,214,276
02578400,MARYLAND UNIVERSITY OF INTEGRATIVE HEALT,MD,20723-6010,Private      ,7,251,258,34,802,836
03027200,BLADES SCHOOL OF HAIR DESIGN            ,MD,20619-0226,Proprietary  ,6,33,39,37,98,135
03064900,AARON'S ACADEMY OF BEAUTY               ,MD,20602-2715,Proprietary  ,10,20,30,37,108,145
03097200,AESTHETICS INSTITUTE OF COSMETOLOGY     ,MD,20877-1305,Proprietary  ,4,46,50,17,102,119
03100700,CARROLL COMMUNITY COLLEGE               ,MD,21157-6913,Public       ,253,297,550,1267,1286,2553
03148300,AMERICAN BEAUTY ACADEMY                 ,MD,20902-1911,Proprietary  ,114,331,445,198,574,772
03296300,BALTIMORE SCHOOL OF MASSAGE             ,MD,21090-2261,Proprietary  ,48,176,224,110,431,541
03327300,NEW CREATIONS ACADEMY OF HAIR DSN       ,MD,20746-0000,Proprietary  ,28,116,144,62,239,301
03493300,ALL-STATE CAREER SCHOOL                 ,MD,21224-6658,Proprietary  ,115,480,595,377,1515,1892
03667300,FAITH THEOLOGICAL SEMINARY              ,MD,21212-2624,Private      ,2,31,33,5,151,156
03822400,MAPLE SPRINGS BAPTIST BIBLE COLLEGE & SE,MD,20743-5711,Private      ,0,24,24,5,57,62
03937300,YESHIVA COLLEGE OF THE NATION'S CAPITAL ,MD,20902-1700,Private      ,5,5,10,13,27,40
03965500,HAIR EXPRESSIONS ACADEMY                ,MD,20852-1729,Proprietary  ,48,98,146,122,250,372
04139700,FREDERICK SCHOOL OF COSMETOLOGY         ,MD,21701-0000,Proprietary  ,8,12,20,25,57,82
04141600,OMEGA STUDIOS' SCHOOL OF APPLIED RECORDI,MD,20852-1731,Proprietary  ,21,29,50,56,111,167
04151800,TEMPLE (THE): A PAUL MITCHELL PARTNER SC,MD,21701-5409,Proprietary  ,41,59,100,148,201,349
04167602,FINGER LAKES SCHOOL OF MASSAGE (THE)    ,MD,21701-3030,Proprietary  ,4,36,40,18,100,118
04168900,HOLISTIC MASSAGE TRAINING INSTITUTE     ,MD,21218-2407,Proprietary  ,4,41,45,18,150,168
04171501,COSMOPOLITAN BEAUTY & TECH SCHOOL -     ,MD,20143-3370,Proprietary  ,5,17,22,21,65,86
04188400,BAIS HAMEDRASH AND MESIVTA OF BALTIMORE ,MD,21209-1613,Private      ,0,0,0,34,10,44
04204000,ASPEN BEAUTY ACADEMY - LAUREL           ,MD,20724-2013,Proprietary  ,4,32,36,28,107,135
04209600,INSTITUTE OF HEALTH SCIENCES            ,MD,21031-1408,Proprietary  ,6,47,53,25,174,199
04211700,HARMON'S BEAUTY SCHOOL                  ,MD,20785-2135,Proprietary  ,8,23,31,27,74,101
00211400,AMERICAN INTERNATIONAL COLLEGE          ,MA,01109-3189,Private      ,92,589,681,2109,2749,4858
00211500,AMHERST COLLEGE                         ,MA,01002-5000,Private      ,86,46,132,4535,312,4847
00211600,ANDOVER NEWTON THEOLOGICAL SCHOOL       ,MA,02459-0000,Private      ,0,22,22,0,171,171
00211700,ANNA MARIA COLLEGE                      ,MA,01612-1198,Private      ,54,178,232,1622,657,2279
00211800,ASSUMPTION COLLEGE                      ,MA,01615-1294,Private      ,110,110,220,4676,826,5502
00212000,MERRIMACK COLLEGE                       ,MA,01845-5800,Private      ,212,92,304,6794,707,7501
00212100,BABSON COLLEGE                          ,MA,02457-0310,Private      ,43,121,164,3033,524,3557
00212200,BAY PATH COLLEGE                        ,MA,01106-2212,Private      ,50,688,738,1157,3010,4167
00212300,BECKER COLLEGE-WORCESTER                ,MA,01615-0071,Private      ,157,202,359,2946,1081,4027
00212400,BENTLEY UNIVERSITY                      ,MA,02452-4705,Private      ,98,83,181,6388,634,7022
00212600,BERKLEE COLLEGE OF MUSIC                ,MA,02215-3693,Private      ,345,404,749,4168,1824,5992
00212800,BOSTON COLLEGE                          ,MA,02467-3800,Private      ,294,323,617,17757,5110,22867
00212900,BOSTON CONSERVATORY OF MUSIC            ,MA,02215-9830,Private      ,31,23,54,1087,355,1442
00213000,BOSTON UNIVERSITY                       ,MA,02215-1789,Private      ,576,1603,2179,36681,15274,51955
00213300,BRANDEIS UNIVERSITY                     ,MA,02453-2728,Private      ,76,132,208,6218,1278,7496
00213900,CLARK UNIVERSITY                        ,MA,01610-1473,Private      ,52,89,141,4790,717,5507
00214000,ELMS COLLEGE                            ,MA,01013-2839,Private      ,50,164,214,1306,1182,2488
00214100,COLLEGE OF THE HOLY CROSS               ,MA,01610-2395,Private      ,51,14,65,5287,169,5456
00214300,CURRY COLLEGE                           ,MA,02186-2395,Private      ,90,212,302,5052,1226,6278
00214400,DEAN COLLEGE                            ,MA,02038-1994,Private      ,121,63,184,1749,318,2067
00214500,EASTERN NAZARENE COLLEGE                ,MA,02170-2999,Private      ,85,104,189,844,561,1405
00214507,EASTERN NAZARENE COLLEGE - OLD COLONY CA,MA,02170-3831,Private      ,0,0,0,3,5,8
00214600,EMERSON COLLEGE                         ,MA,02116-4624,Private      ,152,85,237,7376,1247,8623
00214700,EMMANUEL COLLEGE                        ,MA,02115-5798,Private      ,53,58,111,5107,429,5536
00214800,ENDICOTT COLLEGE                        ,MA,01915-2098,Private      ,90,235,325,5183,916,6099
00214900,EPISCOPAL DIVINITY SCHOOL               ,MA,02138-0000,Private      ,0,7,7,0,51,51
00215000,FISHER COLLEGE                          ,MA,02116-1500,Private      ,130,376,506,1558,1428,2986
00215100,BENJAMIN FRANKLIN INSTITUTE OF TECH     ,MA,02116-6296,Public       ,79,78,157,640,387,1027
00215300,GORDON COLLEGE                          ,MA,01984-1899,Private      ,72,44,116,2239,195,2434
00215400,HELLENIC COLLEGE                        ,MA,02445-7496,Private      ,13,16,29,81,120,201
00215500,HARVARD UNIVERSITY                      ,MA,02138-3800,Private      ,82,116,198,3500,731,4231
00215501,AMRCN REPERTORY THTR INST ADV THTR      ,MA,02138-0000,Private      ,0,6,6,1,95,96
00215502,HARVARD BUSINESS SCHOOL                 ,MA,02163-0000,Private      ,18,150,168,234,1511,1745
00215503,HARVARD EXTENSION SCHOOL                ,MA,02138-0000,Private      ,26,350,376,203,1757,1960
00215504,HARVARD SCH OF DENTAL MEDICINE          ,MA,02115-0000,Private      ,5,26,31,19,178,197
00215505,HARVARD UNIV GRAD SCH DESIGN            ,MA,02138-0000,Private      ,2,27,29,13,866,879
00215506,HARVARD DIVINITY SCHOOL                 ,MA,02138-0000,Private      ,1,34,35,19,495,514
00215507,HARVARD UNIV GRAD SCH ED                ,MA,02138-0000,Private      ,0,41,41,11,1129,1140
00215508,HARVARD UNIV GRAD S OF ARTS & SCIEN     ,MA,02138-0000,Private      ,7,85,92,65,643,708
00215509,HARVARD KENNEDY SCHOOL                  ,MA,02138-0000,Private      ,2,39,41,17,1212,1229
00215510,HARVARD LAW SCHOOL                      ,MA,02138-0000,Private      ,14,80,94,114,2800,2914
00215511,HARVARD UNIV MEDICAL SCHOOL             ,MA,02115-0000,Private      ,27,60,87,160,984,1144
00215512,HARVARD UNIV SCH PUBLIC HEALTH          ,MA,02115-0000,Private      ,0,42,42,28,896,924
00215513,HARVARD UNIVERSITY-HARVARD COLLEGE      ,MA,02138-0000,Private      ,354,202,556,20800,1520,22320
00215700,HEBREW COLLEGE                          ,MA,02459-2237,Private      ,0,14,14,1,120,121
00215800,LASELL COLLEGE                          ,MA,02466-2716,Private      ,63,78,141,3111,525,3636
00216000,LESLEY UNIVERSITY                       ,MA,02138-2790,Private      ,119,546,665,2980,3088,6068
00216100,UMASS LOWELL                            ,MA,01854-3089,Public       ,848,1252,2100,15482,6121,21603
00216400,NEW ENGLAND COLLEGE OF OPTOMETRY        ,MA,02115-1129,Private      ,1,5,6,10,449,459
00216500,MASS. COLLEGE OF PHARMACY  & HEALTH SCIE,MA,02115-5804,Private      ,122,296,418,5488,4172,9660
00216700,BERKSHIRE COMMUNITY COLLEGE             ,MA,01201-5786,Public       ,106,218,324,930,1243,2173
00216800,CAPE COD COMMUNITY COLLEGE              ,MA,02668-1599,Public       ,291,503,794,1350,1862,3212
00216900,GREENFIELD COMMUNITY COLLEGE            ,MA,01301-9739,Public       ,171,302,473,813,1295,2108
00217000,HOLYOKE COMMUNITY COLLEGE               ,MA,01040-1099,Public       ,571,918,1489,3587,4043,7630
00217100,MASSACHUSETTS BAY COMMUNITY COLLEGE     ,MA,02181-0000,Public       ,413,582,995,2025,2402,4427
00217200,MOUNT WACHUSETT COMMUNITY COLLEGE       ,MA,01440-1000,Public       ,307,617,924,1898,2999,4897
00217300,NORTH SHORE COMMUNITY COLLEGE           ,MA,01923-4093,Public       ,754,1137,1891,3274,4154,7428
00217400,NORTHERN ESSEX COMMUNITY COLLEGE        ,MA,01830-2399,Public       ,754,1086,1840,3211,3874,7085
00217500,QUINSIGAMOND COMMUNITY COLLEGE          ,MA,01606-2092,Public       ,790,1345,2135,4154,5603,9757
00217600,BRISTOL COMMUNITY COLLEGE               ,MA,02720-7399,Public       ,863,1349,2212,4433,5588,10021
00217700,MASSASOIT COMMUNITY COLLEGE             ,MA,02302-3996,Public       ,840,1058,1898,3556,4146,7702
00217800,MASSACHUSETTS INST OF TECHNOLOGY        ,MA,02139-4307,Private      ,331,279,610,12091,2501,14592
00218000,MASSACHUSETTS COLLEGE OF ART AND DESIGN ,MA,02115-5803,Public       ,116,83,199,2332,706,3038
00218100,MASSACHUSETTS MARITIME ACADEMY          ,MA,02532-3400,Public       ,55,26,81,1755,167,1922
00218300,BRIDGEWATER STATE UNIVERSITY            ,MA,02325-0001,Public       ,635,567,1202,11705,3855,15560
00218400,FITCHBURG STATE UNIVERSITY              ,MA,01420-2697,Public       ,205,282,487,6454,1703,8157
00218500,FRAMINGHAM STATE COLLEGE                ,MA,01702-2471,Public       ,193,251,444,6714,1634,8348
00218700,MASSACHUSETTS CLG OF LIBERAL ARTS       ,MA,01247-4100,Public       ,90,68,158,2507,535,3042
00218800,SALEM STATE UNIVERSITY                  ,MA,01970-5353,Public       ,487,621,1108,9256,4026,13282
00218900,WESTFIELD STATE UNIVERSITY              ,MA,01086-1630,Public       ,300,303,603,8109,1996,10105
00219000,WORCESTER STATE COLLEGE                 ,MA,01602-2597,Public       ,267,344,611,6455,2517,8972
00219200,MOUNT HOLYOKE COLLEGE                   ,MA,01075-1492,Private      ,30,30,60,2716,382,3098
00219300,MOUNT IDA COLLEGE                       ,MA,02459-3323,Private      ,60,58,118,1893,426,2319
00219400,NEW ENGLAND CONSERVATORY OF MUSIC       ,MA,02115-5018,Private      ,17,15,32,697,566,1263
00219700,NICHOLS COLLEGE                         ,MA,01571-6346,Private      ,85,74,159,2181,348,2529
00219900,NORTHEASTERN UNIVERSITY                 ,MA,02115-5000,Private      ,618,1814,2432,31311,11567,42878
00220100,PINE MANOR COLLEGE                      ,MA,02167-0000,Private      ,32,13,45,452,129,581
00220200,BLESSED JOHN XXIII NATIONAL SEMINARY    ,MA,02493-0000,Private      ,0,1,1,0,1,1
00220500,QUINCY COLLEGE                          ,MA,02169-4324,Public       ,478,1026,1504,1889,3887,5776
00220600,REGIS COLLEGE                           ,MA,02193-0000,Private      ,95,133,228,2103,869,2972
00220800,SIMMONS COLLEGE                         ,MA,02115-5898,Private      ,65,837,902,3519,5497,9016
00220900,SMITH COLLEGE                           ,MA,01063-2936,Private      ,53,27,80,3822,479,4301
00220901,"SMITH COLLEGE, SCH FOR SOCIAL WORK      ",MA,01063-0000,Private      ,1,11,12,14,476,490
00221000,UNIV OF MASSACHUSETTS-DARTMOUTH         ,MA,02747-2300,Public       ,352,418,770,11806,3557,15363
00221100,SPRINGFIELD COLLEGE                     ,MA,01109-3797,Private      ,168,1069,1237,4733,4120,8853
00221400,ST JOHN'S SEMINARY                      ,MA,02135-8839,Private      ,2,19,21,3,45,48
00221700,STONEHILL COLLEGE                       ,MA,02357-6110,Private      ,63,20,83,5624,206,5830
00221800,SUFFOLK UNIVERSITY                      ,MA,02108-2770,Private      ,161,301,462,7564,3822,11386
00221900,TUFTS UNIVERSITY                        ,MA,02155-5808,Private      ,84,166,250,10726,2182,12908
00221901,TUFTS UNIV SCH OF DENTAL MEDICINE       ,MA,02111-0000,Private      ,4,31,35,23,885,908
00221902,TUFTS UNIVERSITY - CUMMINGS SCHOOL OF VE,MA,01536-0000,Private      ,3,10,13,30,489,519
00221904,TUFTS UNIV SCHOOL OF MEDICINE           ,MA,02111-0000,Private      ,6,149,155,80,2078,2158
00222100,UNIV OF MASSACHUSETTS-AMHERST           ,MA,01003-0000,Public       ,1284,852,2136,40402,7115,47517
00222200,UNIV OF MASSACHUSETTS-BOSTON            ,MA,02125-3393,Public       ,664,1624,2288,13222,10239,23461
00222400,WELLESLEY COLLEGE                       ,MA,02481-8203,Private      ,75,19,94,3441,226,3667
00222500,WENTWORTH INSTITUTE OF TECHNOLOGY       ,MA,02115-5998,Private      ,225,194,419,6575,958,7533
00222600,WESTERN NEW ENGLAND UNIVERSITY          ,MA,01119-2654,Private      ,126,204,330,5975,1648,7623
00222700,WHEATON COLLEGE                         ,MA,02766-2322,Private      ,54,5,59,2678,89,2767
00222800,WHEELOCK COLLEGE                        ,MA,02215-4176,Private      ,63,82,145,1524,738,2262
00222900,WILLIAMS COLLEGE                        ,MA,01267-2600,Private      ,44,3,47,3742,138,3880
00223300,WORCESTER POLYTECHNIC INSTITUTE         ,MA,01609-2280,Private      ,113,98,211,8125,650,8775
00267104,BARD COLLEGE - LONGY SCHOOL OF MUSIC    ,MA,02138-3599,Private      ,2,12,14,26,136,162
00396500,BAY STATE COLLEGE                       ,MA,02116-2901,Proprietary  ,81,194,275,957,1212,2169
00396600,BOSTON ARCHITECTURAL COLLEGE            ,MA,02115-2795,Private      ,35,130,165,241,601,842
00466100,HAMPSHIRE COLLEGE                       ,MA,01002-3359,Private      ,49,17,66,2125,189,2314
00466600,SALTER COLLEGE                          ,MA,01583-1700,Proprietary  ,166,636,802,402,1796,2198
00466700,SCHOOL OF MUSEUM OF FINE ARTS           ,MA,02115-5534,Private      ,28,27,55,418,251,669
00466900,UPPER CAPE COD REGIONAL VOC TECH        ,MA,02532-3310,Public       ,4,16,20,22,140,162
00527900,GREATER LOWELL REGNL VOC TECH SCH       ,MA,01879-0000,Public       ,7,24,31,29,129,158
00551900,DIMAN REGIONAL VOC TECH INST            ,MA,02723-3519,Public       ,3,32,35,40,165,205
00552300,BLUE HILLS REGIONAL VOC TECH            ,MA,02021-1398,Public       ,8,32,40,28,158,186
00555700,MCCANN TECHNICAL SCHOOL                 ,MA,01247-0000,Public       ,3,14,17,26,54,80
00613600,NATIONAL AVIATION ACADEMY - NEW ENGLAND ,MA,01730-2620,Proprietary  ,22,41,63,91,204,295
00632200,BROCKTON HOSPITAL SCH OF NURSING        ,MA,02302-0000,Private      ,6,80,86,125,548,673
00632400,LABOURE COLLEGE                         ,MA,02124-0000,Private      ,39,266,305,236,1138,1374
00633100,LAWRENCE MEM HOSPITAL SCH OF NRSNG      ,MA,02155-1643,Private      ,5,54,59,63,345,408
00635200,BAYSTATE MEDICAL CENTER                 ,MA,01199-0001,Private      ,5,16,21,36,84,120
00687300,MARIAN COURT COLLEGE                    ,MA,01907-2896,Private      ,0,4,4,65,86,151
00748400,NEWBURY COLLEGE                         ,MA,02445-5796,Private      ,47,37,84,1727,297,2024
00748600,THE NEW ENGLAND INSTITUTE OF ART        ,MA,02445-7295,Proprietary  ,17,28,45,439,245,684
00807800,SPRINGFIELD TECHNICAL COMMUNITY CLG     ,MA,01105-0000,Public       ,648,1156,1804,3470,4708,8178
00809002,EVEREST COLLEGE - EVEREST INSTITUTE     ,MA,02150-2333,Proprietary  ,0,0,0,8,40,48
00891600,NEW ENGLAND SCHOOL OF LAW               ,MA,02116-0000,Private      ,3,67,70,17,1202,1219
00964500,BARD COLLEGE AT SIMON'S ROCK            ,MA,01230-9702,Private      ,38,1,39,350,10,360
00974700,GORDON-CONWELL THEOLOGICAL SEMINARY     ,MA,01982-0000,Private      ,0,72,72,5,447,452
00975600,UNIVERSITY OF MASS MEDICAL CENTER       ,MA,01655-0000,Public       ,3,58,61,42,792,834
00987700,HENRI'S SCHOOL OF HAIR DESIGN           ,MA,01420-5675,Proprietary  ,0,2,2,7,10,17
00989900,LOWELL ACADEMY HAIRSTYLING INST         ,MA,01852-1909,Proprietary  ,14,32,46,38,79,117
00993600,MIDDLESEX COMMUNITY COLLEGE             ,MA,01730-1197,Public       ,378,489,867,1758,1670,3428
00993602,"MIDDLESEX COMMUNITY COLLEGE, LOWELL     ",MA,01852-0000,Public       ,656,874,1530,2883,2950,5833
01121000,BUNKER HILL COMMUNITY COLLEGE           ,MA,02129-2991,Public       ,1059,2046,3105,6304,9767,16071
01193000,ROXBURY COMMUNITY COLLEGE               ,MA,02120-3400,Public       ,205,737,942,898,2770,3668
01204200,MANSFIELD BEAUTY SCHOOLS                ,MA,02169-5061,Proprietary  ,7,17,24,21,64,85
01206800,MANSFIELD BEAUTY SCHOOL                 ,MA,01103-1410,Proprietary  ,5,12,17,13,41,54
01218700,BLACKSTONE VALLEY VOCATIONAL REGIONAL SC,MA,01568-1499,Public       ,3,6,9,15,51,66
01238600,SOUTHEASTERN TECHNICAL INSTITUTE        ,MA,02375-1780,Public       ,13,49,62,58,179,237
01246108,LINCOLN TECHNICAL INSTITUTE - BROCKTON  ,MA,02401-1818,Proprietary  ,38,89,127,123,309,432
01246114,LINCOLN TECHNICAL INSTITUTE - LOWELL    ,MA,01852-5119,Proprietary  ,28,74,102,123,305,428
01246115,LINCOLN TECHNICAL INSTITUTE - SOMERVILLE,MA,02145-1102,Proprietary  ,33,76,109,122,293,415
01288100,MONTACHUSETT REG VOC TECH SCH           ,MA,01420-4649,Public       ,0,17,17,21,89,110
01294800,ROB ROY ACADEMY                         ,MA,02721-5330,Proprietary  ,10,26,36,29,60,89
02063000,MONTSERRAT COLLEGE OF ART               ,MA,01915-0000,Private      ,15,5,20,642,60,702
02079400,EMPIRE BEAUTY SCHOOL                    ,MA,01702-5232,Proprietary  ,165,378,543,572,1348,1920
02092100,MASSACHUSETTS SCHOOL OF BARBERING       ,MA,02169-5058,Proprietary  ,7,31,38,14,91,105
02122000,NEW ENGLAND HAIR ACADEMY                ,MA,02148-0000,Proprietary  ,29,35,64,53,106,159
02137000,ROB ROY ACADEMY                         ,MA,02780-0000,Proprietary  ,5,10,15,19,24,43
02137200,MASS GEN HOSP DIETETIC INTERNSHIP       ,MA,02114-0000,Private      ,1,4,5,12,34,46
02163500,NEW ENGLAND SCHOOL OF PHOTOGRAPHY       ,MA,02215-0000,Proprietary  ,11,16,27,78,74,152
02163600,MASS SCH OF PROFESSIONAL PSYCHOLOGY     ,MA,02132-0000,Private      ,3,85,88,21,808,829
02169900,ASSABET VALLEY REGIONAL VOC SCHOOL      ,MA,01752-0000,Public       ,3,8,11,19,89,108
02181600,ROB ROY ACADEMY                         ,MA,01609-0000,Proprietary  ,21,51,72,49,96,145
02182900,CAMBRIDGE COLLEGE                       ,MA,02138-5304,Private      ,96,905,1001,345,2349,2694
02197900,NORTH BENNET STREET SCHOOL              ,MA,02113-0000,Private      ,3,24,27,39,156,195
02215100,HALLMARK INSTITUTE OF PHOTOGRAPHY       ,MA,01376-0000,Proprietary  ,11,23,34,92,86,178
02219501,MILDRED ELLEY - PITTSFIELD              ,MA,01201-5300,Proprietary  ,1,24,25,16,77,93
02220400,CATHERINE HINDS INST OF ESTHETICS       ,MA,01801-0000,Proprietary  ,26,60,86,61,160,221
02231600,MGH INSTITUTE OF HEALTH PROFESSION      ,MA,02129-0000,Private      ,8,208,216,91,1494,1585
02274300,CONWAY SCHOOL OF LANDSCAPE DESIGN       ,MA,01341-0179,Private      ,0,4,4,0,27,27
02325700,LABARON HAIRDRESSING ACADEMY            ,MA,02740-0000,Proprietary  ,5,7,12,12,25,37
02325800,LABARON HAIRDRESSING ACAD-BROCKTON      ,MA,02301-0000,Proprietary  ,6,15,21,11,38,49
02337400,BANCROFT SCHOOL OF MASSAGE THERAPY      ,MA,01604-4614,Proprietary  ,3,19,22,18,56,74
02338200,BAY STATE SCHOOL OF TECHNOLOGY          ,MA,02021-0000,Proprietary  ,14,44,58,31,102,133
02339400,ROB ROY ACADEMY                         ,MA,02746-0000,Proprietary  ,2,13,15,7,24,31
02491700,CORTIVA INSTITUTE -  BOSTON             ,MA,02472-2577,Proprietary  ,9,18,27,16,56,72
02523900,ELIZABETH GRADY SCHOOL OF ESTHETICS     ,MA,02155-0000,Proprietary  ,15,51,66,42,124,166
02579800,NEW ENGLAND SCHOOL OF ACUPUNCTURE       ,MA,02458-0000,Private      ,0,36,36,0,136,136
02616704,LE CORDON BLEU COLLEGE OF CULINARY ARTS ,MA,02142-1221,Proprietary  ,19,45,64,102,173,275
03066700,AILANO SCHOOL OF COSMETOLOGY            ,MA,02303-4740,Proprietary  ,2,16,18,9,48,57
03104000,SHAWSHEEN ADULT TECHNICAL INSTITUTE     ,MA,01821-5499,Public       ,3,17,20,13,60,73
03115200,MOTORING TECHNICAL TRAINING INST        ,MA,02771-5933,Proprietary  ,30,94,124,117,245,362
03120800,KAY HARVEY HAIRDRESSING ACADEMY         ,MA,01089-2701,Proprietary  ,7,15,22,15,25,40
03130500,URBAN COLLEGE OF BOSTON                 ,MA,02111-1093,Private      ,16,303,319,57,816,873
03194300,BOSTON GRAD SCH OF PSYCHOANALYSIS       ,MA,02446-4602,Private      ,0,29,29,0,71,71
03205400,JOLIE HAIR & BEAUTY ACADEMY             ,MA,01056-2769,Proprietary  ,10,32,42,22,68,90
03235300,MASSACHUSETTS SCHOOL OF LAW             ,MA,01810-1094,Private      ,1,88,89,10,380,390
03240300,TONI & GUY HAIRDRESSING ACADEMY         ,MA,01605-2213,Proprietary  ,17,27,44,70,82,152
03240301,TONI & GUY HAIRDRESSING ACADEMY - BRAINT,MA,02184-2807,Proprietary  ,19,16,35,68,60,128
03248300,BOSTON BAPTIST COLLEGE                  ,MA,02136-4030,Private      ,8,14,22,70,48,118
03316400,FUNERAL INSTITUTE OF THE NORTHEAST      ,MA,02062-4766,Proprietary  ,4,12,16,25,89,114
03504300,NATL GRAD SCH OF QUALITY SYSTM MGMT     ,MA,02540-0000,Private      ,0,32,32,0,51,51
03570500,NORTHPOINT BIBLE COLLEGE                ,MA,01835-0000,Private      ,55,31,86,218,136,354
03763300,MEDICAL PROFESSIONAL INSTITUTE          ,MA,02148-8143,Proprietary  ,10,75,85,35,308,343
03859300,E.I.N.E.                                ,MA,01876-4709,Proprietary  ,0,24,24,2,53,55
03927303,MARINELLO SCHOOL OF BEAUTY - NORTHAMPTON,MA,01060-3947,Proprietary  ,6,16,22,34,55,89
03946300,FRANKLIN W. OLIN COLLEGE OF ENGINEERING ,MA,02492-1200,Private      ,7,2,9,648,21,669
03965300,NEW ENGLAND COLLEGE OF FINANCE          ,MA,02110-1605,Proprietary  ,13,132,145,87,851,938
04116900,DIGRIGOLI SCHOOL OF COSMETOLOGY         ,MA,01089-4623,Proprietary  ,22,41,63,65,83,148
04122000,TRI COUNTY REGIONAL VOCATIONAL TECHNICAL,MA,02038-0000,Public       ,6,12,18,26,61,87
04128000,MILLENNIUM TRAINING INSTITUTE           ,MA,01801-6386,Proprietary  ,2,32,34,6,74,80
04143200,HULT INTERNATIONAL BUSINESS SCHOOL      ,MA,02141-1805,Private      ,3,33,36,98,231,329
04153200,SOUTHERN WORCESTER COUNTY REGIONAL VOC S,MA,01507-1331,Public       ,1,6,7,13,38,51
04193100,ALEXANDER ACADEMY                       ,MA,01420-0000,Proprietary  ,9,25,34,26,56,82
04229200,JUPITER BEAUTY ACADEMY                  ,MA,02122-2834,Proprietary  ,2,13,15,12,33,45
00401200,HEBREW UNIVERSITY OF JERUSALEM (THE)    ,FC,00000-0000,Public       ,7,16,23,23,71,94
00403000,UNIVERSITY OF CAMBRIDGE                 ,FC,00000-0000,Public       ,1,11,12,8,99,107
00503400,AMERICAN UNIVERSITY OF CAIRO            ,FC,00000-0000,Private      ,5,21,26,34,98,132
00669000,UNIVERSITY OF COPENHAGEN                ,FC,00000-0000,Public       ,0,6,6,3,66,69
00669100,UNIVERSITY OF CAMBRIDGE - PEMBROKE      ,FC,00000-0000,Public       ,0,2,2,1,10,11
00669200,UNIVERSITY OF LEEDS                     ,FC,00000-0000,Public       ,0,20,20,23,114,137
00669300,UNIV OF LONDON-LONDON SCHOOL ECON       ,FC,00000-0000,Public       ,1,52,53,15,377,392
00669400,UNIVERSITY OF LONDON - SCHOOL OF ORIENTA,FC,00000-0000,Public       ,4,31,35,15,174,189
00669500,UNIV OF LONDON-UNIVERSITY COLLEGE       ,FC,00000-0000,Public       ,7,76,83,47,416,463
00669502,UNIVERSITY OF LONDON - UCL INSTITUTE OF ,FC,00000-0000,Public       ,0,5,5,1,40,41
00669600,UNIV OF LONDON-SCH ADVANCED STUDY       ,FC,00000-0000,Public       ,0,5,5,0,14,14
00669700,"QUEEN MARY, UNIVERSITY OF LONDON        ",FC,00000-0000,Public       ,4,22,26,37,157,194
00669900,UNIVERSITY OF SUSSEX                    ,FC,00000-0000,Public       ,5,14,19,18,76,94
00670000,"UNIVERSITY OF YORK, THE                 ",FC,00000-0000,Public       ,1,28,29,24,141,165
00670400,UNIVERSITY COLLEGE CORK                 ,FC,00000-0000,Public       ,1,15,16,21,77,98
00671300,UPPSALA UNIVERSITY                      ,FC,00000-0000,Public       ,0,7,7,1,49,50
00671500,UNIVERSITY OF GENEVA                    ,FC,00000-0000,Public       ,0,6,6,5,84,89
00683900,UNIVERSITY OF EDINBURGH                 ,FC,00000-0000,Public       ,28,98,126,249,761,1010
00684200,UNIVERSITY OF DUBLIN TRINITY COLLEG     ,FC,00000-0000,Public       ,10,31,41,61,242,303
00685000,UNIVERSITY OF CAMBRIDGE - DOWNING C     ,FC,00000-0000,Public       ,0,0,0,1,4,5
00763200,UNIVERSITY OF BRISTOL                   ,FC,00000-0000,Public       ,2,14,16,22,83,105
00770500,ROYAL COLLEGE OF SURGEONS IN IRELAN     ,FC,00000-0000,Private      ,0,3,3,4,54,58
00788100,AMERICAN UNIVERSITY OF PARIS            ,FC,00000-0000,Private      ,27,45,72,554,307,861
00837100,AMERICAN UNIVERSITY OF BEIRUT           ,FC,00000-0000,Private      ,20,18,38,76,72,148
00837300,TEL-AVIV UNIVERSITY                     ,FC,00000-0000,Public       ,7,33,40,33,107,140
00837600,VRIJE UNIVERSITEIT AMSTERDAM            ,FC,00000-0000,Public       ,0,6,6,6,50,56
00837700,UNIVERSITEIT VAN AMSTERDAM(UNIVERSI     ,FC,00000-0000,Public       ,2,15,17,19,151,170
00838000,UNIVERSITY OF WARWICK                   ,FC,00000-0000,Public       ,0,9,9,9,60,69
00838300,UNIVERSITY OF GLASGOW                   ,FC,00000-0000,Public       ,13,71,84,85,459,544
00839400,UNIVERSITY OF OXFORD                    ,FC,00000-0000,Public       ,2,60,62,20,292,312
00839800,UNIVERSITY OF SHEFFIELD (THE)           ,FC,00000-0000,Public       ,3,15,18,18,99,117
00839900,UNIVERSITY OF SOUTHAMPTON               ,FC,00000-0000,Public       ,4,6,10,18,56,74
00845200,ABERYSTWYTH UNIVERSITY                  ,FC,00000-0000,Public       ,2,5,7,18,38,56
00845800,LOUGHBOROUGH UNIVERSITY                 ,FC,00000-0000,Public       ,2,2,4,6,16,22
00846000,UNIVERSITY OF NEWCASTLE UPON TYNE       ,FC,00000-0000,Public       ,2,15,17,26,95,121
00846100,UNIVERSITY OF SAINT ANDREWS             ,FC,00000-0000,Private      ,54,29,83,324,159,483
00850500,UNIVERSITY OF MELBOURNE                 ,FC,00000-0000,Public       ,2,31,33,16,138,154
00858600,SWANSEA UNIVERSITY                      ,FC,00000-0000,Public       ,1,12,13,23,52,75
00858700,UNIVERSITY OF DURHAM                    ,FC,00000-0000,Public       ,5,65,70,32,212,244
00866500,UNIVERSITY OF KENT AT CANTERBURY (THE)  ,FC,00000-0000,Public       ,3,28,31,31,159,190
00867000,UNIVERSITY OF NEW SOUTH WALES           ,FC,00000-0000,Public       ,6,9,15,25,68,93
00868700,UNIVERSITY OF ESSEX                     ,FC,00000-0000,Public       ,4,20,24,34,130,164
00869300,CITY UNIVERSITY                         ,FC,00000-0000,Public       ,3,40,43,24,231,255
00890800,THE UNIVERSITY OF BIRMINGHAM            ,FC,00000-0000,Public       ,2,21,23,18,116,134
00891000,UNIVERSITY OF HULL                      ,FC,00000-0000,Public       ,1,2,3,5,10,15
00892000,UNIVERSITY OF NOTTINGHAM                ,FC,00000-0000,Public       ,1,15,16,20,106,126
00900600,UNIVERSITY OF SALFORD (THE)             ,FC,00000-0000,Public       ,0,5,5,3,23,26
00908400,"UNIV OF LONDON, BIRKBECK                ",FC,00000-0000,Public       ,2,13,15,10,88,98
00908500,UNIV OF LONDON KING'S COLLEGE           ,FC,00000-0000,Public       ,7,60,67,112,455,567
00908600,UNIVERSITY OF LONDON - ROYAL HOLLOWAY   ,FC,00000-0000,Public       ,3,15,18,36,80,116
00914300,BAR-ILAN UNIVERSITY                     ,FC,00000-0000,Private      ,4,10,14,18,28,46
00924900,UNIVERSITY OF LIVERPOOL                 ,FC,00000-0000,Public       ,5,19,24,21,84,105
00936800,UNIVERSITY OF ABERDEEN                  ,FC,00000-0000,Public       ,7,12,19,55,137,192
00942300,ROYAL COLLEGE OF ART                    ,FC,00000-0000,Public       ,0,7,7,5,51,56
00942800,TECHNION-ISRAEL INST OF TECHLGY         ,FC,00000-0000,Public       ,2,27,29,7,70,77
00944200,UNIVERSITY OF EXETER                    ,FC,00000-0000,Public       ,1,13,14,21,73,94
00944400,UNIVERSITY OF LANCASTER                 ,FC,00000-0000,Public       ,1,5,6,9,35,44
00963400,UNIVERSITY OF OXFORD ST CATHERINE'S     ,FC,00000-0000,Public       ,0,2,2,1,5,6
00980800,UNIVERSITY OF STRATHCLYDE               ,FC,00000-0000,Public       ,1,9,10,9,59,68
00986000,UNIVERSITY OF SURREY                    ,FC,00000-0000,Public       ,2,4,6,18,41,59
00992700,UNIVERSITY OF CAMBRIDGE - FITZWILLI     ,FC,00000-0000,Public       ,0,1,1,1,8,9
01006700,LUND UNIVERSITY                         ,FC,00000-0000,Public       ,1,6,7,7,94,101
01008400,UNIVERSITY OF CAPE TOWN                 ,FC,00000-0000,Public       ,1,8,9,10,50,60
01008700,UNIVERSITY OF OXFORD ST PETER'S COL     ,FC,00000-0000,Public       ,0,2,2,0,4,4
01008800,UNIVERSITY OF OXFORD - CORPUS CHRIS     ,FC,00000-0000,Public       ,1,2,3,1,4,5
01008900,CENTRAL SCHOOL OF SPEECH AND DRAMA      ,FC,00000-0000,Public       ,1,9,10,11,46,57
01009000,UNIVERSITY OF OXFORD - BALLIOL COLL     ,FC,00000-0000,Public       ,1,2,3,1,9,10
01014300,UNIVERSITY OF READING                   ,FC,00000-0000,Public       ,2,9,11,13,66,79
01015700,CARDIFF UNIVERSITY                      ,FC,00000-0000,Public       ,4,10,14,24,70,94
01016000,CG JUNG INST                            ,FC,00000-0000,Private      ,0,2,2,0,3,3
01018800,UNIVERSITY COLLEGE DUBLIN               ,FC,00000-0000,Public       ,7,46,53,84,295,379
01019000,UNIVERSITY OF CAMBRIDGE CHURCHILL C     ,FC,00000-0000,Public       ,0,1,1,1,6,7
01022800,UNIVERSITY OF STIRLING                  ,FC,00000-0000,Public       ,5,5,10,24,46,70
01033200,UNIVERSITY OF CAMBRIDGE - CLARE COL     ,FC,00000-0000,Public       ,0,1,1,2,6,8
01045600,UNIVERSITY OF HAIFA                     ,FC,00000-0000,Public       ,1,6,7,3,43,46
01047200,INST EUROPEEN OPEEN D'ADMINISTRATIO     ,FC,00000-0000,Private      ,0,10,10,0,44,44
01049300,CRANFIELD UNIVERSITY                    ,FC,00000-0000,Public       ,0,3,3,0,11,11
01052000,TRINITY LABAN CONSERVATOIRE OF MUSIC AND,FC,00000-0000,Public       ,0,1,1,7,18,25
01052500,UNIVERSITY OF HERTFORDSHIRE             ,FC,00000-0000,Public       ,1,4,5,25,30,55
01057400,LONDON INTRNTL FILM SCHOOL              ,FC,00000-0000,Private      ,0,4,4,2,16,18
01058800,AUSTRALIAN NATIONAL UNIVERSITY          ,FC,00000-0000,Public       ,2,7,9,13,39,52
01058900,BANGOR UNIVERSITY                       ,FC,00000-0000,Public       ,3,3,6,27,28,55
01059400,"RICHMOND, THE AMERICAN INT UNI IN LONDON",FC,00000-0000,Private      ,13,4,17,313,50,363
01059900,INST D'ETUDES POLITIQUES DE PARIS       ,FC,00000-0000,Public       ,2,14,16,11,115,126
01068100,MACQUARIE UNIVERSITY                    ,FC,00000-0000,Public       ,4,6,10,10,32,42
01069200,UNIVERSITY OF QUEENSLAND (THE)          ,FC,00000-0000,Public       ,6,144,150,24,289,313
01078900,UNIVERSITY OF OXFORD - WORCESTER CO     ,FC,00000-0000,Public       ,0,0,0,0,4,4
01079700,"NATIONAL UNIVERSITY OF IRELAND, MAY     ",FC,00000-0000,Public       ,2,1,3,14,24,38
01081600,KINGSTON UNIVERSITY                     ,FC,00000-0000,Public       ,3,34,37,63,205,268
01086400,UNIV OF DUNDEE                          ,FC,00000-0000,Public       ,0,5,5,6,30,36
01086600,UNIVERSITY OF OXFORD - MAGDALEN COLLEGE ,FC,00000-0000,Public       ,0,1,1,1,6,7
01086700,UNIVERSITY OF OXFORD ST JOHN'S COLL     ,FC,00000-0000,Public       ,0,0,0,0,2,2
01091400,MONASH UNIVERSITY                       ,FC,00000-0000,Public       ,2,7,9,8,32,40
01091500,UNIV OF EAST ANGLIA                     ,FC,00000-0000,Public       ,3,12,15,30,72,102
01094200,UNIVERSITY OF OXFORD - ST HUGH'S CO     ,FC,00000-0000,Public       ,0,2,2,1,8,9
01097700,UNIVERSIDAD CENTRAL DEL ESTE            ,FC,00000-0000,Private      ,7,38,45,19,110,129
01098000,SOMERVILLE COLLEGE                      ,FC,00000-0000,Public       ,0,2,2,1,5,6
01099900,UNIV OF OXFORD - WADHAM COLLEGE         ,FC,00000-0000,Public       ,0,0,0,0,4,4
01105300,UNIVERSITY OF OXFORD - ST HILDA'S C     ,FC,00000-0000,Public       ,1,1,2,1,5,6
01105400,UNIVERSITY OF OXFORD - ST ANNE'S CO     ,FC,00000-0000,Public       ,0,3,3,0,12,12
01105500,UNIV OF OXFORD - LADY MARGARET HALL     ,FC,00000-0000,Public       ,0,4,4,0,8,8
01105600,UNIVERSITY OF OXFORD - UNIVERSITY C     ,FC,00000-0000,Public       ,1,2,3,16,50,66
01105700,UNIVERSITY OF OXFORD - TRINITY COLL     ,FC,00000-0000,Public       ,1,1,2,2,3,5
01105800,UNIVERSITY OF OXFORD-ST EDMUND HALL     ,FC,00000-0000,Public       ,0,2,2,1,5,6
01105900,UNIVERSITY OF OXFORD ST ANTONY'S CO     ,FC,00000-0000,Public       ,0,6,6,0,22,22
01106000,UNIVERSITY OF OXFORD - QUEEN'S COLL     ,FC,00000-0000,Public       ,0,1,1,2,2,4
01106100,UNIVERSITY OF OXFORD - PEMBROKE COL     ,FC,00000-0000,Public       ,0,2,2,0,4,4
01106200,UNIVERSITY OF OXFORD - ORIEL COLLEG     ,FC,00000-0000,Public       ,0,6,6,1,9,10
01106300,UNIVERSITY OF OXFORD - NUFFIELD COL     ,FC,00000-0000,Public       ,0,1,1,0,4,4
01106400,UNIVERSITY OF OXFORD - NEW COLLEGE      ,FC,00000-0000,Public       ,0,1,1,3,5,8
01106500,UNIVERSITY OF OXFORD MERTON COLLEGE     ,FC,00000-0000,Public       ,0,0,0,2,7,9
01106600,UNIVERSITY OF OXFORD - LINCOLN COLL     ,FC,00000-0000,Public       ,0,3,3,0,9,9
01106700,UNIVERSITY OF OXFORD - KEBLE COLLEG     ,FC,00000-0000,Public       ,0,1,1,0,5,5
01106800,UNIVERSITY OF OXFORD - JESUS COLLEG     ,FC,00000-0000,Public       ,0,2,2,2,6,8
01106900,UNIVERSITY OF OXFORD - HERTFORD COL     ,FC,00000-0000,Public       ,0,2,2,1,8,9
01107000,UNIVERSITY OF OXFORD EXETER COLLEGE     ,FC,00000-0000,Public       ,0,1,1,0,4,4
01107100,UNIV OF OXFORD - CHRIST CHURCH          ,FC,00000-0000,Public       ,3,1,4,3,13,16
01107200,UNIVERSITY OF OXFORD - BRASENOSE CO     ,FC,00000-0000,Public       ,0,1,1,1,4,5
01109100,FLINDERS UNIVERSITY OF S AUSTRALIA      ,FC,00000-0000,Public       ,2,2,4,7,17,24
01109400,UNIVERSITY OF WESTERN AUSTRALIA (THE)   ,FC,00000-0000,Public       ,1,2,3,3,18,21
01121400,UNIVERSITY OF THE WITWATERSRAND         ,FC,00000-0000,Public       ,0,4,4,2,22,24
01122600,AARHUS UNIVERSITY                       ,FC,00000-0000,Public       ,0,6,6,2,35,37
01156700,"IMPERIAL COLLEGE OF SCIENCE, TECHNOLOGY ",FC,00000-0000,Public       ,3,24,27,17,82,99
01167900,UNIVERSITY OF BATH                      ,FC,00000-0000,Public       ,1,5,6,10,38,48
01168300,FRANKLIN COLLEGE  SWITZERLAND           ,FC,00000-0000,Private      ,12,3,15,248,35,283
01175800,UNIV OF CAMBRIDGE - PETERHOUSE          ,FC,00000-0000,Public       ,1,0,1,1,4,5
01176400,ROYAL ACADEMY OF MUSIC                  ,FC,00000-0000,Public       ,2,5,7,8,22,30
01176500,GOLDSMITHS' COLLEGE-UNIV OF LONDON      ,FC,00000-0000,Public       ,7,27,34,51,173,224
01178000,BRUNEL UNIVERSITY                       ,FC,00000-0000,Public       ,1,14,15,12,67,79
01183800,UNIVERSITY OF OXFORD - MANSFIELD CO     ,FC,00000-0000,Public       ,0,1,1,0,5,5
01207500,UNIVERSITY CAMBRIDGE - TRINITY COLL     ,FC,00000-0000,Public       ,2,2,4,3,6,9
01207800,VICTORIA UNIV OF WELLINGTON             ,FC,00000-0000,Public       ,0,6,6,6,43,49
01209600,ECOLE HÔTELIERE DE LAUSANNE             ,FC,00000-0000,Private      ,0,1,1,4,9,13
01210100,UNIVERSITY OF CAMBRIDGE - GIRTON CO     ,FC,00000-0000,Public       ,0,0,0,1,6,7
01213600,VICTORIA UNIV OF MANCHESTER (THE)       ,FC,00000-0000,Public       ,4,21,25,30,142,172
01219800,UNIVERSITY OF BRADFORD                  ,FC,00000-0000,Public       ,0,8,8,3,29,32
01220100,UNIVERSITY OF OXFORD - REGENT'S PAR     ,FC,00000-0000,Public       ,0,0,0,0,2,2
01220600,JAMES COOK UNIVERSITY                   ,FC,00000-0000,Public       ,3,4,7,14,43,57
01221500,BIRMINGHAM CITY UNIVERSITY              ,FC,00000-0000,Public       ,4,5,9,10,42,52
01222300,JAGIELLONIAN UNIVERSITY COLLEGIUM M     ,FC,00000-0000,Public       ,0,10,10,1,29,30
01225800,ASTON UNIVERSITY                        ,FC,00000-0000,Public       ,1,0,1,5,9,14
01227500,UNIVERSITY OF OXFORD - WOLFSON COLL     ,FC,00000-0000,Public       ,0,7,7,0,19,19
01230200,GONVILLE & CAIUS COLLEGE                ,FC,00000-0000,Public       ,0,0,0,0,2,2
01233500,ROYAL COLLEGE OF MUSIC                  ,FC,00000-0000,Public       ,1,6,7,4,22,26
01234100,UNIVERSITY OF WALES - ST DAVID'S UN     ,FC,00000-0000,Public       ,1,2,3,4,10,14
01242100,UNIV OF AUCKLAND                        ,FC,00000-0000,Public       ,3,17,20,22,86,108
01254000,UNIVERSIDAD DE NAVARRA                  ,FC,00000-0000,Private      ,3,10,13,12,33,45
01276500,UNIVERSITY OF OXFORD - LINACRE COLL     ,FC,00000-0000,Public       ,0,3,3,0,13,13
01276600,"NATIONAL UNIVERSITY IRELAND, GALWAY     ",FC,00000-0000,Public       ,5,12,17,31,117,148
01280200,PONTIFICIA UNIV CATOLICA MAD Y MAES     ,FC,00000-0000,Private      ,66,45,111,112,102,214
01281100,INST TECNOLOGICO DE SANTO DOMINGO       ,FC,00000-0000,Private      ,5,11,16,20,46,66
01283900,UNIVERSITY OF CAMBRIDGE - SAINT JOH     ,FC,00000-0000,Public       ,0,0,0,0,8,8
01297800,UNIVERSITY OF HUDDERSFIELD (THE)        ,FC,00000-0000,Public       ,1,5,6,6,17,23
01315300,MASSEY UNIVERSITY                       ,FC,00000-0000,Public       ,3,4,7,7,41,48
02052400,DARWIN COLLEGE                          ,FC,00000-0000,Public       ,0,2,2,1,7,8
02082400,UNIVERSITY OF CAMBRIDGE - QUEEN'S C     ,FC,00000-0000,Public       ,1,0,1,2,7,9
02083400,UNIVERSITY OF CAMBRIDGE - WOLFSON C     ,FC,00000-0000,Public       ,0,4,4,0,20,20
02087400,UNIVERSITY OF CAMBRIDGE - NEWNHAM C     ,FC,00000-0000,Public       ,0,1,1,0,5,5
02087900,OXFORD BROOKES UNIVERSITY               ,FC,00000-0000,Public       ,5,20,25,23,95,118
02094100,BEN-GURION UNIV                         ,FC,00000-0000,Public       ,1,4,5,2,89,91
02094400,UNIV OF CAMBRIDGE - ST EDMUND'S HOU     ,FC,00000-0000,Public       ,0,4,4,0,9,9
02095500,LONDON BUS SCHOOL                       ,FC,00000-0000,Public       ,0,20,20,2,88,90
02101900,ROEHAMPTON UNIVERSITY                   ,FC,00000-0000,Public       ,6,22,28,43,107,150
02108600,LONDON ACADEMY OF MUSIC & DRAMATIC      ,FC,00000-0000,Private      ,1,4,5,26,55,81
02115900,UNIVERSITY OF PORTSMOUTH                ,FC,00000-0000,Public       ,1,2,3,15,13,28
02116700,UNIVERSITY OF CAMBRIDGE - LUCY CAVE     ,FC,00000-0000,Public       ,0,2,2,1,8,9
02120000,UNIV OF LONDON - COURTALD INST OF A     ,FC,00000-0000,Public       ,0,7,7,0,35,35
02133400,UNIVERSITY OF CAMBRIDGE - SIDNEY SU     ,FC,00000-0000,Public       ,0,0,0,2,8,10
02142000,UNIVERSITY OF CAMBRIDGE - HOMERTON      ,FC,00000-0000,Public       ,0,5,5,0,6,6
02149700,UNIVERSITY OF WINCHESTER (THE)          ,FC,00000-0000,Public       ,3,0,3,15,8,23
02156800,UNIV OF OTAGO                           ,FC,00000-0000,Public       ,3,11,14,11,45,56
02162300,"IESE BUSINESS SCH, UNIV OF NAVARRA      ",FC,00000-0000,Private      ,2,18,20,4,59,63
02167400,UNIVERSITY OF CAMBRIDGE - CORPUS CH     ,FC,00000-0000,Public       ,0,2,2,0,6,6
02177700,KING'S COLLEGE- UNIV OF CAMBRIDGE       ,FC,00000-0000,Public       ,1,2,3,12,30,42
02180500,MIDDLESEX UNIVERSITY                    ,FC,00000-0000,Public       ,9,26,35,49,95,144
02183500,UNIV OF OXFORD - WYCLIFFE HALL          ,FC,00000-0000,Public       ,1,3,4,3,14,17
02186000,UNIVERSITY OF CAMBRIDGE - MAGDALENE     ,FC,00000-0000,Public       ,0,1,1,3,3,6
02186100,UNIVERSITY OF CAMBRIDGE - EMMANUEL      ,FC,00000-0000,Public       ,0,1,1,0,5,5
02194800,UNIVERSITY OF THE WEST OF ENGLAND -     ,FC,00000-0000,Public       ,2,4,6,8,27,35
02195100,UNIV OF WESTMINSTER                     ,FC,00000-0000,Public       ,5,25,30,62,156,218
02196700,GUILDHALL SCHOOL OF MUSIC & DRAMA       ,FC,00000-0000,Public       ,0,2,2,13,21,34
02207300,UNIVERSITY OF CAMBRIDGE - CHRIST'S      ,FC,00000-0000,Public       ,0,0,0,0,7,7
02207400,CHINESE UNIVERSITY OF HONG KONG (THE)   ,FC,00000-0000,Public       ,3,3,6,11,24,35
02209500,UNIVERSITEIT UTRECHT                    ,FC,00000-0000,Public       ,3,3,6,14,50,64
02210000,UNIV OF LONDON - LONDON SCHOOL OF H     ,FC,00000-0000,Public       ,0,22,22,0,103,103
02225300,UNIVERSITY OF CANTERBURY                ,FC,00000-0000,Public       ,1,3,4,4,17,21
02229100,UNIVERSITY OF LEICESTER                 ,FC,00000-0000,Public       ,0,26,26,15,111,126
02229600,SACKLER SCHOOL OF MEDICINE              ,FC,00000-0000,Public       ,0,16,16,0,157,157
02232100,UNIVERSITY OF CAMBRIDGE                 ,FC,00000-0000,Public       ,0,8,8,2,35,37
02233300,"ST GEORGE'S UNIVERSITY, SCHOOL OF MEDICI",FC,00000-0000,Proprietary  ,0,422,422,21,3867,3888
02235300,LONDON METROPOLITAN UNIVERSITY          ,FC,00000-0000,Public       ,2,22,24,38,79,117
02244400,AMERICAN UNIV OF THE CARIBBEAN          ,FC,00000-0000,Proprietary  ,2,502,504,9,1480,1489
02266600,UNIVERSITY OF LONDON - SAINT GEORGE     ,FC,00000-0000,Public       ,1,14,15,2,55,57
02271700,UNIVERSITY OF CAMBRIDGE - CLARE HAL     ,FC,00000-0000,Public       ,0,0,0,0,4,4
02271900,UNIVERSITY OF OXFORD - BLACKFRIARS      ,FC,00000-0000,Public       ,0,1,1,0,2,2
02273600,QUEEN'S UNIV OF BELFAST (THE)           ,FC,00000-0000,Public       ,3,18,21,18,80,98
02273900,HERIOT WATT UNIVERSITY                  ,FC,00000-0000,Public       ,1,5,6,7,31,38
02293400,ECOLE DES HAUTES ETUDES COMERCIALS      ,FC,00000-0000,Public       ,0,3,3,0,29,29
02296300,UNIVERSITY OF CAMBRIDGE - JESUS COL     ,FC,00000-0000,Public       ,0,2,2,0,9,9
02310500,DE MONTFORT UNIVERSITY                  ,FC,00000-0000,Public       ,0,3,3,5,10,15
02320500,ROYAL NORTHERN COLLEGE OF MUSIC         ,FC,00000-0000,Public       ,0,1,1,2,9,11
02335100,UNIV OF CAMBRIDGE - TRINITY HALL        ,FC,00000-0000,Public       ,0,0,0,2,9,11
02338900,UNIVERSITY  FOR THE CREATIVE ARTS       ,FC,00000-0000,Public       ,2,3,5,11,9,20
02351800,UNIVERSIDAD IBEROAMERICANA (UNIBE       ,FC,00000-0000,Private      ,12,78,90,76,361,437
02352100,UNIVERSITY OF PLYMOUTH                  ,FC,00000-0000,Public       ,0,1,1,14,14,28
02496700,NATIONAL FILM & TV SCHOOL               ,FC,00000-0000,Public       ,0,1,1,1,7,8
02545700,GLASGOW SCHOOL OF ART                   ,FC,00000-0000,Public       ,1,2,3,5,22,27
02561600,SOUTHAMPTON SOLENT UNIVERSITY           ,FC,00000-0000,Public       ,4,0,4,12,3,15
02579600,MURDOCH UNIVERSITY                      ,FC,00000-0000,Public       ,1,2,3,3,22,25
02588000,UNIVERSITY OF ULSTER                    ,FC,00000-0000,Public       ,3,1,4,7,20,27
02611700,DUBLIN CITY UNIVERSITY                  ,FC,00000-0000,Public       ,1,5,6,11,40,51
03012700,UNIVERSITY OF BUCKINGHAM                ,FC,00000-0000,Private      ,1,4,5,6,9,15
03029400,KEELE UNIVERSITY                        ,FC,00000-0000,Public       ,1,3,4,13,13,26
03029500,NORTHUMBRIA UNIVERSITY                  ,FC,00000-0000,Public       ,1,5,6,9,40,49
03033300,MANCHESTER METROPOLITAN UNIV            ,FC,00000-0000,Public       ,5,11,16,35,65,100
03045000,UNIVERSITY OF EAST LONDON               ,FC,00000-0000,Public       ,2,12,14,31,51,82
03050100,STUDIO ART CENTERS INTERNATIONAL        ,FC,00000-0000,Private      ,2,4,6,17,52,69
03067200,UNIVERSITY OF SYDNEY                    ,FC,00000-0000,Public       ,2,29,31,21,142,163
03073800,UNIV OF DEBRECEN MED & HEALTH SCI       ,FC,00000-0000,Public       ,0,6,6,3,16,19
03078700,UNIVERSITA COMMERCIALE L BOCCONI        ,FC,00000-0000,Private      ,1,7,8,10,34,44
03080300,SHEFFIELD HALLAM UNIVERSITY             ,FC,00000-0000,Public       ,0,2,2,7,8,15
03084300,UNIVERSITY OF LIMERICK                  ,FC,00000-0000,Public       ,2,16,18,17,76,93
03088700,ROYAL SCOTTISH ACAD MUSIC & DRAMA       ,FC,00000-0000,Public       ,2,5,7,19,26,45
03091400,UNIVERSITY OF WOLLONGONG                ,FC,00000-0000,Public       ,1,5,6,7,19,26
03091500,UNIVERSITY OF CANBERRA                  ,FC,00000-0000,Public       ,1,0,1,2,4,6
03091700,POZNAN UNIVERSITY OF MEDICAL SCIENCES   ,FC,00000-0000,Public       ,0,10,10,5,41,46
03092500,NOTTINGHAM TRENT UNIVERSITY             ,FC,00000-0000,Public       ,1,6,7,16,29,45
03095000,RMIT UNIVERSITY                         ,FC,00000-0000,Public       ,2,4,6,8,31,39
03095400,BOND UNIVERSITY                         ,FC,00000-0000,Private      ,1,18,19,20,44,64
03095900,ESSEC BUSINESS SCHOOL                   ,FC,00000-0000,Private      ,0,2,2,3,15,18
03096100,LA TROBE UNIVERSITY                     ,FC,00000-0000,Public       ,3,3,6,9,19,28
03100000,UNIVERSITY OF ADELAIDE (THE)            ,FC,00000-0000,Public       ,1,2,3,6,13,19
03101600,ASIAN INSTITUTE OF MANAGEMENT           ,FC,00000-0000,Private      ,0,4,4,3,22,25
03102500,AMERICAN UNIVERSITY OF ROME             ,FC,00000-0000,Private      ,11,11,22,115,88,203
03102800,ROBERT GORDON UNIVERSITY (THE)          ,FC,00000-0000,Public       ,0,7,7,1,33,34
03104800,GRIFFITH UNIVERSITY                     ,FC,00000-0000,Public       ,3,9,12,14,32,46
03140600,SOUTHERN CROSS UNIVERSITY               ,FC,00000-0000,Public       ,1,2,3,1,6,7
03150400,"UNIVERSITY OF TECHNOLOGY, SYDNEY        ",FC,00000-0000,Public       ,0,4,4,2,25,27
03287300,LIVERPOOL INSTITUTE FOR PERFORMING ARTS ,FC,00000-0000,Public       ,2,0,2,25,3,28
03300300,"2ND SCHOOL OF MEDICINE, CHARLES UNI     ",FC,00000-0000,Public       ,0,6,6,3,22,25
03300400,"FIRST FACULTY OF MEDICINE, CHARLES UNIV.",FC,00000-0000,Public       ,0,13,13,5,30,35
03329300,JOHN CABOT UNIVERSITY                   ,FC,00000-0000,Private      ,7,3,10,179,41,220
03333300,MEDICAL UNIVERSITY SCHOOL OF LUBLIN     ,FC,00000-0000,Public       ,6,56,62,11,144,155
03334300,UNIVERSIDAD NORDESTANA                  ,FC,00000-0000,Private      ,2,17,19,7,54,61
03335300,MEDICAL UNIVERSITY OF SILESIA           ,FC,00000-0000,Public       ,3,34,37,8,63,71
03342300,GLASGOW CALEDONIAN UNIVERSITY           ,FC,00000-0000,Public       ,1,10,11,6,43,49
03349400,"QUEEN MARGARET UNIVERSITY, EDINBURGH    ",FC,00000-0000,Public       ,1,2,3,3,27,30
03350300,BOURNEMOUTH UNIVERSITY                  ,FC,00000-0000,Public       ,2,10,12,15,32,47
03352300,LONDON SOUTH BANK UNIVERSITY            ,FC,00000-0000,Private      ,1,10,11,17,42,59
03378300,"THE 3RD FACULTY OF MEDICINE, CHARLE     ",FC,00000-0000,Public       ,0,0,0,1,3,4
03418400,NAPIER UNIVERSITY                       ,FC,00000-0000,Public       ,2,9,11,9,52,61
03435300,ANGLIA  RUSKIN UNIVERSITY               ,FC,00000-0000,Private      ,1,14,15,12,32,44
03460300,INTERNATIONALES THEOLOGISCHES INSTI     ,FC,00000-0000,Private      ,0,8,8,5,16,21
03473300,UNIVERSITY OF THE ARTS LONDON           ,FC,00000-0000,Public       ,27,46,73,122,147,269
03478300,ROYAL WELSH COLLEGE OF MUSIC AND DRAMA  ,FC,00000-0000,Public       ,0,5,5,14,24,38
03492300,UNIVERSITY OF OXFORD - GREEN TEMPLETON C,FC,00000-0000,Public       ,0,4,4,0,22,22
03492400,UNIV OF CAMBRIDGE-ST CATHERINE'S CG     ,FC,00000-0000,Public       ,0,0,0,0,3,3
03494400,UNIV OF CAMBRIDGE-SELWYN COLLEGE        ,FC,00000-0000,Public       ,0,1,1,0,4,4
03494600,UNIV OF OXFORD-HARRIS MANCHESTER        ,FC,00000-0000,Public       ,0,1,1,1,7,8
03501400,LEEDS METROPOLITAN UNIVERSITY           ,FC,00000-0000,Public       ,5,17,22,12,56,68
03507300,UNIVERSITY OF SUNDERLAND                ,FC,00000-0000,Public       ,1,1,2,7,7,14
03515300,UNIVERSITY OF CENTRAL LANCASHIRE        ,FC,00000-0000,Public       ,2,3,5,13,26,39
03517300,UNIVERSITY OF BRIGHTON                  ,FC,00000-0000,Public       ,3,10,13,20,39,59
03518300,EUROPEAN GRADUATE SCHOOL (EGS)          ,FC,00000-0000,Private      ,0,13,13,1,80,81
03527300,SOFIA UNIVERSITY ST. KLIMENT OHRIDSKI   ,FC,00000-0000,Public       ,0,0,0,1,9,10
03533300,BATH SPA UNIVERSITY                     ,FC,00000-0000,Public       ,1,3,4,9,27,36
03547300,UNIVERSITY OF SOUTH WALES               ,FC,00000-0000,Public       ,1,3,4,9,15,24
03547303,"UNIVERSITY OF SOUTH WALES - NEWPORT, CAE",FC,00000-0000,Public       ,0,0,0,0,1,1
03565300,MASARYKOVA UNIVERZITA                   ,FC,00000-0000,Public       ,0,3,3,1,7,8
03580300,LIVERPOOL JOHN MOORES UNIVERSITY        ,FC,00000-0000,Public       ,1,2,3,2,10,12
03589400,ARTS INSTITUTE AT BOURNEMOUTH (THE)     ,FC,00000-0000,Public       ,1,1,2,17,10,27
03594300,GROUP ESC GRENOBLE GRAD SCH OF BUS.     ,FC,00000-0000,Private      ,0,7,7,2,39,41
03597300,JAGIELLONIAN UNIVERSITY                 ,FC,00000-0000,Public       ,2,4,6,4,19,23
03619300,UNIVERSITY OF GREENWICH                 ,FC,00000-0000,Public       ,6,12,18,49,48,97
03653400,UNIVERSIDAD DE IBEROAMERICA - UNIBE     ,FC,00000-0000,Private      ,2,3,5,5,18,23
03674300,UNIVERSITY OF ABERTAY DUNDEE            ,FC,00000-0000,Public       ,0,2,2,3,7,10
03684400,UNIVERSITY OF LINCOLN                   ,FC,00000-0000,Public       ,2,3,5,11,17,28
03684500,MEDICAL UNIVERSITY OF GDANSK            ,FC,00000-0000,Public       ,1,3,4,5,8,13
03694300,UNIVERSITY OF CHICHESTER                ,FC,00000-0000,Public       ,0,2,2,1,6,7
03721300,WRITTLE COLLEGE                         ,FC,00000-0000,Public       ,0,1,1,0,1,1
03728300,UNIVERSITY OF DERBY                     ,FC,00000-0000,Public       ,0,5,5,2,10,12
03738300,LONDON SCHOOL OF THEOLOGY               ,FC,00000-0000,Private      ,0,2,2,0,6,6
03770300,NAZARENE THEOLOGICAL COLLEGE            ,FC,00000-0000,Private      ,0,2,2,0,4,4
03780300,SABA UNIVERSITY SCHOOL OF MEDICINE      ,FC,00000-0000,Proprietary  ,1,105,106,4,409,413
03784300,MEDICAL UNIVERSITY OF BIALYSTOK         ,FC,00000-0000,Public       ,1,2,3,4,8,12
03794400,ANGLO EUROPEAN COLLEGE OF CHIROPRACTIC  ,FC,00000-0000,Private      ,0,0,0,0,1,1
03807300,ROSE BRUFORD COLLEGE                    ,FC,00000-0000,Public       ,0,3,3,6,10,16
03816400,AMERICAN GRAD SCH OF INTERNTL REL & DIPL,FC,00000-0000,Private      ,1,7,8,4,42,46
03818300,LEIPZIG GRADUATE SCHOOL OF MANAGEMENT   ,FC,00000-0000,Private      ,0,3,3,0,12,12
03824300,"ROYAL VETERINARY COLLEGE (THE), UNIVERSI",FC,00000-0000,Public       ,1,24,25,2,97,99
03829300,INTERNATIONAL CHRISTIAN COLLEGE         ,FC,00000-0000,Private      ,0,0,0,0,1,1
03859400,UNIVERSITY COLLEGE FALMOUTH             ,FC,00000-0000,Public       ,3,3,6,22,13,35
03873300,COPENHAGEN BUSINESS SCHOOL              ,FC,00000-0000,Public       ,0,4,4,4,17,21
03880300,UNIVERSITY OF GLOUCESTERSHIRE (THE)     ,FC,00000-0000,Public       ,0,1,1,6,6,12
03897400,INTERNATIONAL SPACE UNIVERSITY          ,FC,00000-0000,Private      ,0,1,1,0,7,7
03900300,MEDICAL UNIVERSITY OF THE AMERICAS      ,FC,00000-0000,Proprietary  ,0,83,83,0,277,277
03945300,UNIVERSITY OF WEST LONDON               ,FC,00000-0000,Public       ,0,3,3,14,21,35
03974300,"ST. GEORGE'S UNIVERSITY, SCHOOL OF VETER",FC,00000-0000,Proprietary  ,0,56,56,2,691,693
04015300,FRANKFURT SCHOOL OF FINANCE & MANAGEMENT,FC,00000-0000,Private      ,1,11,12,6,29,35
04021400,"AMERICAN COLLEGE, DUBLIN LIMITED (THE)  ",FC,00000-0000,Private      ,2,4,6,23,32,55
04021500,CENTRAL EUROPEAN UNIVERSITY             ,FC,00000-0000,Private      ,0,5,5,0,79,79
04032300,YORK ST JOHN UNIVERSITY                 ,FC,00000-0000,Public       ,0,1,1,5,5,10
04046300,HK UNIVERSITY OF SCI & TECH (HKUST)     ,FC,00000-0000,Public       ,0,4,4,3,14,17
04070300,"RAPHAEL RECANATI INTERNATIONAL SCHOOL, T",FC,00000-0000,Private      ,22,30,52,56,71,127
04076300,NEWCASTLE COLLEGE                       ,FC,00000-0000,Public       ,0,1,1,1,7,8
04085400,NEW ZEALAND COLLEGE OF CHIROPRACTIC     ,FC,00000-0000,Private      ,0,1,1,1,3,4
04113300,LEBANESE AMERICAN UNIVERSITY            ,FC,00000-0000,Private      ,21,7,28,63,20,83
04115900,LIVERPOOL HOPE UNIVERSITY               ,FC,00000-0000,Public       ,1,1,2,3,8,11
04116300,EDHEC BUSINESS SCHOOL                   ,FC,00000-0000,Private      ,0,7,7,1,23,24
04128600,UNIVERSITY OF WORCESTER                 ,FC,00000-0000,Public       ,1,0,1,10,3,13
04128700,HERTIE SCHOOL OF GOVERNANCE             ,FC,00000-0000,Private      ,2,4,6,7,41,48
04134200,LONDON CONTEMPORARY DANCE SCHOOL        ,FC,00000-0000,Private      ,2,0,2,11,3,14
04139100,UNIVERSITA DEGLI STUDI DI SCIENZE GASTRO,FC,00000-0000,Private      ,0,2,2,1,11,12
04143700,ST MARY'S UNIVERSITY COLLEGE TWICKENHAM ,FC,00000-0000,Public       ,1,2,3,15,11,26
04160800,CORK INSTITUTE OF TECHNOLOGY            ,FC,00000-0000,Public       ,1,0,1,1,4,5
04168200,EUROPEAN UNIVERSITY AT ST. PETERSBURG   ,FC,00000-0000,Private      ,1,4,5,3,13,16
04170900,UNIVERSITY OF CHESTER                   ,FC,00000-0000,Public       ,0,4,4,5,10,15
04176500,ESMT EUROPEAN SCHOOL OF MANAGEMENT AND T,FC,00000-0000,Private      ,2,8,10,8,30,38
04180700,"HEYTHROP COLLEGE, UNIVERSITY OF LONDON  ",FC,00000-0000,Public       ,1,1,2,3,3,6
04212900,UNIVERSITY COLLEGE BIRMINGHAM           ,FC,00000-0000,Public       ,0,0,0,0,1,1
04218800,REGENT'S UNIVERSITY LONDON              ,FC,00000-0000,Private      ,4,8,12,70,36,106
04219400,UNIVERSIDAD TORCUATO DI TELLA           ,FC,00000-0000,Private      ,0,1,1,3,4,7
04227300,UNIVERSITY OF OXFORD-ST. STEPHEN'S HOUSE,FC,00000-0000,Public       ,0,0,0,0,2,2
04244500,NORWICH UNIVERSITY OF THE ARTS          ,FC,00000-0000,Public       ,0,0,0,2,1,3
00380600,ALDERSON BROADDUS UNIVERSITY            ,WV,26416-1051,Private      ,46,31,77,1862,365,2227
00380700,MOUNTAIN STATE UNIVERSITY               ,WV,25801-5624,Private      ,5,48,53,70,163,233
00380800,BETHANY COLLEGE                         ,WV,26032-0417,Private      ,83,29,112,1100,144,1244
00380900,BLUEFIELD STATE COLLEGE                 ,WV,24701-2198,Public       ,112,280,392,1319,1430,2749
00381000,CONCORD UNIVERSITY                      ,WV,24712-0000,Public       ,127,254,381,2390,1295,3685
00381100,DAVIS & ELKINS COLLEGE                  ,WV,26241-3996,Private      ,74,64,138,1080,297,1377
00381200,FAIRMONT STATE UNIVERSITY               ,WV,26554-2470,Public       ,281,436,717,4455,2430,6885
00381300,GLENVILLE STATE COLLEGE                 ,WV,26351-1292,Public       ,83,114,197,1484,579,2063
00381500,MARSHALL UNIVERSITY                     ,WV,25755-3300,Public       ,510,1194,1704,10061,6899,16960
00381600,SOUTHERN WV COMMUNITY COLLEGE           ,WV,25637-2900,Public       ,119,327,446,1162,1384,2546
00381800,UNIVERSITY OF CHARLESTON                ,WV,25304-1099,Private      ,100,270,370,1700,1697,3397
00381900,OHIO VALLEY COLLEGE                     ,WV,26105-8000,Private      ,28,29,57,454,126,580
00382000,SALEM INTERNATIONAL UNIVERSITY          ,WV,26426-0500,Proprietary  ,67,281,348,332,581,913
00382200,SHEPHERD UNIVERSITY                     ,WV,25443-5000,Public       ,164,219,383,3660,1415,5075
00382300,WEST LIBERTY UNIVERSITY                 ,WV,26074-0295,Public       ,170,189,359,2485,826,3311
00382600,WEST VIRGINIA STATE UNIVERSITY          ,WV,25112-0000,Public       ,232,339,571,2563,1827,4390
00382700,WEST VIRGINIA UNIVERSITY                ,WV,26506-6201,Public       ,970,1032,2002,25182,9149,34331
00382711,WEST VIRGINIA UNIVERSITY - POTOMAC STATE,WV,26726-3000,Public       ,107,89,196,1728,549,2277
00382721,WEST VIRGINIA UNIV INST OF TECH         ,WV,25136-2436,Public       ,74,97,171,1393,602,1995
00382800,WEST VIRGINIA UNIV AT PARKERSBURG       ,WV,26101-9577,Public       ,180,535,715,1442,2063,3505
00383000,WEST VIRGINIA WESLEYAN COLLEGE          ,WV,26201-2600,Private      ,73,43,116,2001,291,2292
00383100,WHEELING JESUIT UNIVERSITY              ,WV,26003-6243,Private      ,63,144,207,1085,759,1844
00500700,WEST VIRGINIA JUNIOR COLLEGE            ,WV,26505-5596,Proprietary  ,34,173,207,267,619,886
00500800,MOUNTAIN STATE COLLEGE                  ,WV,26101-3993,Proprietary  ,10,82,92,53,295,348
00754400,APPALACHIAN BIBLE COLLEGE               ,WV,25818-1353,Private      ,15,16,31,223,60,283
00760000,INTERNATIONAL BEAUTY SCHOOL             ,WV,25401-3231,Proprietary  ,11,23,34,28,79,107
00835500,JAMES RUMSEY TECHNICAL INSTITUTE        ,WV,25403-0259,Public       ,20,77,97,123,320,443
00895900,CLARKSBURG BEAUTY ACADEMY               ,WV,26301-2903,Proprietary  ,13,34,47,44,99,143
00904700,HUNTINGTON JUNIOR COLLEGE               ,WV,25701-2004,Proprietary  ,35,272,307,182,958,1140
00905400,WEST VIRGINIA NORTHERN CMTY COLLEGE     ,WV,26003-0000,Public       ,143,378,521,960,1392,2352
01014000,MINERAL COUNTY VOCATIONAL TECH CTR      ,WV,26726-0000,Public       ,2,9,11,27,50,77
01057300,WEST VIRGINIA JUNIOR COLLEGE            ,WV,25322-0000,Proprietary  ,28,96,124,195,391,586
01057302,WEST VIRGINIA JUNIOR COLLEGE            ,WV,26330-0000,Proprietary  ,19,51,70,160,262,422
01086100,WEST VIRGINIA BUSINESS COLLEGE          ,WV,26301-0000,Proprietary  ,2,54,56,16,154,170
01124500,WEST VIRGINIA SCH OSTEOPATHIC MED       ,WV,24901-1128,Public       ,1,16,17,14,883,897
01174900,WOOD COUNTY SCH OF PRAC NURSING         ,WV,26101-6424,Public       ,5,28,33,39,131,170
01235900,B M SPURR SCHOOL OF PRAC NURSING        ,WV,26038-1660,Private      ,2,2,4,10,43,53
01257300,WEST VIRGINIA UNIV-HOSP-RAD TECH        ,WV,26506-8062,Private      ,3,14,17,121,106,227
01274300,BENJAMIN FRANKLIN CAREER&TECH           ,WV,25064-0000,Public       ,10,43,53,69,154,223
01290400,MONONGALIA CNTY TECH ED CTR             ,WV,26501-6841,Public       ,8,24,32,69,140,209
01290500,ACADEMY OF CAREERS AND TECHNOLOGY       ,WV,25801-0000,Public       ,26,114,140,164,379,543
02057400,ROANE-JACKSON TECHNICAL CENTER          ,WV,25252-0000,Public       ,4,14,18,31,50,81
02068000,UNITED TECHNICAL CENTER                 ,WV,26301-0000,Public       ,3,20,23,40,94,134
02073400,CARVER CAREER TECH ED CTR               ,WV,25306-6397,Public       ,26,90,116,220,371,591
02145100,SCOTT COLLEGE OF COSMETOLOGY            ,WV,26003-0000,Proprietary  ,10,17,27,45,74,119
02178200,CHARLESTON SCHOOL OF BEAUTY CULTURE     ,WV,25301-0000,Proprietary  ,16,81,97,76,202,278
02218200,GARNET CAREER CENTER                    ,WV,25301-0000,Public       ,10,95,105,101,356,457
02275300,CABELL COUNTY CAREER TECHNOLOGY CTR     ,WV,25705-0000,Public       ,19,86,105,155,313,468
02524500,RALPH R WILLIS VOCATIONAL CENTER        ,WV,25601-0000,Public       ,6,31,37,37,97,134
02534800,FRED W EBERLE TECHNICAL CENTER          ,WV,26201-0000,Public       ,18,43,61,67,110,177
02535500,MERCER COUNTY TECH EDUC CNTR            ,WV,24740-0000,Public       ,13,64,77,90,245,335
02579900,NORTH CENTRAL OPPORTUNITIES INDUSTRIALIZ,WV,26554-2936,Private      ,10,39,49,27,91,118
02609400,VALLEY COLLEGE                          ,WV,25404-5711,Proprietary  ,19,113,132,84,334,418
03052000,MEREDITH MANOR EQUESTRIAN CENTRE        ,WV,26184-9707,Proprietary  ,22,25,47,151,97,248
03076500,FAYETTE INSTITUTE OF TECHNOLOGY         ,WV,25901-2174,Public       ,4,20,24,26,75,101
03084200,VALLEY COLLEGE                          ,WV,24740-3141,Proprietary  ,21,63,84,70,217,287
03084400,VALLEY COLLEGE                          ,WV,25801-2643,Proprietary  ,24,163,187,107,525,632
03098300,PUTNAM CAREER & TECHNICAL CENTER        ,WV,25070-0000,Public       ,23,21,44,74,94,168
03102100,MORGANTOWN BEAUTY COLLEGE               ,WV,26505-5430,Proprietary  ,19,39,58,87,136,223
03734300,JOHN D. ROCKEFELLER IV CAREER CENTER    ,WV,26047-9424,Public       ,1,6,7,10,31,41
03819300,AMERICAN PUBLIC UNIVERSITY SYSTEM       ,WV,25414-1621,Proprietary  ,491,13638,14129,1662,46690,48352
03957300,BLUE RIDGE COMMUNITY AND TECHNICAL COLLE,WV,25401-3244,Public       ,196,477,673,1033,1906,2939
03960300,NEW RIVER COMMUNITY AND TECHNICAL COLLEG,WV,25801-2636,Public       ,151,473,624,1094,1925,3019
04028300,MOUNTAIN STATE SCHOOL OF MASSAGE        ,WV,25304-2025,Proprietary  ,2,28,30,25,70,95
04038500,PIERPONT COMMUNITY & TECHNICAL COLLEGE  ,WV,26554-2451,Public       ,168,278,446,1332,1309,2641
04038600,BRIDGEVALLEY COMMUNITY AND TECHNICAL COL,WV,25303-2735,Public       ,119,399,518,1083,1796,2879
04038601,BRIDGEVALLEY COMMUNITY AND TECHNICAL COL,WV,25136-2435,Public       ,0,0,0,61,48,109
04041400,MOUNTWEST COMMUNITY AND TECHNICAL COLLEG,WV,25755-3300,Public       ,156,538,694,1051,1828,2879
04119000,EASTERN WEST VIRGINIA COMMUNITY & TECHNI,WV,26836-0000,Public       ,48,156,204,241,552,793
04212400,MINGO EXTENDED LEARNING CENTER          ,WV,25670-9797,Public       ,4,14,18,12,51,63
04234800,RANDOLPH TECHNICAL CENTER               ,WV,26241-9527,Public       ,5,11,16,16,31,47
00106100,ALASKA PACIFIC UNIVERSITY               ,AK,99508-4672,Private      ,48,156,204,530,725,1255
00106300,UNIVERSITY OF ALASKA FAIRBANKS          ,AK,99775-7500,Public       ,415,954,1369,3468,3831,7299
00106500,UNIVERSITY OF ALASKA SOUTHEAST          ,AK,99801-8680,Public       ,86,312,398,764,1240,2004
00884300,ALASKA BIBLE COLLEGE                    ,AK,99588-0000,Private      ,9,3,12,31,40,71
01146200,UNIVERSITY OF ALASKA ANCHORAGE          ,AK,99514-1608,Public       ,960,1924,2884,6416,7710,14126
02541000,ALASKA CAREER COLLEGE                   ,AK,99507-1033,Proprietary  ,70,195,265,250,760,1010
02576900,CHARTER COLLEGE                         ,AK,99508-0000,Proprietary  ,256,769,1025,806,3037,3843
03160300,AVTEC - ALASKA'S INSTITUTE OF TECHNOLOGY,AK,99664-0889,Public       ,47,60,107,232,298,530
03461300,ILISAGVIK COLLEGE                       ,AK,99723-0749,Public       ,6,25,31,21,58,79
04138600,ALASKA CHRISTIAN COLLEGE                ,AK,99669-9755,Private      ,3,28,31,36,92,128
00108500,UNIV ARKANSAS MONTICELLO                ,AR,71656-0000,Public       ,396,615,1011,2192,1764,3956
00108600,UNIV OF ARKANSAS AT PINE BLUFF          ,AR,71601-2790,Public       ,506,520,1026,3226,1671,4897
00108700,ARKANSAS BAPTIST COLLEGE                ,AR,72202-6099,Private      ,299,408,707,1052,1102,2154
00108800,LYON COLLEGE                            ,AR,72501-3699,Private      ,81,37,118,1097,149,1246
00108900,ARKANSAS TECH UNIVERSITY                ,AR,72801-2222,Public       ,1006,1367,2373,7344,5138,12482
00109000,ARKANSAS STATE UNIVERSITY               ,AR,72467-0000,Public       ,1263,2949,4212,9338,9910,19248
00109100,ARKANSAS STATE UNIVERSITY - BEEBE       ,AR,72012-1000,Public       ,337,658,995,2159,2431,4590
00109200,UNIVERSITY OF CENTRAL ARKANSAS          ,AR,72035-0001,Public       ,1100,1067,2167,10141,4689,14830
00109300,CENTRAL BAPTIST COLLEGE                 ,AR,72034-6470,Private      ,112,131,243,608,559,1167
00109400,UNIVERSITY OF THE OZARKS                ,AR,72830-2880,Private      ,101,51,152,849,158,1007
00109500,CROWLEYS RIDGE COLLEGE                  ,AR,72450-9775,Private      ,65,62,127,240,148,388
00109700,HARDING UNIVERSITY                      ,AR,72149-0001,Private      ,504,402,906,3942,1699,5641
00109800,HENDERSON STATE UNIVERSITY              ,AR,71999-0001,Public       ,477,404,881,3661,1671,5332
00109900,HENDRIX COLLEGE                         ,AR,72032-3080,Private      ,107,59,166,2131,276,2407
00110000,JOHN BROWN UNIVERSITY                   ,AR,72761-2747,Private      ,113,346,459,1614,1250,2864
00110100,UNIV ARKANSAS LITTLE ROCK               ,AR,72204-1099,Public       ,744,2183,2927,5292,8920,14212
00110200,OUACHITA BAPTIST UNIVERSITY             ,AR,71998-0001,Private      ,201,49,250,1777,207,1984
00110300,PHILANDER SMITH COLLEGE                 ,AR,72202-3718,Private      ,171,222,393,987,715,1702
00110400,PHILLIPS COUNTY COMMUNITY COLLEGE       ,AR,72342-0000,Public       ,145,285,430,443,656,1099
00110500,SHORTER COLLEGE                         ,AR,72114-4885,Private      ,26,226,252,73,619,692
00110600,WILLIAMS BAPTIST COLLEGE                ,AR,72476-4661,Private      ,51,44,95,583,160,743
00110700,SOUTHERN ARKANSAS UNIVERSITY            ,AR,71754-0000,Public       ,419,441,860,3122,1738,4860
00110800,UNIV ARKANSAS FAYETTEVILLE              ,AR,72701-0000,Public       ,2247,1694,3941,18253,6852,25105
00110900,UNIVERSITY OF ARKANSAS FOR MEDICAL SCIEN,AR,72205-7102,Public       ,78,471,549,601,3128,3729
00111000,UNIVERSITY OF ARKANSAS-FORT SMITH       ,AR,72904-7397,Public       ,526,791,1317,4282,3603,7885
00524500,U OF A COMM COLLEGE AT MORRILTON        ,AR,72110-9601,Public       ,159,367,526,1287,1640,2927
00570700,SEARK COLLEGE                           ,AR,71603-0000,Public       ,170,555,725,671,1659,2330
00573200,UNIV AR COMMUNITY COLLEGE AT HOPE       ,AR,71801-0000,Public       ,98,326,424,563,962,1525
00704400,CROWLEYS RIDGE TECHNICAL INSTITUTE      ,AR,72336-0000,Public       ,68,101,169,146,269,415
00732967,ITT TECHNICAL INSTITUTE                 ,AR,72204-7739,Proprietary  ,32,180,212,168,621,789
00773800,SOUTHERN ARKANSAS UNIVERSITY TECH       ,AR,71701-1900,Public       ,91,216,307,507,764,1271
00792100,PAUL MITCHELL THE SCHOOL ARKANSAS       ,AR,72701-0000,Proprietary  ,24,43,67,81,133,214
00997600,COLLEGE OF THE OUACHITAS                ,AR,72104-0816,Public       ,81,269,350,390,919,1309
01074100,MELLIE'S BEAUTY COLLEGE                 ,AR,72901-3833,Proprietary  ,18,37,55,53,153,206
01210500,NATIONAL PARK COMMUNITY COLLEGE         ,AR,71913-9174,Public       ,308,713,1021,1071,1911,2982
01226000,EAST ARKANSAS COMMUNITY COLLEGE         ,AR,72335-2204,Public       ,132,202,334,447,572,1019
01226100,NORTH ARKANSAS COLLEGE                  ,AR,72601-5508,Public       ,133,343,476,916,1358,2274
01286000,ARKANSAS NORTHEASTERN COLLEGE           ,AR,72316-1109,Public       ,162,401,563,704,1012,1716
02052200,BLACK RIVER TECHNICAL COLLEGE           ,AR,72455-0000,Public       ,173,493,666,718,1336,2054
02073500,UNIVERSITY OF ARKANSAS COMMUNITY COLLEGE,AR,72503-0000,Public       ,108,326,434,573,926,1499
02073700,NORTHWEST TECHNICAL INSTITUTE           ,AR,72765-0000,Public       ,52,147,199,244,477,721
02074600,SOUTH ARKANSAS COMMUNITY COLLEGE        ,AR,71731-0000,Public       ,136,462,598,618,1558,2176
02075300,PULASKI TECHNICAL COLLEGE               ,AR,72118-0000,Public       ,757,2428,3185,3401,9062,12463
02087000,OZARKA COLLEGE                          ,AR,72556-0000,Public       ,85,290,375,376,875,1251
02111100,RICH MOUNTAIN COMMUNITY COLLEGE         ,AR,71953-0000,Public       ,56,166,222,343,404,747
02202400,PROFESSIONAL COSMETOLOGY EDUC CTR       ,AR,71730-5828,Proprietary  ,5,17,22,33,82,115
02220900,COSSATOT COMMUNITY COLLEGE              ,AR,71832-0000,Public       ,64,173,237,514,702,1216
02272400,EASTERN COLLEGE OF HEALTH VOCATIONS     ,AR,72205-3535,Proprietary  ,60,204,264,152,534,686
02284200,NEW TYLER BARBER COLLEGE INC            ,AR,72114-0000,Proprietary  ,13,47,60,35,123,158
02330800,JEFFERSON SCHOOL OF NURSING             ,AR,71603-0000,Private      ,10,55,65,78,203,281
02339800,SOUTHERN INSTITUTE OF COSMETOLOGY       ,AR,72301-0000,Proprietary  ,10,21,31,16,47,63
02341700,CAREER ACADEMY OF HAIR DESIGN           ,AR,72764-4304,Proprietary  ,13,44,57,34,107,141
02341701,CAREER ACADEMY OF HAIR DESIGN - ROGERS  ,AR,72756-2102,Proprietary  ,14,26,40,36,75,111
02341702,CAREER ACADEMY OF HAIR DESIGN - SILOAM  ,AR,72761-4217,Proprietary  ,5,9,14,14,38,52
02341703,CAREER ACADEMY OF HAIR DESIGN - FAYETTEV,AR,72701-7731,Proprietary  ,8,16,24,28,66,94
02348200,MID-SOUTH COMMUNITY COLLEGE             ,AR,72301-0000,Public       ,232,493,725,644,1272,1916
02363500,ARTHUR'S BEAUTY COLLEGE                 ,AR,72901-0000,Proprietary  ,16,44,60,57,185,242
02525800,LEE'S SCHOOL OF COSMETOLOGY             ,AR,72114-0000,Proprietary  ,1,16,17,24,73,97
02538500,ARTHUR'S BEAUTY COLLEGE                 ,AR,72076-0000,Proprietary  ,23,60,83,72,206,278
02569600,SEARCY BEAUTY COLLEGE                   ,AR,72143-0000,Proprietary  ,7,31,38,23,98,121
03005100,ARKANSAS BEAUTY SCHOOL                  ,AR,72209-5116,Proprietary  ,21,82,103,65,242,307
03007100,HOT SPRINGS BEAUTY COLLEGE              ,AR,71901-5432,Proprietary  ,8,41,49,37,116,153
03007600,ARKANSAS BEAUTY SCHOOL-CONWAY           ,AR,72032-4354,Proprietary  ,0,0,0,15,31,46
03023400,ARKANSAS COLLEGE OF BARBERING           ,AR,72114-5615,Proprietary  ,24,140,164,60,285,345
03063300,NORTHWEST ARKANSAS COMMUNITY COLLEG     ,AR,72712-5190,Public       ,716,1135,1851,3480,4357,7837
03065100,ABC BEAUTY COLLEGE                      ,AR,71923-4206,Proprietary  ,7,18,25,21,62,83
03066302,BRYAN UNIVERSITY - ROGERS               ,AR,72756-1825,Proprietary  ,16,58,74,62,252,314
03105200,BAPTIST HEALTH SCHOOLS LITTLE ROCK      ,AR,72210-2820,Private      ,51,265,316,469,1467,1936
03115102,HERITAGE COLLEGE - LITTLE ROCK          ,AR,72227-5544,Proprietary  ,66,243,309,181,746,927
03124900,IMAGINE -  PAUL MITCHELL PARTNER SCHOOL ,AR,72117-2516,Proprietary  ,37,89,126,165,339,504
03214300,VELVATEX COLLEGE OF BEAUTY CULTURE      ,AR,72202-5452,Proprietary  ,3,27,30,11,59,70
03254300,MARGARET'S HAIR ACADEMY                 ,AR,71655-4905,Proprietary  ,2,18,20,14,79,93
03855300,ECCLESIA COLLEGE                        ,AR,72762-8159,Private      ,53,63,116,172,152,324
03912300,CROSSETT SCHOOL OF COSMETOLOGY          ,AR,71635-0000,Proprietary  ,6,8,14,13,24,37
03997300,ARKANSAS BEAUTY COLLEGE                 ,AR,72801-3741,Proprietary  ,5,15,20,24,55,79
04183100,WASHINGTON BARBER COLLEGE               ,AR,72209-3820,Proprietary  ,16,73,89,38,150,188
04183400,SALON PROFESSIONAL ACADEMY (THE)        ,AR,72116-7310,Proprietary  ,12,41,53,54,123,177
04203400,ARKANSAS STATE UNIVERSITY - NEWPORT     ,AR,72112-9073,Public       ,182,485,667,970,1524,2494
04220000,DESIGNER BARBER & STYLIST SCHOOL        ,AR,72903-3753,Proprietary  ,4,24,28,18,77,95
04238900,"BEAUTY SCHOOL, (THE)                    ",AR,72653-3275,Proprietary  ,3,21,24,7,30,37
04241800,ACADEMY OF PROFESSIONAL COSMETOLOGY     ,AR,72756-2028,Proprietary  ,8,13,21,32,56,88
04241900,RIVER VALLEY SCHOOL OF MASSAGE          ,AR,72802-2310,Proprietary  ,1,15,16,1,15,16
04247600,NEW BEGINNINGS BEAUTY ACADEMY           ,AR,71601-5257,Proprietary  ,3,25,28,4,36,40
00133900,CORBAN UNIVERSITY                       ,OR,97301-9392,Private      ,72,90,162,2052,649,2701
00318600,BLUE MOUNTAIN COMMUNITY COLLEGE         ,OR,97801-0000,Public       ,161,320,481,1158,1379,2537
00318800,CENTRAL OREGON COMMUNITY COLLEGE        ,OR,97701-5998,Public       ,395,904,1299,2973,4557,7530
00318900,CLATSOP COMMUNITY COLLEGE               ,OR,97103-3698,Public       ,55,146,201,435,706,1141
00319100,CONCORDIA UNIVERSITY                    ,OR,97211-6099,Private      ,112,2308,2420,2081,8808,10889
00319300,EASTERN OREGON UNIVERSITY               ,OR,97850-2899,Public       ,147,356,503,2805,2630,5435
00319400,GEORGE FOX UNIVERSITY                   ,OR,97132-2697,Private      ,191,461,652,4223,2176,6399
00319600,LANE COMMUNITY COLLEGE                  ,OR,97405-0640,Public       ,688,1436,2124,5521,8261,13782
00319700,LEWIS & CLARK COLLEGE                   ,OR,97219-7899,Private      ,103,196,299,5895,3048,8943
00319800,LINFIELD COLLEGE                        ,OR,97128-6894,Private      ,92,129,221,3542,945,4487
00319801,LINFIELD COLLEGE - PORTLAND CAMPUS      ,OR,97210-0000,Private      ,43,118,161,735,991,1726
00319900,MARYLHURST UNIVERSITY                   ,OR,97036-7036,Private      ,12,248,260,136,1150,1286
00320300,MOUNT ANGEL SEMINARY                    ,OR,97373-9700,Private      ,7,5,12,18,18,36
00320400,MOUNT HOOD COMMUNITY COLLEGE            ,OR,97030-3300,Public       ,566,1192,1758,4807,6948,11755
00320600,MULTNOMAH UNIVERSITY                    ,OR,97220-5898,Private      ,55,185,240,531,804,1335
00320700,PACIFIC NORTHWEST COLLEGE OF ART        ,OR,97209-3023,Private      ,50,91,141,729,633,1362
00320800,NORTHWEST CHRISTIAN UNIVERSITY          ,OR,97401-3727,Private      ,46,137,183,688,784,1472
00320900,WESTERN OREGON UNIVERSITY               ,OR,97361-1394,Public       ,319,361,680,7380,2941,10321
00321000,OREGON STATE UNIVERSITY                 ,OR,97331-8507,Public       ,1244,2054,3298,26767,14806,41573
00321100,OREGON INSTITUTE OF TECHNOLOGY          ,OR,97601-8801,Public       ,187,369,556,3046,2553,5599
00321200,PACIFIC UNIVERSITY                      ,OR,97116-1797,Private      ,114,224,338,4216,3303,7519
00321300,PORTLAND COMMUNITY COLLEGE              ,OR,97219-7198,Public       ,1978,4966,6944,14081,27979,42060
00321600,PORTLAND STATE UNIVERSITY               ,OR,97207-0000,Public       ,1215,3015,4230,17763,22736,40499
00321700,REED COLLEGE                            ,OR,97202-8199,Private      ,51,98,149,4042,680,4722
00321800,CHEMEKETA COMMUNITY COLLEGE             ,OR,97309-1500,Public       ,678,1542,2220,6289,9511,15800
00321900,SOUTHERN OREGON UNIVERSITY              ,OR,97520-5010,Public       ,299,450,749,5772,3325,9097
00322000,SOUTHWESTERN OREGON COMMUNITY CLG       ,OR,97420-2956,Public       ,125,225,350,1604,1334,2938
00322100,TREASURE VALLEY COMMUNITY COLLEGE       ,OR,97914-3423,Public       ,248,459,707,1354,1673,3027
00322200,UMPQUA COMMUNITY COLLEGE                ,OR,97470-0226,Public       ,139,390,529,1117,1902,3019
00322300,UNIVERSITY OF OREGON                    ,OR,97403-1226,Public       ,1282,1051,2333,26383,9675,36058
00322400,UNIVERSITY OF PORTLAND                  ,OR,97203-5798,Private      ,263,308,571,11174,2796,13970
00322500,WARNER PACIFIC COLLEGE                  ,OR,97215-4099,Private      ,50,262,312,1262,1549,2811
00322700,WILLAMETTE UNIVERSITY                   ,OR,97301-3930,Private      ,89,122,211,5056,1310,6366
00487800,CLACKAMAS COMMUNITY COLLEGE             ,OR,97045-7998,Public       ,464,847,1311,3790,4859,8649
00488200,OREGON HEALTH & SCIENCE UNIVERSITY      ,OR,97239-0000,Public       ,64,316,380,1080,4364,5444
00693800,LINN BENTON COMMUNITY COLLEGE           ,OR,97321-3774,Public       ,359,674,1033,3555,4190,7745
00717800,WESTERN SEMINARY                        ,OR,97215-0000,Private      ,2,119,121,14,527,541
00723402,HEALD COLLEGE - PORTLAND                ,OR,97205-3432,Proprietary  ,5,36,41,118,448,566
00732969,ITT TECHNICAL INSTITUTE                 ,OR,97220-6819,Proprietary  ,60,360,420,388,1650,2038
00781900,ART INSTITUTE OF PORTLAND (THE)         ,OR,97209-2911,Proprietary  ,169,259,428,1397,1440,2837
00888700,CONCORDE CAREER INSTITUTE               ,OR,97232-2242,Proprietary  ,72,157,229,304,772,1076
00907900,EVEREST COLLEGE                         ,OR,97204-2296,Private      ,24,131,155,158,579,737
00958100,SPRINGFIELD COLLEGE OF BEAUTY           ,OR,97477-5474,Proprietary  ,8,32,40,51,153,204
01012200,PHAGANS' MEDFORD BEAUTY SCHOOL          ,OR,97504-5297,Proprietary  ,8,44,52,40,151,191
01018200,ROGUE COMMUNITY COLLEGE                 ,OR,97527-0000,Public       ,329,1033,1362,2537,5280,7817
01050700,ACADEMY OF HAIR DESIGN                  ,OR,97301-3526,Proprietary  ,9,44,53,59,182,241
01230900,UNIVERSITY OF WESTERN STATES            ,OR,97230-3099,Private      ,10,132,142,144,803,947
01234700,PHAGANS CENTRAL OREGON BEAUTY CLG       ,OR,97701-5175,Proprietary  ,25,44,69,84,181,265
01234800,PHAGANS BEAUTY COLLEGE                  ,OR,97333-4716,Proprietary  ,12,22,34,77,95,172
01235000,PHAGANS SCHOOL OF HAIR DESIGN           ,OR,97086-7721,Proprietary  ,18,43,61,94,181,275
01235100,PHAGANS SCHOOL OF BEAUTY                ,OR,97301-4732,Proprietary  ,9,37,46,72,190,262
01300800,PHAGANS TIGARD BEAUTY SCHOOL            ,OR,97223-0000,Proprietary  ,4,14,18,22,64,86
02101000,NORTHWEST COLLEGE OF HAIR DESIGN        ,OR,97086-7702,Proprietary  ,60,158,218,209,521,730
02101002,NORTHWEST COLLEGE                       ,OR,97007-3954,Proprietary  ,2,28,30,29,79,108
02104900,SUMNER COLLEGE                          ,OR,97219-4063,Proprietary  ,22,89,111,78,478,556
02106100,COLLEGE OF COSMETOLOGY                  ,OR,97601-0000,Proprietary  ,5,25,30,37,95,132
02154400,BEAU MONDE CLG OF HAIR DESIGN           ,OR,97205-0000,Proprietary  ,21,46,67,97,218,315
02154401,BEAU MONDE COLLEGE OF HAIR DESIGN - BEAU,OR,97232-1315,Proprietary  ,12,44,56,79,154,233
02159700,NEW HOPE CHRISTIAN COLLEGE              ,OR,97405-1194,Private      ,39,45,84,218,235,453
02201900,PHAGANS' SCHOOL OF HAIR DESIGN          ,OR,97232-0000,Proprietary  ,17,62,79,105,284,389
02311000,PAUL MITCHELL THE SCHOOL                ,OR,97205-3724,Proprietary  ,34,80,114,208,301,509
02330100,PIONEER PACIFIC COLLEGE                 ,OR,97070-0000,Proprietary  ,64,213,277,297,882,1179
02330102,PIONEER PACIFIC COLLEGE                 ,OR,97403-0000,Proprietary  ,32,165,197,202,816,1018
02337900,COLLEGE OF HAIR DESIGN CAREERS          ,OR,97301-0000,Proprietary  ,10,35,45,62,159,221
02344100,ROSEBURG BEAUTY COLLEGE                 ,OR,97470-0000,Proprietary  ,7,22,29,35,91,126
02534000,NATIONAL COLLEGE OF NATURAL MEDICINE    ,OR,97201-0000,Private      ,12,80,92,70,1069,1139
02578800,NORTHWEST NANNIES INSTITUTE             ,OR,97035-0000,Proprietary  ,2,1,3,11,12,23
02603700,OREGON COL OF ORIENTAL MEDICINE         ,OR,97216-0000,Private      ,5,43,48,39,430,469
02617506,EVEREST COLLEGE - EVEREST INSTITUTE     ,OR,97223-6581,Private      ,28,80,108,94,265,359
03007300,OREGON COLLEGE OF ART & CRAFT           ,OR,97225-6399,Private      ,24,62,86,285,439,724
03022600,LE CORDON BLEU COLLEGE OF CULINARY ARTS ,OR,97205-2793,Proprietary  ,79,233,312,501,1005,1506
03042500,CARRINGTON COLLEGE                      ,OR,97232-1302,Proprietary  ,65,186,251,234,723,957
03074400,PHAGANS NEWPORT ACAD CSMTLGY CAREER     ,OR,97365-4963,Proprietary  ,11,15,26,27,43,70
03074500,EAST-WEST COLLEGE OF THE HEALING ARTS   ,OR,97232-2765,Proprietary  ,14,87,101,66,345,411
03185300,PHAGANS GRANTS PASS COLLEGE OF BTY      ,OR,97527-0000,Proprietary  ,7,25,32,43,85,128
03428300,KLAMATH COMMUNITY COLLEGE               ,OR,97603-7121,Public       ,103,284,387,645,1269,1914
03642300,INSTITUTE OF TECHNOLOGY                 ,OR,97305-1373,Proprietary  ,34,139,173,181,513,694
03668300,BIRTHINGWAY COLLEGE OF MIDWIFERY        ,OR,97266-4042,Private      ,3,41,44,40,245,285
03783400,ABDILL CAREER COLLEGE                   ,OR,97504-7137,Proprietary  ,11,84,95,58,291,349
04146500,PORTLAND ACTORS CONSERVATORY            ,OR,97201-2557,Private      ,6,25,31,47,137,184
04151900,COLUMBIA GORGE COMMUNITY COLLEGE        ,OR,97058-3434,Public       ,61,169,230,509,758,1267
04167400,SAGE SCHOOL OF MASSAGE & HEALING ARTS   ,OR,97701-4082,Proprietary  ,3,33,36,25,116,141
04171400,AVEDA INSTITUTE PORTLAND                ,OR,97209-3144,Proprietary  ,55,96,151,330,473,803
04194400,AMERICAN COLLEGE OF HEALTHCARE SCIENCES ,OR,97239-3719,Proprietary  ,23,347,370,192,1304,1496
04194900,TILLAMOOK BAY COMMUNITY COLLEGE         ,OR,97141-2807,Public       ,21,63,84,180,321,501
00137400,ALBERTUS MAGNUS COLLEGE                 ,CT,06511-1189,Private      ,59,377,436,946,1847,2793
00137800,CENTRAL CONNECTICUT STATE UNIV          ,CT,06050-2490,Public       ,646,920,1566,11893,5123,17016
00137900,CONNECTICUT COLLEGE                     ,CT,06320-4196,Private      ,47,39,86,3184,201,3385
00138000,WESTERN CONNECTICUT STATE UNIV          ,CT,06810-6826,Public       ,349,316,665,6689,2037,8726
00138500,FAIRFIELD UNIVERSITY                    ,CT,06430-0000,Private      ,103,168,271,7972,1041,9013
00138700,HARTFORD SEMINARY                       ,CT,06105-0000,Private      ,0,25,25,27,100,127
00138900,HOLY APOSTLES COLLEGE & SEMINARY        ,CT,06416-2027,Private      ,6,27,33,28,94,122
00139200,MANCHESTER COMMUNITY COLLEGE            ,CT,06045-1046,Public       ,803,1045,1848,3880,3773,7653
00139300,MITCHELL COLLEGE                        ,CT,06320-4498,Private      ,66,43,109,832,253,1085
00139700,UNIVERSITY OF NEW HAVEN                 ,CT,06516-1999,Private      ,245,384,629,10476,2233,12709
00139728,LYME ACADEMY COLLEGE OF FINE ARTS       ,CT,06371-2333,Private      ,0,0,0,78,24,102
00139800,NORTHWESTERN CT COMMUNITY COLLEGE       ,CT,06098-1747,Public       ,113,155,268,559,632,1191
00139900,NORWALK COMMUNITY TECHNICAL COLLEGE     ,CT,06854-1655,Public       ,633,758,1391,2482,2845,5327
00140100,POST UNIVERSITY                         ,CT,06723-3240,Proprietary  ,276,3239,3515,1694,10705,12399
00140200,QUINNIPIAC UNIVERSITY                   ,CT,06518-1908,Private      ,269,397,666,17327,3539,20866
00140300,SACRED HEART UNIVERSITY                 ,CT,06825-1000,Private      ,145,608,753,8877,3145,12022
00140600,SOUTHERN CONNECTICUT STATE UNIV         ,CT,06515-1355,Public       ,467,719,1186,11347,5383,16730
00140900,UNIVERSITY OF SAINT JOSEPH              ,CT,06117-2791,Private      ,48,361,409,1124,1899,3023
00141400,TRINITY COLLEGE                         ,CT,06106-3100,Private      ,65,40,105,3483,366,3849
00141600,UNIVERSITY OF BRIDGEPORT                ,CT,06601-5650,Private      ,211,562,773,3434,3415,6849
00141700,UNIVERSITY OF CONNECTICUT-STORRS        ,CT,06269-2151,Public       ,586,590,1176,34055,5851,39906
00141702,UNIV CONN STAMFORD                      ,CT,06901-0000,Public       ,62,102,164,1052,638,1690
00141703,UNIV OF CONNECTICUT - TORINGTON         ,CT,06790-0000,Public       ,13,22,35,347,136,483
00141706,UNIV OF CONNECTICUT SCH LAW             ,CT,06105-0000,Public       ,6,34,40,68,834,902
00141707,UNIV OF CT - SCH OF SOCIAL WORK         ,CT,06117-0000,Public       ,7,36,43,148,523,671
00141708,UNIVERSITY OF CONNECTICUT - SCHOOL OF ME,CT,06030-1920,Public       ,8,34,42,172,559,731
00141709,UNIVERSITY OF CONNECTICUT - SCHOOL OF DE,CT,06030-1920,Public       ,11,23,34,296,297,593
00142200,UNIVERSITY OF HARTFORD                  ,CT,06117-1599,Private      ,399,339,738,10718,2314,13032
00142400,WESLEYAN UNIVERSITY                     ,CT,06459-3208,Private      ,80,29,109,5202,303,5505
00142500,EASTERN CONNECTICUT STATE UNIV          ,CT,06226-2295,Public       ,211,248,459,7040,1414,8454
00142600,YALE UNIVERSITY                         ,CT,06520-8288,Private      ,354,401,755,17636,7653,25289
00280301,RENSSELAER POLYTECHNIC INSTITUTE-RENSSEL,CT,06120-2991,Private      ,1,6,7,28,23,51
00451300,HOUSATONIC COMMUNITY COLLEGE            ,CT,06604-4704,Public       ,664,1014,1678,2778,4072,6850
00618100,BRIDGEPORT HOSP SCHL OF NURSING         ,CT,06610-2896,Private      ,32,103,135,185,556,741
00619100,ST. VINCENT'S COLLEGE                   ,CT,06606-9966,Private      ,51,245,296,273,881,1154
00698200,NAUGATUCK VALLEY COMM-TECH COLG         ,CT,06708-3089,Public       ,768,995,1763,3307,3845,7152
00730000,ELI WHITNEY TECHNICAL HIGH SCHOOL       ,CT,06514-0000,Public       ,3,20,23,16,74,90
00730300,LINCOLN TECHNICAL INSTITUTE             ,CT,06051-0000,Proprietary  ,105,271,376,381,933,1314
00730306,LINCOLN TECHNICAL INSTITUTE - EAST WINDS,CT,06088-9631,Proprietary  ,107,89,196,703,439,1142
00730500,PORTER AND CHESTER INSTITUTE OF BRANFORD,CT,06405-4022,Proprietary  ,50,71,121,211,334,545
00731100,WINDHAM TECHNICAL HIGH SCHOOL           ,CT,06226-2100,Public       ,2,6,8,4,12,16
00745900,PAIER COLLEGE OF ART                    ,CT,06514-3902,Proprietary  ,19,21,40,107,60,167
00763500,CAPITAL COMMUNITY COLLEGE               ,CT,06103-1207,Public       ,437,1088,1525,1700,3816,5516
00803700,GATEWAY COMMUNITY-TECHNICAL COLLEGE     ,CT,06511-0000,Public       ,886,1395,2281,3744,5497,9241
00803800,MIDDLESEX COMMUNITY CLG                 ,CT,06457-4889,Public       ,361,463,824,1320,1676,2996
00887300,PAUL MITCHELL THE SCHOOL                ,CT,06810-6716,Proprietary  ,27,21,48,111,76,187
00887400,MARINELLO SCHOOL OF BEAUTY              ,CT,06450-4836,Proprietary  ,19,44,63,40,110,150
00887401,MARINELLO SCHOOL OF BEAUTY - HAMDEN     ,CT,06514-4132,Proprietary  ,15,43,58,25,77,102
00887402,MARINELLO SCHOOL OF BEAUTY - FAIRFIELD  ,CT,06825-4847,Proprietary  ,27,61,88,61,143,204
00887403,MARINELLO SCHOOL OF BEAUTY - WILLIMANTIC,CT,06226-1940,Proprietary  ,11,34,45,25,67,92
00927700,E C GOODWIN TECHNICAL HIGH SCHOOL       ,CT,06053-0000,Public       ,9,14,23,37,53,90
00940700,LINCOLN COLLEGE OF NEW ENGLAND          ,CT,06489-1057,Proprietary  ,72,134,206,487,603,1090
00976400,TUNXIS COMMUNITY COLLEGE                ,CT,06032-3187,Public       ,421,572,993,2148,2070,4218
00976500,THREE RIVERS COMMUNITY COLLEGE          ,CT,06360-6598,Public       ,375,703,1078,1885,2661,4546
00982200,ALBERT I PRINCE TECHNICAL HIGH SCHOOL   ,CT,06106-3799,Public       ,8,33,41,27,112,139
01041700,MARINELLO SCHOOL OF BEAUTY              ,CT,06108-2220,Proprietary  ,45,119,164,109,266,375
01053000,QUINEBAUG VALLEY COMMUNITY COLLEGE      ,CT,06239-1440,Public       ,171,307,478,850,1073,1923
01077900,PORTER AND CHESTER INSTITUTE-ALLCAMPUSES,CT,06615-7158,Proprietary  ,272,502,774,1211,2318,3529
01115000,ASNUNTUCK COMMUNITY COLLEGE             ,CT,06082-3800,Public       ,214,302,516,609,811,1420
01149600,BULLARD HAVENS VOC TECH SCHOOL          ,CT,06610-3499,Public       ,6,29,35,24,134,158
01169700,VINAL REGIONAL VOC TECH SCHOOL          ,CT,06457-4918,Public       ,1,15,16,5,43,48
01184300,NORWICH TECHNICAL HIGH SCHOOL           ,CT,06360-7097,Public       ,5,14,19,18,73,91
01242500,STONE ACADEMY                           ,CT,06516-4049,Proprietary  ,83,439,522,191,1000,1191
01242503,STONE ACADEMY -WATERBURY                ,CT,06705-3823,Proprietary  ,10,28,38,33,105,138
01242504,STONE ACADEMY -  EAST HARTFORD          ,CT,06118-0000,Proprietary  ,12,49,61,50,176,226
02074000,BRANFORD HALL CAREER INSTITUTE          ,CT,06405-0000,Proprietary  ,274,988,1262,579,2332,2911
02106600,AMERICAN INSTITUTE                      ,CT,06110-1922,Proprietary  ,36,166,202,93,401,494
02112300,RIDLEY LOWELL BUSINESS & TECH INST      ,CT,06320-0000,Proprietary  ,32,131,163,115,486,601
02112700,NORTH HAVEN ACADEMY                     ,CT,06473-3108,Proprietary  ,37,35,72,98,88,186
02148700,CONNECTICUT INST OF HAIR DESIGN         ,CT,06716-0000,Proprietary  ,7,5,12,11,48,59
02202500,NEW ENGLAND TRACTOR TRAILER SCH         ,CT,06071-2036,Proprietary  ,42,446,488,81,850,931
02244900,GOODWIN COLLEGE                         ,CT,06118-9980,Private      ,325,1418,1743,1156,4490,5646
02245300,HOWELL CHENEY TECHNICAL HIGH SCHOOL     ,CT,06040-0000,Public       ,1,8,9,11,23,34
02265900,WINDHAM COMMUNITY MEM HOSP-RAD TECH     ,CT,06226-0000,Private      ,0,3,3,9,23,32
02296100,YALE-NEW HAVEN HOSP DIETETIC INTERN     ,CT,06510-8900,Private      ,2,12,14,10,56,66
02300000,W F KAYNOR TECHNICAL HIGH SCHOOL        ,CT,06708-0000,Public       ,1,8,9,11,66,77
02316600,CONNECTICUT CTR FOR MASSAGE THERAPY     ,CT,06111-3975,Proprietary  ,22,58,80,52,142,194
02316601,CONNECTICUT CENTER FOR MASSAGE THERAPY -,CT,06880-4619,Proprietary  ,14,42,56,25,82,107
02316603,CONNECTICUT CENTER FOR MASSAGE THERAPY -,CT,06340-4619,Proprietary  ,14,29,43,28,70,98
02565000,PLATT TECHNICAL HIGH SCHOOL             ,CT,06460-2105,Public       ,2,14,16,11,30,41
03094800,INDUSTRIAL MANAGEMENT & TRAINING        ,CT,06706-1211,Proprietary  ,11,35,46,22,102,124
03234300,CHARTER OAK STATE COLLEGE               ,CT,06053-2150,Public       ,28,468,496,141,1947,2088
03316300,LINCOLN TECHNICAL INSTITUTE - HARTFORD  ,CT,06105-3630,Proprietary  ,43,83,126,265,307,572
03927300,MARINELLO SCHOOL OF BEAUTY              ,CT,06357-2447,Proprietary  ,7,19,26,18,45,63
03927301,MARINELLO SCHOOL OF BEAUTY  - TORRINGTON,CT,06790-5425,Proprietary  ,5,14,19,18,32,50
04104300,ACADEMY DI CAPELLI - SCHOOL OF COSMETOLO,CT,06492-0000,Proprietary  ,16,31,47,45,69,114
04128800,BRANFORD ACADEMY OF HAIR & COSMETOLOGY  ,CT,06405-0000,Proprietary  ,8,14,22,26,46,72
04145400,OXFORD ACADEMY OF HAIR DESIGN           ,CT,06483-2911,Proprietary  ,15,22,37,30,48,78
04148400,EUROPEAN ACADEMY OF COSMETOLOGY AND HAIR,CT,06437-0000,Proprietary  ,9,7,16,21,13,34
04152400,INTERNATIONAL INSTITUTE OF COSMETOLOGY  ,CT,06109-0000,Proprietary  ,26,36,62,82,75,157
04219200,ACE COSMETOLOGY & BARBERING TRAINING CEN,CT,06716-0000,Proprietary  ,2,13,15,11,36,47
04224200,BELLE ACADEMY OF COSMETOLOGY            ,CT,06704-0135,Proprietary  ,6,20,26,19,66,85
04230900,RICCI'S ACADEMY OF COSMETOLOGY          ,CT,06470-0000,Proprietary  ,22,15,37,44,38,82
04249800,DOLCE LLC THE ACADEMY                   ,CT,06705-2685,Proprietary  ,5,23,28,5,23,28
00146600,BARRY UNIVERSITY                        ,FL,33161-6695,Private      ,389,1513,1902,4497,7372,11869
00146601,BARRY UNIVERSITY - ORLANDO              ,FL,32807-3673,Private      ,60,432,492,386,1765,2151
00146700,BETHUNE COOKMAN UNIVERSITY              ,FL,32114-3099,Private      ,696,389,1085,7652,2039,9691
00146800,ST THOMAS UNIVERSITY                    ,FL,33054-0000,Private      ,164,911,1075,1453,2925,4378
00146900,FLORIDA INSTITUTE OF TECHNOLOGY         ,FL,32901-6988,Private      ,479,1693,2172,5037,7336,12373
00147000,EASTERN FLORIDA STATE COLLEGE           ,FL,32922-6503,Public       ,1547,2740,4287,5687,8947,14634
00147100,COLLEGE OF CENTRAL FLORIDA              ,FL,34474-4415,Public       ,856,1507,2363,4135,6170,10305
00147200,CHIPOLA  COLLEGE                        ,FL,32446-2053,Public       ,227,346,573,995,1165,2160
00147300,CLEARWATER CHRISTIAN COLLEGE            ,FL,33759-0000,Private      ,6,20,26,492,154,646
00147500,DAYTONA STATE COLLEGE                   ,FL,32114-2800,Public       ,1893,3162,5055,7224,10511,17735
00147700,FLORIDA SOUTHWESTERN STATE COLLEGE      ,FL,33919-5566,Public       ,1695,2004,3699,7815,8103,15918
00147800,EDWARD WATERS COLLEGE                   ,FL,32209-6199,Private      ,234,308,542,1355,1048,2403
00147900,EMBRY-RIDDLE AERONAUTICAL UNIV          ,FL,32114-3900,Private      ,712,2527,3239,7973,9109,17082
00148000,FLORIDA A & M UNIVERSITY                ,FL,32307-3100,Public       ,1458,1391,2849,15535,7729,23264
00148100,FLORIDA ATLANTIC UNIVERSITY             ,FL,33431-6498,Public       ,2939,3418,6357,26832,16872,43704
00148101,FLORIDA ATLANTIC UNIVERSITY/DAVIE       ,FL,33314-0000,Public       ,444,993,1437,3074,4904,7978
00148103,FLORIDA ATLANTIC UNIV-JUPITER/PSL       ,FL,33458-0000,Public       ,169,285,454,1554,1286,2840
00148200,FLORIDA COLLEGE                         ,FL,33617-5578,Private      ,94,26,120,562,82,644
00148400,FLORIDA STATE COLLEGE AT JACKSONVILLE   ,FL,32202-4030,Public       ,2971,6326,9297,12383,23241,35624
00148500,FLORIDA KEYS COMMUNITY COLLEGE          ,FL,33040-4397,Public       ,127,200,327,556,616,1172
00148600,FLORIDA MEMORIAL UNIVERSITY             ,FL,33054-6199,Private      ,369,341,710,2983,1458,4441
00148700,ECKERD COLLEGE                          ,FL,33711-4744,Private      ,210,223,433,3335,850,4185
00148800,FLORIDA SOUTHERN COLLEGE                ,FL,33801-5698,Private      ,284,359,643,4553,1339,5892
00148900,FLORIDA STATE UNIVERSITY                ,FL,32306-2430,Public       ,4277,2655,6932,47946,17305,65251
00149000,GULF COAST STATE COLLEGE                ,FL,32401-1058,Public       ,507,1122,1629,2386,4160,6546
00149300,INDIAN RIVER STATE COLLEGE              ,FL,34981-5596,Public       ,1570,2533,4103,6770,9350,16120
00149500,JACKSONVILLE UNIVERSITY                 ,FL,32211-3394,Private      ,392,971,1363,3727,3960,7687
00149700,JONES COLLEGE                           ,FL,32205-5395,Private      ,15,189,204,89,737,826
00149900,EVEREST UNIVERSITY                      ,FL,32810-5601,Private      ,91,512,603,367,2976,3343
00149901,EVEREST UNIVERSITY - ORLANDO SOUTH      ,FL,32819-7666,Private      ,205,2243,2448,817,10856,11673
00149902,EVEREST UNIVERSITY - MELBOURNE          ,FL,32905-6609,Private      ,25,179,204,84,690,774
00149904,EVEREST UNIVERSITY - TAMPA              ,FL,33614-5801,Private      ,63,446,509,296,1851,2147
00149905,EVEREST UNIVERSITY - BRANDON            ,FL,33619-1354,Private      ,56,599,655,236,2575,2811
00149906,EVEREST UNIVERSITY - ORANGE PARK        ,FL,32073-1111,Private      ,19,150,169,80,684,764
00149907,EVEREST UNIVERSITY - LARGO              ,FL,33770-2556,Private      ,18,102,120,63,491,554
00149908,EVEREST UNIVERSITY - LAKELAND           ,FL,33801-3801,Private      ,52,166,218,144,693,837
00149909,EVEREST UNIVERSITY - JACKSONVILLE       ,FL,32256-0000,Private      ,49,325,374,222,1197,1419
00149910,EVEREST UNIVERSITY - POMPANO            ,FL,33062-2522,Private      ,32,367,399,114,1303,1417
00150000,BROWARD COLLEGE- DOWNTOWN CTR           ,FL,33301-2298,Public       ,5625,8189,13814,23743,31338,55081
00150100,FLORIDA GATEWAY COLLEGE                 ,FL,32025-2007,Public       ,295,634,929,1117,2094,3211
00150200,LAKE SUMTER COMMUNITY COLLEGE           ,FL,34788-8751,Public       ,443,589,1032,2426,2610,5036
00150400,"STATE COLLEGE OF FLORIDA, MANATEE-SARASO",FL,34207-3596,Public       ,1027,1531,2558,4877,6288,11165
00150500,LYNN UNIVERSITY                         ,FL,33431-5598,Private      ,314,316,630,2921,1211,4132
00150600,MIAMI DADE COLLEGE ADMINISTRATION ONLY  ,FL,33176-3393,Public       ,140,229,369,554,838,1392
00150601,MIAMI DADE COLLEGE - NORTH CAMPUS       ,FL,33167-3495,Public       ,2904,4109,7013,13666,14822,28488
00150602,MIAMI DADE COLLEGE - KENDALL CAMPUS     ,FL,33176-3393,Public       ,4445,4034,8479,19795,14463,34258
00150603,MIAMI DADE COLLEGE - WOLFSON CAMPUS     ,FL,33132-2297,Public       ,2612,3204,5816,11593,11089,22682
00150604,MIAMI DADE COLLEGE - MEDICAL CAMPUS     ,FL,33127-4693,Public       ,677,1695,2372,3688,6660,10348
00150605,MIAMI DADE COLLEGE - HOMESTEAD CAMPUS   ,FL,33030-6009,Public       ,789,1033,1822,3294,3705,6999
00150606,MIAMI DADE COLLEGE -INTERAMERICAN CAMPUS,FL,33135-0000,Public       ,1038,1859,2897,4414,6712,11126
00150607,MIAMI DADE COLLEGE - HIALEAH CAMPUS     ,FL,33012-2918,Public       ,1211,1345,2556,5164,4801,9965
00150800,NORTH FLORIDA COMMUNITY COLLEGE         ,FL,32340-1699,Public       ,139,255,394,466,762,1228
00150900,NOVA SOUTHEASTERN UNIVERSITY            ,FL,33314-7796,Private      ,584,4432,5016,6992,25177,32169
00151000,NORTHWEST FLORIDA STATE COLLEGE         ,FL,32578-1295,Public       ,466,1178,1644,1894,3954,5848
00151200,PALM BEACH COMMUNITY COLLEGE            ,FL,33461-4796,Public       ,3813,4386,8199,14730,14653,29383
00151300,PENSACOLA STATE COLLEGE                 ,FL,32504-8998,Public       ,1122,2306,3428,4320,7504,11824
00151400,POLK STATE COLLEGE                      ,FL,33881-4256,Public       ,1198,1964,3162,5089,7747,12836
00151500,ROLLINS COLLEGE                         ,FL,32789-4499,Private      ,179,263,442,3262,1250,4512
00151900,SANTA FE COLLEGE                        ,FL,32606-6200,Public       ,1652,1937,3589,9619,8000,17619
00152000,SEMINOLE STATE COLLEGE OF FLORIDA       ,FL,32773-6199,Public       ,2593,3661,6254,9240,11789,21029
00152100,SOUTHEASTERN UNIVERSITY                 ,FL,33801-6099,Private      ,630,601,1231,4793,2133,6926
00152200,SOUTH FLORIDA COMMUNITY COLLEGE         ,FL,33825-9399,Public       ,322,469,791,1393,1697,3090
00152300,SAINT JOHNS RIVER STATE COLLEGE         ,FL,32177-3897,Public       ,654,981,1635,2771,4021,6792
00152600,SAINT LEO UNIVERSITY                    ,FL,33574-6665,Private      ,376,3398,3774,4709,16353,21062
00152800,ST. PETERSBURG COLLEGE                  ,FL,33760-3768,Public       ,2615,6011,8626,10148,22534,32682
00153100,STETSON UNIVERSITY                      ,FL,32723-3761,Private      ,235,131,366,6622,958,7580
00153101,STETSON UNIVERSITY - COLLEGE OF LAW     ,FL,33707-3299,Private      ,16,269,285,123,1695,1818
00153300,TALLAHASSEE COMMUNITY COLLEGE           ,FL,32304-2895,Public       ,1951,2063,4014,9868,7816,17684
00153500,UNIVERSITY OF FLORIDA                   ,FL,32611-3150,Public       ,3358,3404,6762,46040,21076,67116
00153600,UNIVERSITY OF MIAMI                     ,FL,33146-6531,Private      ,920,928,1848,21857,6266,28123
00153601,UNIV OF MIAMI SCHOOL OF LAW             ,FL,33124-0000,Private      ,9,166,175,155,1643,1798
00153602,UNIV OF MIAMI-SCH OF MEDICINE           ,FL,33136-0000,Private      ,106,179,285,870,1746,2616
00153700,UNIVERSITY OF SOUTH FLORIDA             ,FL,33620-6960,Public       ,3228,4205,7433,41404,24758,66162
00153701,UNIV OF SOUTH FLORIDA-ST PETERSBURG     ,FL,33701-0000,Public       ,422,750,1172,4768,3619,8387
00153702,UNIV OF SOUTH FLORIDA-SARASOTA          ,FL,34243-2025,Public       ,134,323,457,1291,1694,2985
00153705,UNIV OF SOUTH FLORIDA                   ,FL,33803-0000,Public       ,107,177,284,981,885,1866
00153706,UNIV OF SOUTH FLORIDA- MEDICINE         ,FL,33612-0000,Public       ,113,240,353,1308,2273,3581
00153800,UNIVERSITY OF TAMPA                     ,FL,33606-1490,Private      ,878,651,1529,14608,3646,18254
00154000,WEBBER INTERNATIONAL UNIVERSITY         ,FL,33827-0096,Private      ,179,86,265,1429,387,1816
00173308,NATIONAL-LOUIS UNIVERSITY               ,FL,33609-0000,Private      ,4,21,25,24,89,113
00177201,TRINITY INTERNATIONAL UNIVERSITY - SOUTH,FL,33324-4611,Private      ,9,112,121,56,421,477
00395400,UNIV OF CENTRAL FLORIDA                 ,FL,32816-0001,Public       ,6701,6276,12977,68157,32015,100172
00395500,UNIVERSITY OF WEST FLORIDA              ,FL,32514-5750,Public       ,963,1782,2745,9397,8107,17504
00407215,NORTHWOOD UNIVERSITY                    ,FL,33409-0000,Private      ,66,88,154,570,345,915
00491005,KAPLAN COLLEGE JACKSONVILLE             ,FL,32216-3216,Proprietary  ,5,91,96,132,1557,1689
00558500,LIVELY TECHNICAL CENTER                 ,FL,32304-0000,Public       ,213,581,794,547,1614,2161
00558600,LINDSEY HOPKINS TECHNICAL ED CENTER     ,FL,33127-4692,Public       ,90,310,400,275,878,1153
00559400,D G ERWIN TECHNICAL CENTER              ,FL,33610-8255,Public       ,112,415,527,535,1646,2181
00560500,PINELLAS TECH ED CTR-CLEARWATER         ,FL,33760-2194,Public       ,88,336,424,300,1111,1411
00560700,SARASOTA COUNTY TECHNICAL INSTITUTE     ,FL,34233-0000,Public       ,84,204,288,344,752,1096
00560800,MAYNARD A. TRAVISS CAREER CENTER        ,FL,33803-9709,Public       ,107,271,378,349,1015,1364
00561200,MANATEE TECHNICAL INSTITUTE             ,FL,34210-0000,Public       ,139,408,547,452,1214,1666
00561201,MANATEE TECHNICAL INSTITUTE-EAST        ,FL,34211-0000,Public       ,60,192,252,248,661,909
00675000,VALENCIA COMMUNITY COLLEGE              ,FL,32802-3028,Public       ,6598,6877,13475,31323,25573,56896
00732910,ITT TECHNICAL INSTITUTE                 ,FL,33634-7515,Proprietary  ,211,1131,1342,704,3571,4275
00732947,ITT TECHNICAL INSTITUTE                 ,FL,32746-1607,Proprietary  ,102,404,506,314,1529,1843
00736206,MEDTECH COLLEGE - MEDTECH INSTITUTE - OR,FL,32826-4906,Proprietary  ,51,233,284,232,993,1225
00752500,SUWANNEE-HAMILTON AREA VOC TECH CTR     ,FL,32060-0000,Public       ,28,70,98,65,226,291
00752600,WASHINGTON HOLMES TECHNICAL CENTER      ,FL,32428-1699,Public       ,33,102,135,146,373,519
00755800,LEE COUNTY HIGH TECH CENTER CENTRAL     ,FL,33916-2299,Public       ,124,295,419,417,870,1287
00787000,HILLSBOROUGH COMMUNITY COLLEGE          ,FL,33606-3572,Public       ,2210,4120,6330,14818,20707,35525
00789300,FLAGLER COLLEGE                         ,FL,32085-1027,Private      ,315,147,462,4329,732,5061
00789301,FLAGLER COLLEGE - TALLAHASSEE COMMUNITY ,FL,32304-2895,Private      ,79,180,259,491,836,1327
00807500,ST JOHN VIANNEY COLLEGE SEMINARY        ,FL,33165-3244,Private      ,11,6,17,32,28,60
00822300,ST VINCENT DE PAUL REGIONL SEMINARY     ,FL,33436-0000,Private      ,1,1,2,4,9,13
00841700,STENOTYPE INST OF JACKSONVILLE          ,FL,32207-0000,Proprietary  ,6,74,80,20,188,208
00869410,RASMUSSEN COLLEGE - OCALA               ,FL,34471-7051,Proprietary  ,210,1728,1938,784,6699,7483
00869411,RASMUSSEN COLLEGE - NEW PORT RICHEY     ,FL,34690-4554,Proprietary  ,41,232,273,153,1098,1251
00869413,RASMUSSEN COLLEGE - FORT MYERS          ,FL,33905-7805,Proprietary  ,60,318,378,279,1335,1614
00869420,RASMUSSEN COLLEGE - TAMPA               ,FL,33610-9558,Proprietary  ,49,304,353,202,1237,1439
00869422,RASMUSSEN COLLEGE - PASCO               ,FL,33558-0000,Proprietary  ,20,118,138,71,412,483
00884800,WARNER UNIVERSITY                       ,FL,33859-8725,Private      ,140,270,410,997,770,1767
00884900,PALM BEACH ATLANTIC UNIVERSITY          ,FL,33401-6505,Private      ,342,589,931,3790,2503,6293
00887800,MIAMI INTERNATIONAL UNIV ART&DESIGN     ,FL,33132-1418,Proprietary  ,385,420,805,1808,1788,3596
00910400,TONI & GUY HAIRDRESSING ACADEMY         ,FL,32256-3810,Proprietary  ,10,27,37,44,97,141
00963500,FLORIDA INTERNATIONAL UNIVERSITY        ,FL,33199-0001,Public       ,3974,5459,9433,42026,33279,75305
00984100,UNIVERSITY OF NORTH FLORIDA             ,FL,32224-2645,Public       ,1646,2007,3653,15400,9407,24807
00990200,SHERIDAN TECHNICAL CENTER               ,FL,33021-3399,Public       ,229,737,966,678,2022,2700
01016100,"LORAINE'S ACADEMY, INC                  ",FL,33710-0000,Proprietary  ,19,104,123,47,222,269
01019500,ART INSTITUTE OF FT LAUDERDALE          ,FL,33316-3000,Proprietary  ,241,338,579,1367,1382,2749
01065200,PASCO-HERNANDO COMMUNITY CLG            ,FL,34654-5199,Public       ,1543,2058,3601,5732,6997,12729
01072401,CARLOS ALBIZU UNIVERSITY                ,FL,33172-0000,Private      ,29,338,367,116,995,1111
01082600,TOM P. HANEY TECHNICAL CENTER           ,FL,32405-5099,Public       ,71,332,403,248,1016,1264
01112700,GOODING INST OF NUR ANES BAY MED CT     ,FL,32401-0000,Proprietary  ,2,25,27,17,103,120
01226300,ATLANTIC TECHNICAL CENTER               ,FL,33063-3902,Public       ,218,490,708,625,1378,2003
01246117,LINCOLN COLLEGE OF TECHNOLOGY - WEST PAL,FL,33407-3105,Proprietary  ,110,175,285,474,663,1137
01254400,FIRST COAST TECHNICAL COLLEGE           ,FL,32084-1921,Public       ,94,239,333,378,834,1212
01257400,RINGLING SCHOOL OF ART AND DESIGN       ,FL,34234-5895,Private      ,131,60,191,1971,407,2378
01303904,SOUTH UNIVERSITY - WEST PALM BEACH CAMPU,FL,33409-5149,Proprietary  ,105,679,784,507,2036,2543
01323400,LORENZO WALKER INST OF TECHNOLOGY       ,FL,34104-4405,Public       ,91,172,263,349,608,957
02089600,CONCORDE CAREER INSTITUTE               ,FL,32211-0000,Proprietary  ,90,379,469,241,1192,1433
02113609,AMERICAN INTERCONTINENTAL UNIV - WESTON ,FL,33326-3233,Proprietary  ,2,24,26,16,157,173
02115300,PINELLAS TECHNICAL EDUCATION CENTERS - S,FL,33711-0000,Public       ,138,517,655,408,1571,1979
02116006,SANFORD-BROWN INSTITUTE - FT. LAUDERDALE,FL,33309-1906,Proprietary  ,23,77,100,152,473,625
02148200,FASHION FOCUS HAIR ACADEMY              ,FL,34231-0000,Proprietary  ,10,30,40,29,94,123
02148300,MANHATTAN BEAUTY SCHOOL                 ,FL,33611-0000,Proprietary  ,0,0,0,23,68,91
02149900,PAUL MITCHELL THE SCHOOL-JACKSONVILLE   ,FL,32205-0000,Proprietary  ,51,114,165,138,308,446
02151900,KEISER  UNIVERSITY                      ,FL,33309-0000,Private      ,1441,6805,8246,4849,19710,24559
02156300,MARGATE SCHOOL OF BEAUTY                ,FL,33063-0000,Proprietary  ,15,65,80,17,67,84
02159600,BAPTIST COLLEGE OF FLORIDA (THE)        ,FL,32440-0000,Private      ,75,115,190,231,299,530
02172700,CONCORDE CAREER INSTITUTE               ,FL,33607-0000,Proprietary  ,51,201,252,157,629,786
02188900,HOBE SOUND BIBLE COLLEGE                ,FL,33475-0000,Private      ,28,23,51,79,81,160
02200100,BRADENTON BEAUTY & BARBER ACADEMY       ,FL,34209-0000,Proprietary  ,7,38,45,24,135,159
02215900,ATI CAREER TRAINING CENTER              ,FL,33309-1785,Proprietary  ,14,59,73,40,158,198
02218700,FLORIDA TECHNICAL COLLEGE               ,FL,32826-2707,Proprietary  ,388,1164,1552,1124,3426,4550
02218707,FLORIDA TECHNICAL COLLEGE - LAKELAND    ,FL,33813-2101,Proprietary  ,47,114,161,221,466,687
02218709,FLORIDA TECHNICAL COLLEGE - DELAND      ,FL,32720-7415,Proprietary  ,54,305,359,173,853,1026
02228300,LAKE TECHNICAL CENTER                   ,FL,32726-0000,Public       ,113,345,458,450,1137,1587
02245500,FORTIS COLLEGE                          ,FL,32789-4679,Proprietary  ,19,92,111,52,415,467
02257900,INTERNATIONAL ACADEMY                   ,FL,32119-3541,Proprietary  ,24,86,110,62,229,291
02275100,CONCORDE CAREER INSTITUTE               ,FL,33025-0000,Proprietary  ,45,166,211,123,455,578
02278800,SOUTHWEST FLORIDA COLLEGE               ,FL,33907-0000,Proprietary  ,116,461,577,1207,1957,3164
02278801,SOUTHWEST FLORIDA COLLEGE - TAMPA       ,FL,33619-1344,Proprietary  ,59,241,300,360,871,1231
02278802,SOUTHWEST FLORIDA COLLEGE - INSTITUTUE O,FL,33928-9469,Proprietary  ,13,27,40,75,123,198
02278803,SOUTHWEST FLORIDA COLLEGE - PORT CHARLOT,FL,33953-3100,Proprietary  ,47,150,197,217,563,780
02279600,CORTIVA INSTITUTE - FLORIDA             ,FL,33781-0000,Proprietary  ,46,123,169,94,271,365
02283800,BEAUTY SCHOOLS OF AMERICA               ,FL,33012-3322,Proprietary  ,114,595,709,260,1237,1497
02286502,ITT TECHNICAL INSTITUTE                 ,FL,32244-6630,Proprietary  ,0,0,0,0,1,1
02287100,LA BELLE BEAUTY SCHOOL                  ,FL,33012-3224,Proprietary  ,16,94,110,31,130,161
02293200,ATI CAREER TRAINING CENTER              ,FL,33309-5916,Proprietary  ,3,12,15,10,38,48
02293201,ATI CAREER TRAINING CENTER - MIAMI      ,FL,33122-1707,Proprietary  ,17,37,54,59,130,189
02293202,ATI CAREER TAINING CENTER - ATI COLLEGE ,FL,87109-2016,Proprietary  ,9,35,44,43,134,177
02293600,ADVANCED TECHNICAL CENTERS              ,FL,33266-1597,Private      ,6,24,30,47,98,145
02297000,CHARLOTTE TECHNICAL CENTER              ,FL,33948-0000,Public       ,26,92,118,158,341,499
02300900,WITHLACOOCHEE TECHNICAL INSTITUTE       ,FL,34450-0000,Public       ,47,175,222,175,537,712
02305800,FLORIDA CAREER COLLEGE                  ,FL,33012-7028,Proprietary  ,379,1781,2160,769,3953,4722
02305810,FLORIDA CAREER COLLEGE - CLEARWATER     ,FL,33759-3924,Proprietary  ,0,0,0,19,79,98
02307400,GEORGE STONE AREA VOCATIONAL TECHNICAL  ,FL,32526-0000,Public       ,96,347,443,280,1036,1316
02314100,SCHILLER INTERNATIONAL UNIVERSITY       ,FL,33770-0000,Proprietary  ,14,62,76,51,235,286
02316200,MIAMI LAKES TECHNICAL EDUCATION CTR     ,FL,33014-0000,Public       ,109,417,526,339,1018,1357
02321200,ORANGE TECH EDUC CTR- WESTSIDE TECH     ,FL,34787-0000,Public       ,83,202,285,261,587,848
02325100,KEY COLLEGE                             ,FL,33004-3046,Proprietary  ,1,13,14,9,63,72
02326303,MEDVANCE INSTITUTE - WEST PALM          ,FL,33461-2171,Proprietary  ,0,9,9,19,77,96
02326306,MEDVANCE INSTITUTE - MIAMI              ,FL,33173-3431,Proprietary  ,1,6,7,22,46,68
02326800,MERIDIAN COLLEGE                        ,FL,34240-8478,Proprietary  ,26,92,118,71,281,352
02326900,SUNSTATE ACADEMY OF HAIR DESIGN         ,FL,33907-1415,Proprietary  ,51,122,173,142,368,510
02329900,FLORIDA INSTITUTE OF ULTRASOUND         ,FL,32514-0000,Proprietary  ,26,98,124,98,304,402
02338400,FT PIERCE BEAUTY ACADEMY                ,FL,34982-0000,Proprietary  ,29,127,156,59,250,309
02346200,WYOTECH                                 ,FL,32174-1010,Private      ,34,87,121,127,338,465
02362100,FULL SAIL UNIVERSITY                    ,FL,32792-0000,Proprietary  ,2635,6030,8665,13091,21651,34742
02499000,ACADEMY OF COSMETOLOGY                  ,FL,32953-3311,Proprietary  ,18,70,88,48,167,215
02501500,"O*TEC, MID-FLORIDA TECH                 ",FL,32809-0000,Public       ,135,464,599,416,1267,1683
02504600,WINTER PARK TECH                        ,FL,32789-0000,Public       ,39,144,183,142,437,579
02508900,TALMUDIC COLLEGE OF FLORIDA             ,FL,33139-0000,Private      ,17,5,22,24,11,35
02511700,RIDGE TECHNICAL CENTER                  ,FL,33881-0000,Public       ,89,281,370,267,821,1088
02513200,ORLANDO TECHNICAL CENTER                ,FL,32801-0000,Public       ,117,363,480,438,1261,1699
02515400,CITY COLLEGE                            ,FL,33309-3073,Private      ,111,450,561,451,1893,2344
02517100,SARASOTA SCHOOL OF MASSAGE THERAPY      ,FL,34243-6130,Proprietary  ,13,47,60,40,140,180
02524000,SUNSTATE ACADEMY OF HAIR DESIGN         ,FL,34624-0000,Proprietary  ,29,82,111,64,188,252
02524002,SUNSTATE ACADEMY - JONES TECHNICAL INSTI,FL,32256-0367,Proprietary  ,31,81,112,89,218,307
02524200,ROBERT MORGAN EDUCATIONAL CENTER        ,FL,33177-0000,Public       ,158,301,459,376,726,1102
02531803,PAUL MITCHELL THE SCHOOL - ORLANDO      ,FL,32765-6444,Proprietary  ,51,106,157,166,276,442
02531805,PAUL MITCHELL THE SCHOOL -TAMPA         ,FL,33613-0000,Proprietary  ,68,134,202,194,343,537
02547600,FLORIDA NATIONAL COLLEGE                ,FL,33012-0000,Proprietary  ,137,491,628,429,1567,1996
02547601,FLORIDA NATIONAL UNIVERSITY - SOUTH CAMP,FL,33175-2478,Proprietary  ,155,368,523,698,1415,2113
02547602,FLORIDA NATIONAL UNIVERSITY - TRAINING A,FL,33012-4108,Proprietary  ,33,72,105,122,342,464
02554200,RADFORD LOCKLIN TECH CENTER             ,FL,32570-0000,Public       ,29,106,135,92,353,445
02573200,LA BELLE BEAUTY ACADEMY                 ,FL,33135-0000,Proprietary  ,23,79,102,86,268,354
02597100,HERITAGE INSTITUTE                      ,FL,33912-7132,Proprietary  ,94,253,347,369,778,1147
02598200,SOUTHERN CAREER COLLEGE                 ,FL,32225-9828,Proprietary  ,12,75,87,66,414,480
02601600,HENRY W BREWSTER TECHNICAL CENTER       ,FL,33602-0000,Public       ,26,126,152,101,468,569
02612700,"SALON PROFESSIONAL ACADEMY - MELBOURNE, ",FL,32904-3919,Proprietary  ,17,57,74,66,174,240
02616400,SANFORD-BROWN INSTITUTE                 ,FL,32256-3520,Proprietary  ,20,91,111,132,525,657
02616705,LE CORDON BLEU COLLEGE OF CULINARY ARTS ,FL,33025-3929,Proprietary  ,57,92,149,311,443,754
03003600,MCFATTER TECHNICAL CENTER               ,FL,33317-7499,Public       ,164,432,596,538,1166,1704
03008600,FLORIDA COLLEGE OF NATURAL HEALTH       ,FL,33064-1342,Proprietary  ,61,194,255,140,461,601
03010608,VIRGINIA COLLEGE - PENSACOLA            ,FL,32501-5650,Proprietary  ,43,175,218,151,663,814
03010612,VIRGINIA COLLEGE - GOLF ACADEMY OF AMERI,FL,32701-0000,Proprietary  ,4,8,12,18,54,72
03010618,VIRGINIA COLLEGE - JACKSONVILLE         ,FL,32207-5167,Proprietary  ,22,182,204,124,678,802
03012300,ASM BEAUTY WORLD ACADEMY                ,FL,33021-0000,Proprietary  ,4,47,51,20,113,133
03018500,BENE'S INTERNATIONAL SCHOOL OF BEAUTY   ,FL,34652-1636,Proprietary  ,45,152,197,106,369,475
03026508,REMINGTON COLLEGE - TAMPA               ,FL,33619-1177,Private      ,10,84,94,87,417,504
03028200,TRINITY COLLEGE OF FLORIDA              ,FL,34655-4401,Private      ,29,42,71,184,182,366
03031400,INTERNATIONAL ACADEMY OF DESIGN AND TECH,FL,33634-6313,Proprietary  ,94,267,361,559,1865,2424
03031402,INTERNATIONAL ACADEMY OF DESIGN AND TECH,FL,32809-4613,Proprietary  ,28,62,90,170,296,466
03031403,IADT - ORLANDO CULINARY ACADEMY         ,FL,32819-0000,Proprietary  ,68,154,222,297,600,897
03035800,HERITAGE INSTITUTE                      ,FL,32216-0948,Proprietary  ,27,158,185,74,431,505
03035900,NATIONAL AVIATION ACADEMY               ,FL,33760-3931,Proprietary  ,67,163,230,327,715,1042
03037500,HODGES UNIVERSITY                       ,FL,34119-7932,Private      ,185,904,1089,616,2697,3313
03071600,COLLEGE OF BUSINESS & TECHNOLOGY        ,FL,33176-1412,Proprietary  ,69,361,430,227,934,1161
03078003,OHIO CENTER FOR BROADCASTING - MIAMI MED,FL,33130-3042,Proprietary  ,6,36,42,30,104,134
03079800,GEORGE T BAKER AVIATION                 ,FL,33142-5687,Public       ,111,140,251,349,436,785
03079900,CITY COLLEGE                            ,FL,32714-3129,Private      ,36,128,164,135,570,705
03089200,NOUVELLE INSTITUTE                      ,FL,33125-4141,Proprietary  ,23,202,225,35,306,341
03096300,FORTIS INSTITUTE                        ,FL,33860-0000,Proprietary  ,0,4,4,6,30,36
03099600,MERCY HOSPITAL SCHOOL OF PRACTICAL NSG  ,FL,33133-4237,Proprietary  ,16,62,78,85,229,314
03100800,TAYLOR TECHNICAL INSTITUTE              ,FL,32348-0894,Public       ,19,52,71,54,142,196
03101900,TRINITY BAPTIST COLLEGE                 ,FL,32221-1398,Private      ,82,76,158,413,294,707
03103900,MARION COUNTY COMMUNITY TECH & ADUL     ,FL,34474-3172,Public       ,87,289,376,368,1253,1621
03108500,EVERGLADES UNIVERSITY                   ,FL,33431-0000,Private      ,82,604,686,221,1623,1844
03108600,COM-PU-MED VOCATIONAL CAREERS           ,FL,33012-4861,Proprietary  ,24,139,163,48,259,307
03113400,ACADEMY OF HEALING ARTS                 ,FL,33463-2113,Proprietary  ,18,57,75,40,171,211
03114700,PRAXIS INSTITUTE                        ,FL,33135-2657,Proprietary  ,30,186,216,42,278,320
03115500,ADVENTIST UNIVERSITY OF HEALTH SCIENCES ,FL,32803-1237,Private      ,223,569,792,1309,2304,3613
03123900,SOUTHEASTERN COLLEGE                    ,FL,33413-0000,Proprietary  ,67,281,348,156,872,1028
03125600,MIAMI AD SCHOOL                         ,FL,33139-5203,Proprietary  ,20,77,97,92,327,419
03127900,TECHNICAL EDUCATION CTR OSCEOLA         ,FL,34744-4459,Public       ,157,338,495,455,972,1427
03158300,LEE COUNTY HIGH TECH CENTER NORTH       ,FL,33993-2479,Public       ,41,135,176,150,365,515
03171300,UNIVERSITY OF ST. AUGUSTINE FOR HEALTH S,FL,32084-4215,Proprietary  ,9,397,406,93,1684,1777
03224300,NEW PROFESSIONS TECHNICAL INSTITUTE     ,FL,33134-1640,Proprietary  ,15,194,209,50,441,491
03230300,CHOICE HIGH SCHOOL AND TECHNICAL CENTER ,FL,32547-1299,Public       ,42,172,214,108,442,550
03238300,FLORIDA COLLEGE OF INTEGRATIVE MED      ,FL,32809-5721,Proprietary  ,27,74,101,101,310,411
03255300,FLORIDA GULF COAST UNIVERSITY           ,FL,33965-6565,Public       ,1519,1053,2572,19330,5824,25154
03256300,YESHIVA GEDOLAH RABBINICAL COLLEGE      ,FL,33139-4708,Private      ,1,5,6,3,11,14
03264300,SOUTH FLORIDA BIBLE COLLEGE AND THEOLOGI,FL,33441-5768,Private      ,3,73,76,9,178,187
03346300,ACAD FOR PRAC NURSING & HEALTH OCCP     ,FL,33417-4574,Private      ,35,204,239,187,747,934
03348400,PROFESSIONAL TRAINING CENTERS           ,FL,33184-0000,Proprietary  ,50,314,364,135,721,856
03373300,BEACON COLLEGE                          ,FL,34748-5224,Private      ,35,26,61,265,106,371
03374300,FLORIDA COASTAL SCHOOL OF LAW           ,FL,32256-0000,Proprietary  ,15,255,270,80,1684,1764
03382300,BRADFORD-UNION AREA CAREERTECHNICAL CENT,FL,32091-2434,Public       ,12,70,82,53,243,296
03390300,LINCOLN TECHNICAL INSTITUTE             ,FL,32730-2351,Proprietary  ,1,12,13,37,131,168
03411400,INTERNATIONAL TRAINING CAREERS          ,FL,33155-1462,Private      ,9,104,113,25,238,263
03414500,ACUPUNCTURE AND MASSAGE COLLEGE         ,FL,33176-1509,Proprietary  ,14,84,98,67,256,323
03429600,ATLANTIC INST OF ORIENTAL MEDICINE      ,FL,33316-0000,Private      ,10,67,77,28,180,208
03429700,EAST WEST COLLG OF NATURAL MEDICINE     ,FL,34236-4959,Proprietary  ,3,63,66,22,205,227
03433400,NEW CONCEPT MASSAGE AND BEAUTY SCHO     ,FL,33135-0000,Proprietary  ,1,35,36,9,85,94
03434300,FORTIS COLLEGE                          ,FL,32073-2999,Proprietary  ,34,112,146,121,495,616
03480301,FORTIS COLLEGE - FORTIS INSTITUTE       ,FL,33313-7261,Proprietary  ,7,17,24,20,105,125
03480302,FORTIS COLLEGE - FORTIS INSTITUTE       ,FL,34952-0000,Proprietary  ,57,194,251,167,602,769
03491400,AMERICAN ADVANCED TECHNICIANS INST      ,FL,33014-4430,Proprietary  ,10,50,60,45,139,184
03549300,ULTIMATE MEDICAL ACADEMY                ,FL,33756-4917,Private      ,879,7887,8766,2059,21351,23410
03553300,SOUTHEASTERN COLLEGE                    ,FL,32216-0000,Proprietary  ,27,129,156,127,469,596
03557300,NORTH FLORIDA COSMETOLOGY INSTITUTE     ,FL,32312-0000,Proprietary  ,34,110,144,101,362,463
03570400,ENGLISH CENTER (THE)                    ,FL,33133-2703,Public       ,8,69,77,21,152,173
03611400,FLORIDA BARBER ACADEMY                  ,FL,33441-0000,Proprietary  ,8,115,123,25,258,283
03618300,FLORIDA INSTITUTE OF ANIMAL ARTS        ,FL,32792-0000,Proprietary  ,23,41,64,131,180,311
03627400,JACKSONVILLE BEAUTY INSTITUTE           ,FL,32208-1885,Proprietary  ,18,118,136,63,266,329
03627600,FLORIDA EDUCATION INSTITUTE             ,FL,33144-5036,Proprietary  ,20,97,117,88,308,396
03661400,SOUTH FLORIDA INSTITUTE OF TECHNOLO     ,FL,33135-0000,Proprietary  ,48,381,429,178,1000,1178
03691400,AVE MARIA SCHOOL OF LAW                 ,FL,34119-1376,Private      ,6,67,73,71,483,554
03696400,SABER                                   ,FL,33134-1604,Private      ,14,143,157,68,600,668
03698308,WEST COAST UNIVERSITY - MIAMI           ,FL,33178-2431,Proprietary  ,31,49,80,151,221,372
03706300,AMERICAN INSTITUTE                      ,FL,33319-0000,Proprietary  ,29,79,108,60,193,253
03757300,ADVANCE SCIENCE INSTITUTE               ,FL,33012-0000,Proprietary  ,6,44,50,22,79,101
03801400,BEAUTY INSTITUTE (THE)                  ,FL,33409-2972,Proprietary  ,4,42,46,37,117,154
03801401,BEAUTY INSTITUTE (THE) - MARGATE        ,FL,33068-5704,Proprietary  ,2,10,12,15,36,51
03816300,ARTISTIC NAILS & BEAUTY ACADEMY         ,FL,33605-5919,Proprietary  ,45,168,213,104,371,475
03823300,FLORIDA ACADEMY OF HEALTH & BEAUTY      ,FL,33311-0000,Proprietary  ,10,12,22,18,26,44
03832300,DADE MEDICAL COLLEGE                    ,FL,33126-5534,Proprietary  ,171,668,839,826,2977,3803
03842500,CAMBRIDGE INSTITUTE OF ALLIED HEALTH    ,FL,32750-0000,Proprietary  ,3,63,66,27,257,284
03856300,UNIVERSAL BEAUTY SCHOOL                 ,FL,33174-4406,Proprietary  ,6,55,61,27,124,151
03856500,FLORIDA SCHOOL OF TRADITIONAL MIDWIFERY ,FL,32601-5507,Private      ,4,38,42,28,145,173
03875300,MCI INSTITUTE OF TECHNOLOGY             ,FL,33409-4937,Proprietary  ,7,55,62,38,142,180
03888300,DRAGON RISES COLLEGE OF ORIENTAL MEDICIN,FL,32601-5089,Private      ,0,11,11,7,85,92
03903500,SOUTHERN TECHNICAL COLLEGE              ,FL,32809-0000,Proprietary  ,117,593,710,343,1979,2322
03907301,PAUL MITCHELL THE SCHOOL FT MYERS       ,FL,33907-0000,Proprietary  ,31,53,84,111,153,264
03911300,TOTAL INTERNATIONAL CAREER INSTITUTE    ,FL,33012-0000,Proprietary  ,0,0,0,4,3,7
03939300,WOLFORD COLLEGE                         ,FL,34108-1931,Proprietary  ,8,168,176,39,252,291
03939400,CENTURA INSTITUTE                       ,FL,32807-3566,Proprietary  ,17,108,125,85,319,404
03939600,DAYTONA COLLEGE                         ,FL,32174-8445,Proprietary  ,24,136,160,105,405,510
03941300,AVE MARIA UNIVERSITY                    ,FL,34142-9505,Private      ,169,32,201,1507,157,1664
03957400,NEW COLLEGE OF FLORIDA                  ,FL,34243-2109,Public       ,80,81,161,1963,377,2340
03985300,COMMERCIAL DIVING ACADEMY               ,FL,32208-0000,Proprietary  ,85,230,315,311,749,1060
03986300,AVIATOR COLLEGE OF AERONAUTICAL SCIENCE ,FL,34946-9022,Proprietary  ,23,70,93,83,220,303
04016500,AMERICAN INSTITUTE OF BEAUTY            ,FL,33773-0000,Proprietary  ,22,92,114,53,246,299
04029300,TRENDSETTERS OF FLORIDA SCHOOL OF BEAUTY,FL,32205-4737,Proprietary  ,8,40,48,24,121,145
04038302,ATA COLLEGE-ATA CAREER EDUCATION        ,FL,34606-4300,Proprietary  ,35,120,155,94,362,456
04039300,SULLIVAN AND COGLIANO TRAINING CENTERS  ,FL,33014-6427,Proprietary  ,18,321,339,32,735,767
04083400,CAMBRIDGE INSTITUTE OF ALLIED HEALTH & T,FL,33484-6543,Proprietary  ,22,158,180,110,538,648
04105400,PENSACOLA SCHOOL OF MASSAGE THERAPY & HE,FL,32504-7337,Proprietary  ,13,89,102,42,247,289
04106300,PALM BEACH ACADEMY OF HEALTH & BEAUTY   ,FL,33403-2130,Proprietary  ,20,110,130,43,189,232
04116400,FUTURE-TECH INSTITUTE                   ,FL,33135-4142,Proprietary  ,7,68,75,31,174,205
04116600,TAYLOR COLLEGE                          ,FL,34420-8714,Proprietary  ,19,110,129,72,493,565
04119400,AVEDA INSTITUTE - SAINT PETERSBURG      ,FL,33701-4242,Proprietary  ,109,181,290,401,602,1003
04120400,HI-TECH SCHOOL OF COSMETOLOGY           ,FL,33174-0000,Proprietary  ,18,46,64,70,140,210
04126900,ACADEMY OF CAREER TRAINING              ,FL,34741-4644,Proprietary  ,48,142,190,119,371,490
04127400,DIGITAL MEDIA ARTS COLLEGE              ,FL,33431-5919,Proprietary  ,56,56,112,282,201,483
04128400,MANAGEMENT RESOURCES INSTITUTE          ,FL,33126-5473,Proprietary  ,34,433,467,64,863,927
04129900,FLORIDA SCHOOL OF MASSAGE               ,FL,32608-5419,Proprietary  ,23,73,96,65,225,290
04130400,SHEAR EXCELLENCE INTERNATIONAL HAIR ACAD,FL,33614-2783,Proprietary  ,15,65,80,37,165,202
04133500,ACADEMY FOR FIVE ELEMENT ACUPUNCTURE    ,FL,32601-6811,Private      ,3,18,21,11,121,132
04133900,FUTURA CAREER INSTITUTE                 ,FL,33012-3325,Proprietary  ,8,44,52,21,135,156
04134800,AVEDA INSTITUTE - TALLAHASSEE           ,FL,32304-3186,Proprietary  ,80,156,236,313,549,862
04135000,COZMO THE SCHOOL                        ,FL,34135-4810,Proprietary  ,11,25,36,24,67,91
04135900,ALLIED HEALTH INSTITUTE                 ,FL,33068-0000,Proprietary  ,8,159,167,38,596,634
04140800,NORTH FLORIDA ACADEMY                   ,FL,32065-7758,Proprietary  ,3,16,19,20,72,92
04143100,PROFESSIONAL HANDS INSTITUTE            ,FL,33135-1939,Proprietary  ,4,57,61,5,105,110
04145900,CELEBRITY SCHOOL OF BEAUTY              ,FL,33144-4153,Proprietary  ,12,87,99,69,196,265
04146200,WALTON CAREER DEVELOPMENT CENTER        ,FL,32433-1557,Public       ,20,75,95,62,215,277
04146300,MARCHMAN TECHNICAL EDUCATION CENTER     ,FL,34653-1211,Public       ,50,97,147,175,312,487
04148500,MEDICAL INSTITUTE OF PALM BEACH         ,FL,33463-3276,Proprietary  ,28,67,95,63,122,185
04150800,IMMOKALEE TECHNICAL CENTER              ,FL,34142-3146,Public       ,46,40,86,197,139,336
04151500,AMERICAN ACADEMY OF COSMETOLOGY         ,FL,32065-8026,Proprietary  ,13,45,58,43,130,173
04156300,UNIVERSITY OF FORT LAUDERDALE           ,FL,33313-5809,Private      ,10,38,48,53,105,158
04156400,AVIATION INSTITUTE OF MAINTENANCE       ,FL,32803-6487,Proprietary  ,52,123,175,195,401,596
04157100,AEROSIM FLIGHT ACADEMY                  ,FL,32773-9683,Proprietary  ,42,66,108,146,233,379
04158300,FLAGLER TECHNICAL INSTITUTE             ,FL,32137-4714,Public       ,20,50,70,89,182,271
04162000,JOSE MARIA VARGAS UNIVERSITY            ,FL,33025-4534,Proprietary  ,7,30,37,21,88,109
04162500,HOLLYWOOD INSTITUTE OF BEAUTY CAREERS   ,FL,33023-6720,Proprietary  ,78,352,430,130,603,733
04163000,SALON PROFESSIONAL ACADEMY (THE)        ,FL,33624-6321,Proprietary  ,27,45,72,78,154,232
04163100,SALON PROFESSIONAL ACADEMY (THE)        ,FL,32607-1672,Proprietary  ,20,52,72,50,155,205
04163200,SALON PROFESSIONAL ACADEMY (THE)        ,FL,32162-9311,Proprietary  ,10,38,48,51,142,193
04164500,EUREKA INSTITUTE OF HEALTH AND BEAUTY   ,FL,33174-4205,Proprietary  ,2,10,12,13,32,45
04164600,D. A. DORSEY EDUCATIONAL CENTER         ,FL,33147-6304,Public       ,12,84,96,32,202,234
04167300,SALON PROFESSIONAL ACADEMY (THE)        ,FL,33904-4824,Proprietary  ,9,27,36,34,77,111
04170300,BEAUTY ACADEMY OF SOUTH FLORIDA         ,FL,33012-3221,Proprietary  ,17,106,123,33,167,200
04172300,ETERNITY COSMETOLOGY SCHOOL             ,FL,33415-5719,Proprietary  ,9,79,88,29,146,175
04176900,AMERICAN HEALTH INSTITUTE               ,FL,34654-3743,Proprietary  ,15,50,65,32,136,168
04182500,MILLENNIA ATLANTIC UNIVERSITY           ,FL,33178-2369,Proprietary  ,4,22,26,8,44,52
04188300,FLORIDA ACADEMY                         ,FL,33966-1155,Proprietary  ,27,129,156,111,312,423
04192100,AMERICAN MEDICAL ACADEMY                ,FL,33186-4830,Proprietary  ,45,88,133,141,276,417
04194000,"SCHOOL DISTRICT OF INDIAN RIVER COUNTY, ",FL,32960-3527,Public       ,59,75,134,161,257,418
04194200,APARICIO-LEVY TECHNICAL CENTER          ,FL,33610-9666,Public       ,11,44,55,61,173,234
04195100,AMBIANCE BEAUTY & BARBER ACADEMY        ,FL,32935-8771,Proprietary  ,13,33,46,30,111,141
04197600,"FLORIDA INSTITUTE OF RECORDING, SOUND AN",FL,32804-3309,Proprietary  ,46,70,116,190,229,419
04204600,BEAUTY AND HEALTH INSTITUTE             ,FL,33626-2610,Proprietary  ,15,89,104,70,248,318
04206300,FLORIDA VOCATIONAL INSTITUTE            ,FL,33155-3762,Proprietary  ,20,119,139,44,256,300
04207900,SAE INSTITUTE OF TECHNOLOGY - MIAMI     ,FL,33160-4307,Proprietary  ,46,64,110,154,203,357
04209500,SHEAR FINESSE HAIRSTYLING ACADEMY       ,FL,32208-5005,Proprietary  ,5,31,36,24,82,106
04210800,ULTRASOUND MEDICAL INSTITUTE            ,FL,33462-4221,Proprietary  ,1,27,28,8,49,57
04212600,COSMIX SCHOOL OF MAKEUP ARTISTRY        ,FL,33306-1640,Proprietary  ,26,62,88,92,196,288
04213200,KAIZEN BEAUTY ACADEMY                   ,FL,33024-6609,Proprietary  ,3,20,23,15,45,60
04214500,PRESTIGE HEALTH & BEAUTY SCIENCES ACADEM,FL,33160-4102,Proprietary  ,4,22,26,27,56,83
04216600,AZURE COLLEGE                           ,FL,33169-5345,Proprietary  ,18,92,110,81,584,665
04216900,SAN IGNACIO COLLEGE                     ,FL,33178-2350,Proprietary  ,5,12,17,14,32,46
04217800,BOCA BEAUTY ACADEMY                     ,FL,33434-4178,Proprietary  ,19,114,133,78,256,334
04220200,MORE TECH INSTITUTE                     ,FL,33012-2165,Proprietary  ,4,50,54,6,61,67
04221200,BLY'S SCHOOL OF COSMETOLOGY             ,FL,32601-4021,Proprietary  ,0,0,0,16,41,57
04223400,INTERAMERICAN TECHNICAL INSTITUTE       ,FL,00174-2950,Proprietary  ,5,63,68,27,148,175
04225000,PARISIAN SPA INSTITUTE                  ,FL,32204-4127,Proprietary  ,7,61,68,28,197,225
04225200,YECHANLAZ INSTITUTO VOCACIONAL          ,FL,33144-4817,Proprietary  ,0,12,12,2,35,37
04225800,FRED D. LEAREY TECHNICAL CENTER         ,FL,33614-1892,Public       ,22,64,86,87,239,326
04227500,MERRYFIELD SCHOOL OF PET GROOMING       ,FL,33334-4925,Proprietary  ,2,20,22,6,71,77
04228900,BEAUTY ANATOMY INSTITUTE OF COSMETOLOGY ,FL,33069-4313,Proprietary  ,6,27,33,25,61,86
04229700,FIRST COAST BARBER ACADEMY              ,FL,32210-8054,Proprietary  ,8,39,47,17,104,121
04233200,UNILATINA INTERNATIONAL COLLEGE         ,FL,33025-3943,Proprietary  ,1,4,5,5,17,22
04233400,LEE PROFESSIONAL INSTITUTE              ,FL,33916-9320,Proprietary  ,9,72,81,47,188,235
04233900,ATLANTIS UNIVERSITY                     ,FL,33132-1417,Proprietary  ,33,41,74,173,157,330
04234500,BURNETT INTERNATIONAL COLLEGE           ,FL,33426-6591,Proprietary  ,7,34,41,15,107,122
04238400,FLORIDA INTERNATIONAL TRAINING INSTITUTE,FL,33172-1507,Proprietary  ,5,40,45,30,99,129
04238500,TRAINING DOMAIN (THE)                   ,FL,33907-4080,Proprietary  ,2,15,17,2,15,17
04242000,LATIN BEAUTY ACADEMY                    ,FL,33415-6104,Proprietary  ,1,24,25,4,47,51
04243600,INTERNATIONAL HAIR AND BARBER ACADEMY   ,FL,33433-3443,Proprietary  ,9,20,29,18,44,62
04246900,PIBERRY INSTITUTE                       ,FL,33032-8219,Proprietary  ,1,5,6,1,5,6
00160500,CHAMINADE UNIV OF HONOLULU              ,HI,96816-1578,Private      ,248,450,698,2117,1963,4080
00160600,BRIGHAM YOUNG UNIV-HAWAII CAMPUS        ,HI,96762-1294,Private      ,271,249,520,1870,825,2695
00161000,UNIVERSITY OF HAWAII AT MANOA           ,HI,96822-2399,Public       ,746,935,1681,13857,8436,22293
00161100,UNIVERSITY OF HAWAII AT HILO            ,HI,96720-4091,Public       ,221,322,543,3461,2553,6014
00161200,HONOLULU COMMUNITY COLLEGE              ,HI,96817-4598,Public       ,296,451,747,2002,2324,4326
00161300,KAPIOLANI COMMUNITY COLLEGE             ,HI,96816-4421,Public       ,439,661,1100,3135,3212,6347
00161400,KAUAI COMMUNITY COLLEGE                 ,HI,96766-9591,Public       ,89,143,232,544,691,1235
00161500,UNIVERSITY OF HAWAII MAUI COLLEGE       ,HI,96732-1644,Public       ,207,462,669,1586,2213,3799
00454900,LEEWARD COMMUNITY COLLEGE               ,HI,96782-3393,Public       ,522,762,1284,2852,3177,6029
00525800,HAWAII COMMUNITY COLLEGE                ,HI,96720-4075,Public       ,186,346,532,1519,2018,3537
00723401,HEALD COLLEGE - HONOLULU                ,HI,96814-0000,Proprietary  ,13,36,49,456,837,1293
00727900,HAWAII PACIFIC UNIVERSITY               ,HI,96813-2882,Private      ,252,578,830,4493,2790,7283
01122000,WINDWARD COMMUNITY COLLEGE              ,HI,96744-0000,Public       ,152,275,427,910,1334,2244
02100300,MED-ASSIST SCHOOL OF HAWAII             ,HI,96813-0000,Proprietary  ,17,49,66,89,203,292
02107800,UNIVERSITY OF HAWAII - WEST OAHU        ,HI,96707-0000,Public       ,170,339,509,1935,2254,4189
02139500,HAWAII INSTITUTE OF HAIR DESIGN         ,HI,96817-5195,Proprietary  ,13,42,55,70,169,239
03017800,TRAVEL INSTITUTE OF THE PACIFIC         ,HI,96814-1946,Proprietary  ,7,32,39,48,126,174
03072500,WORLD MEDICINE INSTITUTE                ,HI,96826-0000,Private      ,4,39,43,41,140,181
03735300,INST OF CLINICAL ACUPUNCTURE & ORIENT MD,HI,96813-2307,Proprietary  ,0,27,27,11,92,103
04165200,MAUNA LOA HELICOPTERS                   ,HI,96740-2650,Proprietary  ,7,11,18,31,58,89
04175100,PAUL MITCHELL THE SCHOOL HONOLULU       ,HI,96816-2433,Proprietary  ,24,49,73,119,197,316
04182200,HAWAII MEDICAL INSTITUTE                ,HI,96814-3518,Proprietary  ,71,197,268,251,659,910
04252700,PACIFIC RIM CHRISTIAN UNIVERSITY        ,HI,96819-2228,Private      ,2,1,3,2,1,3
00161600,BOISE STATE UNIVERSITY                  ,ID,83725-1000,Public       ,805,1589,2394,13459,10072,23531
00161700,"COLLEGE OF IDAHO, THE                   ",ID,83605-4432,Private      ,132,111,243,1817,479,2296
00161900,COLLEGE OF SOUTHERN IDAHO               ,ID,83301-0000,Public       ,470,800,1270,3027,2885,5912
00162000,IDAHO STATE UNIVERSITY                  ,ID,83209-5377,Public       ,763,1771,2534,5821,6752,12573
00162100,LEWIS-CLARK STATE COLLEGE               ,ID,83501-2698,Public       ,227,420,647,2627,2084,4711
00162300,NORTH IDAHO COLLEGE                     ,ID,83814-2199,Public       ,319,747,1066,2784,3379,6163
00162400,NORTHWEST NAZARENE UNIVERSITY           ,ID,83686-5897,Private      ,106,334,440,1508,1343,2851
00162500,BRIGHAM YOUNG UNIVERSITY-IDAHO          ,ID,83460-1650,Private      ,1888,2848,4736,14730,12584,27314
00162600,UNIVERSITY OF IDAHO                     ,ID,83844-4291,Public       ,511,660,1171,9307,4045,13352
00732915,ITT TECHNICAL INSTITUTE                 ,ID,83713-1529,Proprietary  ,99,484,583,354,1654,2008
00987300,MR JUAN'S CLG OF HAIR DESIGN            ,ID,83301-4154,Proprietary  ,12,25,37,29,70,99
01113300,EASTERN IDAHO TECHNICAL COLLEGE         ,ID,83404-5788,Public       ,70,235,305,389,909,1298
02218000,CARRINGTON COLLEGE                      ,ID,83704-0000,Proprietary  ,119,355,474,408,1386,1794
02234500,BOISE BIBLE COLLEGE                     ,ID,83714-1220,Private      ,28,22,50,166,105,271
02275800,MR LEONS SCHOOL OF HAIR DESIGN          ,ID,83843-8384,Proprietary  ,1,24,25,15,46,61
02275801,MR. LEON'S SCHOOL OF HAIR DESIGN        ,ID,83501-1910,Proprietary  ,1,3,4,5,16,21
02314000,SCHOOL OF HAIRSTYLING (THE)             ,ID,83202-0000,Proprietary  ,0,8,8,7,28,35
02319800,TONI&GUY HAIRDRESSING ACADEMY           ,ID,83814-2822,Proprietary  ,14,38,52,50,115,165
02319801,TONI&GUY HAIRDRESSING ACADEMY - BOISE   ,ID,83705-2636,Proprietary  ,22,41,63,84,129,213
02349200,HEADMASTERS SCHOOL OF HAIR DESIGN       ,ID,83501-0000,Proprietary  ,3,8,11,18,41,59
02559500,RAZZLE DAZZLE CLG OF HAIR DESIGN        ,ID,83686-5104,Proprietary  ,10,31,41,58,112,170
02607100,PAUL MITCHELL THE SCHOOL BOISE          ,ID,83709-1662,Proprietary  ,33,86,119,151,248,399
03098700,ACADEMY OF COURT REPORTING              ,ID,83704-8320,Proprietary  ,39,125,164,105,321,426
03832400,COSMETOLOGY SCHOOL OF ARTS & SCIENCES   ,ID,83318-1327,Proprietary  ,5,10,15,15,58,73
04051323,ART INSTITUTE OF PHOENIX (THE) - BROWN M,ID,83709-2746,Proprietary  ,4,30,34,45,146,191
04134300,EVANS HAIRSTYLING COLLEGE               ,ID,83440-5277,Proprietary  ,9,13,22,57,44,101
04144500,HAIR ACDMY PAUL MITCHELL PARTNER SCHOOL ,ID,83440-2600,Proprietary  ,20,25,45,84,106,190
04150600,D & L ACADEMY OF HAIR DESIGN            ,ID,83301-6229,Proprietary  ,4,16,20,16,40,56
04155200,OLIVER FINLEY ACADEMY OF COSMETOLOGY    ,ID,83704-8011,Proprietary  ,37,62,99,140,199,339
04163800,MASTER EDUCATORS BEAUTY SCHOOL          ,ID,83301-4118,Proprietary  ,3,15,18,27,45,72
04168600,COLLEGE OF MASSAGE THERAPY              ,ID,83221-1758,Proprietary  ,4,15,19,15,51,66
04176700,D'SHAW INSTITUTE OF COSMETOLOGY         ,ID,83704-4406,Proprietary  ,7,15,22,34,57,91
04194800,VELVET TOUCH ACADEMY OF COSMETOLOGY     ,ID,83687-5020,Proprietary  ,0,0,0,24,39,63
04203200,BOISE BARBER COLLEGE                    ,ID,83704-5919,Proprietary  ,5,31,36,20,103,123
04203500,AUSTIN KADE ACADEMY                     ,ID,83404-5540,Proprietary  ,27,89,116,62,219,281
04207200,ACADEMY DI FIRENZE                      ,ID,83338-2329,Proprietary  ,0,4,4,6,19,25
04211800,COLLEGE OF WESTERN IDAHO                ,ID,83687-5505,Public       ,860,1753,2613,4190,6599,10789
00149912,EVEREST UNIVERSITY - EVEREST COLLEGE - K,MO,64114-3246,Private      ,38,176,214,103,551,654
00163200,AQUINAS INSTITUTE OF THEOLOGY           ,MO,63108-3323,Private      ,0,15,15,1,60,61
00244900,AVILA UNIVERSITY                        ,MO,64145-1698,Private      ,130,376,506,1486,1498,2984
00245000,CALVARY BIBLE COLLEGE                   ,MO,64147-1341,Private      ,38,50,88,165,186,351
00245300,CENTRAL METHODIST UNIVERSITY            ,MO,65248-1198,Private      ,129,495,624,1825,2203,4028
00245400,UNIVERSITY OF CENTRAL MISSOURI          ,MO,64093-5178,Public       ,870,1037,1907,8985,4434,13419
00245600,COLUMBIA COLLEGE                        ,MO,65216-4581,Private      ,473,4230,4703,2909,17808,20717
00245700,CONCORDIA SEMINARY                      ,MO,63105-3199,Private      ,0,29,29,2,405,407
00245800,COTTEY COLLEGE                          ,MO,64772-2790,Private      ,21,14,35,382,65,447
00245900,CROWDER COLLEGE                         ,MO,64850-9165,Public       ,499,701,1200,2584,2647,5231
00246000,CULVER STOCKTON COLLEGE                 ,MO,63435-1299,Private      ,84,35,119,1420,206,1626
00246100,DRURY UNIVERSITY                        ,MO,65802-3791,Private      ,207,813,1020,2281,3017,5298
00246200,EDEN THEOLOGICAL SEMINARY               ,MO,63119-0000,Private      ,1,59,60,2,133,135
00246300,EVANGEL UNIVERSITY                      ,MO,65802-2125,Private      ,227,260,487,2232,1042,3274
00246400,FONTBONNE UNIVERSITY                    ,MO,63105-3098,Private      ,94,320,414,1207,1762,2969
00246600,HARRIS - STOWE STATE UNIVERSITY         ,MO,63103-2199,Public       ,279,497,776,1562,1779,3341
00246700,CONCEPTION SEMINARY COLLEGE             ,MO,64433-0502,Private      ,19,2,21,56,9,65
00246800,JEFFERSON COLLEGE                       ,MO,63050-2441,Public       ,482,698,1180,2580,2430,5010
00247100,ST LOUIS COMMUNITY COLLEGE              ,MO,63102-0000,Public       ,2193,3723,5916,10155,12749,22904
00247300,KANSAS CITY ART INSTITUTE               ,MO,64111-1874,Private      ,35,48,83,1138,336,1474
00247400,KANSAS CITY UNIV OF MED AND BIOSCIENCES ,MO,64106-0000,Private      ,12,83,95,90,1265,1355
00247600,KENRICK-GLENNON SEMINARY                ,MO,63119-4330,Private      ,3,2,5,32,9,41
00247700,A.T. STILL UNIV OF HEALTH SCIENCES      ,MO,63501-0000,Private      ,5,163,168,23,2993,3016
00247900,LINCOLN UNIVERSITY                      ,MO,65101-3500,Public       ,372,425,797,2664,1572,4236
00248000,LINDENWOOD UNIVERSITY                   ,MO,63301-1695,Private      ,718,1698,2416,7022,6917,13939
00248200,MARYVILLE UNIVERSITY                    ,MO,63141-7299,Private      ,189,1387,1576,2621,5057,7678
00248400,METROPOLITAN COMMUNITY COLLEGE          ,MO,64111-2408,Public       ,1699,2846,4545,8666,10776,19442
00248500,MIDWESTERN BAPTIST THEOL SEMINARY       ,MO,64118-4697,Private      ,31,159,190,136,454,590
00248600,MINERAL AREA COLLEGE                    ,MO,63601-1000,Public       ,316,506,822,1818,1863,3681
00248800,MISSOURI SOUTHERN STATE UNIVERSITY      ,MO,64801-1595,Public       ,387,574,961,4559,3353,7912
00248900,MISSOURI VALLEY COLLEGE                 ,MO,65340-3197,Private      ,138,65,203,1735,420,2155
00249000,MISSOURI WESTERN STATE UNIVERSITY       ,MO,64507-2294,Public       ,431,495,926,4257,2258,6515
00249100,MOBERLY AREA COMMUNITY COLLEGE          ,MO,65270-1304,Public       ,552,658,1210,2886,2570,5456
00249400,NAZARENE THEOLOGICAL SEMINARY           ,MO,64131-1246,Private      ,1,38,39,6,147,153
00249500,TRUMAN STATE UNIVERSITY                 ,MO,63501-4221,Public       ,245,70,315,5697,604,6301
00249600,NORTHWEST MISSOURI STATE UNIV           ,MO,64468-6001,Public       ,414,201,615,6073,1204,7277
00249800,PARK UNIVERSITY                         ,MO,64152-3795,Private      ,213,2327,2540,1400,7774,9174
00249900,ROCKHURST UNIVERSITY                    ,MO,64110-2561,Private      ,133,193,326,2289,1071,3360
00250000,COLLEGE OF THE OZARKS                   ,MO,65726-2502,Private      ,153,52,205,3411,360,3771
00250100,SOUTHEAST MISSOURI STATE UNIV           ,MO,63701-4799,Public       ,522,722,1244,8771,3994,12765
00250200,SOUTHWEST BAPTIST UNIVERSITY            ,MO,65613-2597,Private      ,155,325,480,2090,1579,3669
00250300,MISSOURI STATE UNIVERSITY               ,MO,65897-0094,Public       ,1355,1632,2987,16805,8204,25009
00250400,ST LOUIS COLLEGE OF PHARMACY            ,MO,63110-1088,Private      ,40,88,128,770,835,1605
00250600,SAINT LOUIS UNIVERSITY                  ,MO,63103-2097,Private      ,404,929,1333,9875,6667,16542
00250900,SAINT PAUL SCHOOL OF THEOLOGY           ,MO,64127-2499,Private      ,0,18,18,1,87,88
00251200,STEPHENS COLLEGE                        ,MO,65215-0001,Private      ,40,83,123,1009,592,1601
00251400,NORTH CENTRAL MISSOURI COLLEGE          ,MO,64683-1824,Public       ,104,173,277,921,781,1702
00251600,UNIVERSITY OF MISSOURI - COLUMBIA       ,MO,65211-1600,Public       ,1490,1128,2618,27380,8025,35405
00251700,MISSOURI UNIVERSITY OF SCIENCE & TECHNOL,MO,65409-0250,Public       ,279,212,491,6536,1450,7986
00251800,UNIVERSITY OF MISSOURI-KANSAS CITY      ,MO,64110-2497,Public       ,699,1462,2161,7951,8594,16545
00251900,UNIVERSITY OF MISSOURI-ST LOUIS         ,MO,63121-4499,Public       ,641,1747,2388,6725,9207,15932
00252000,WASHINGTON UNIVERSITY                   ,MO,63130-4899,Private      ,258,537,795,15424,5171,20595
00252001,WASHINGTON UNIV-SCHOOL OF MEDICINE      ,MO,63110-0000,Private      ,17,61,78,155,1417,1572
00252100,WEBSTER UNIVERSITY                      ,MO,63119-3194,Private      ,205,1864,2069,3404,10156,13560
00252200,WENTWORTH MILITARY ACADEMY              ,MO,64067-1799,Private      ,46,40,86,277,189,466
00252300,WESTMINSTER COLLEGE                     ,MO,65251-1299,Private      ,60,27,87,1210,142,1352
00252400,WILLIAM JEWELL COLLEGE                  ,MO,64068-1896,Private      ,64,44,108,1220,248,1468
00252500,WILLIAM WOODS UNIVERSITY                ,MO,65251-2388,Private      ,106,362,468,1060,1159,2219
00405704,NATIONAL AMERICAN UNIVERSITY            ,MO,64057-1791,Proprietary  ,6,124,130,45,565,610
00470300,LOGAN COLLEGE OF CHIROPRACTIC           ,MO,63006-0000,Private      ,16,263,279,59,855,914
00470700,COVENANT THEOLOGICAL SEMINARY           ,MO,63141-8697,Private      ,0,23,23,5,424,429
00471100,STATE TECHNICAL COLLEGE OF MISSOURI     ,MO,65051-9607,Public       ,107,93,200,1378,423,1801
00471300,THREE RIVERS COMMUNITY COLLEGE          ,MO,63901-2393,Public       ,384,912,1296,1924,3035,4959
00528800,KIRKSVILLE AREA TECHNICAL CENTER        ,MO,63501-0000,Public       ,8,11,19,29,66,95
00528900,WAYNESVILLE CAREER CENTER               ,MO,65583-2131,Public       ,12,41,53,52,142,194
00542400,SOUTH CENTRAL CAREER CENTER             ,MO,65775-3052,Public       ,6,60,66,53,146,199
00542600,SIKESTON CAREER AND TECHNOLOGY CTR      ,MO,63801-0000,Public       ,16,63,79,90,209,299
00542900,ROLLA TECHNICAL INSTITUTE               ,MO,65401-3601,Public       ,25,61,86,229,309,538
00543000,POPLAR BLUFF TECHNICAL CAREER CNTR      ,MO,63901-0000,Public       ,12,47,59,76,201,277
00543800,SALINE COUNTY CAREER CENTER             ,MO,65340-0000,Public       ,2,2,4,14,51,65
00544500,TRUMAN MEDICAL CENTER SCHOOL OF NURSE AN,MO,64108-2677,Private      ,0,0,0,50,96,146
00553100,GRAND RIVER TECHNICAL SCHOOL            ,MO,64601-1299,Public       ,14,17,31,71,61,132
00553200,CAPE GIRARDEAU CAREER & TECHNOLOGY CENTE,MO,63703-7511,Public       ,41,116,157,275,503,778
00638900,BARNES JEWISH COLLEGE OF NURSING AND ALL,MO,63110-1091,Private      ,45,140,185,561,1003,1564
00639200,RESEARCH COLLEGE OF NURSING             ,MO,64132-1199,Proprietary  ,22,63,85,149,288,437
00639201,RESEARCH MEDICAL CENTER - COLLEGE OF NUR,MO,64132-1199,Proprietary  ,6,25,31,55,123,178
00639202,RESEARCH MED CTR SCHL OF RAD TECH       ,MO,64132-0000,Proprietary  ,6,23,29,30,72,102
00666600,LUTHERAN  SCHOOL OF NURSING             ,MO,63118-3909,Proprietary  ,0,0,0,54,187,241
00732923,ITT TECHNICAL INSTITUTE                 ,MO,63045-1122,Proprietary  ,146,845,991,522,2799,3321
00754000,MISSOURI BAPTIST UNIVERSITY             ,MO,63141-8698,Private      ,219,532,751,1895,2140,4035
00808000,STATE FAIR COMMUNITY COLLEGE            ,MO,65301-0000,Public       ,568,1040,1608,2353,3017,5370
00826900,HILLYARD TECHNICAL CENTER               ,MO,64506-0000,Public       ,18,41,59,174,212,386
00855200,STEVENS INSTITUTE OF BUSINESS & ARTS    ,MO,63103-0000,Proprietary  ,23,58,81,98,203,301
00886200,EAST CENTRAL COLLEGE                    ,MO,63084-0529,Public       ,297,460,757,1858,1889,3747
00908900,HANNIBAL-LAGRANGE COLLEGE               ,MO,63401-1999,Private      ,75,130,205,715,522,1237
00952000,NATIONAL ACADEMY OF BEAUTY ARTS         ,MO,63128-1307,Proprietary  ,25,63,88,76,173,249
00959000,INDEPENDENCE COLLEGE OF COSMETOLOGY     ,MO,64055-1105,Proprietary  ,7,22,29,36,84,120
00960700,HOUSE OF HEAVILIN BEAUTY COLLEGE        ,MO,64110-2826,Proprietary  ,5,30,35,33,109,142
00978200,SAINT LUKE'S COLLEGE OF HEALTH SCIENCES ,MO,64114-3237,Private      ,27,83,110,270,468,738
00979500,MISSOURI COLLEGE                        ,MO,63144-2901,Proprietary  ,49,135,184,182,537,719
01027900,HICKEY COLLEGE                          ,MO,63146-0000,Proprietary  ,76,63,139,549,380,929
01040500,PINNACLE CAREER INSTITUTE               ,MO,64131-3367,Proprietary  ,41,353,394,138,1131,1269
01040501,PINNACLE CAREER INSTITUTE - NORTH KANSAS,MO,64153-1151,Proprietary  ,12,73,85,46,270,316
01050303,WICHITA TECHNICAL INSTITUTE - WTI JOPLIN,MO,64801-2970,Proprietary  ,11,95,106,34,198,232
01102600,WARRENSBURG AREA VOC TECH SCH           ,MO,64093-0000,Public       ,6,10,16,44,68,112
01173500,PIKE/LINCOLN TECHNICAL CENTER           ,MO,63344-0000,Public       ,2,15,17,13,37,50
01250000,RANKEN TECHNICAL COLLEGE                ,MO,63113-2811,Private      ,224,487,711,1601,1720,3321
01258000,ST LOUIS CHRISTIAN COLLEGE              ,MO,63033-6499,Private      ,32,48,80,106,167,273
01320800,BAPTIST BIBLE COLLEGE                   ,MO,65803-3498,Private      ,81,68,149,298,212,510
02056100,FOUR RIVERS CAREER CENTER               ,MO,63090-0000,Public       ,2,12,14,24,64,88
02068200,COX HEALTH - COX COLLEGE                ,MO,65802-0000,Private      ,44,209,253,350,1109,1459
02119200,COURT REPORTING INSTITUTE OF ST LOUIS   ,MO,63105-3329,Proprietary  ,4,68,72,23,302,325
02119204,COURT REPORTING INSTITUTE OF DALLAS - CO,MO,63105-3329,Proprietary  ,0,0,0,1,20,21
02121100,MIDWEST INSTITUTE                       ,MO,63122-0000,Proprietary  ,24,54,78,53,143,196
02124500,FRANKLIN TECHNOLOGY CENTER              ,MO,64801-0000,Public       ,16,97,113,92,344,436
02142200,LEX LA RAY TECHNICAL CENTER             ,MO,64067-0000,Public       ,0,5,5,19,70,89
02154900,MISSOURI SCH OF BARB & HAIR             ,MO,63031-0000,Proprietary  ,8,21,29,17,65,82
02164200,FOREST INSTITUTE OF PROFESSIONAL PSYCHOL,MO,65807-1445,Private      ,1,20,21,13,91,104
02165900,CHILLICOTHE BEAUTY ACADEMY              ,MO,64601-0000,Proprietary  ,2,6,8,10,15,25
02180200,METRO BUSINESS COLLEGE                  ,MO,63701-0000,Proprietary  ,30,141,171,89,478,567
02188100,NORTHLAND CAREER CENTER                 ,MO,64079-8333,Public       ,4,7,11,25,60,85
02202700,OZARK CHRISTIAN COLLEGE                 ,MO,64801-0000,Private      ,85,71,156,641,215,856
02203400,NEVADA REGIONAL TECHNICAL CENTER        ,MO,64772-0000,Public       ,8,18,26,44,78,122
02205200,SANFORD-BROWN COLLEGE                   ,MO,63026-7305,Proprietary  ,0,0,0,10,28,38
02214500,SALEM COLLEGE OF HAIRSTYLING            ,MO,65401-0000,Proprietary  ,10,15,25,18,33,51
02239200,ANTHEM COLLEGE                          ,MO,63043-0000,Proprietary  ,2,11,13,11,30,41
02250600,EVEREST COLLEGE                         ,MO,65807-2446,Private      ,16,131,147,68,473,541
02263400,LAKE CAREER AND TECHNICAL CENTER        ,MO,65020-0000,Public       ,1,9,10,7,46,53
02266400,CENTRAL CHRISTIAN CLG OF THE BIBLE      ,MO,65270-0000,Private      ,26,30,56,210,120,330
02277500,HOUSE OF HEAVILIN BEAUTY COLLEGE        ,MO,64014-3953,Proprietary  ,26,72,98,69,162,231
02289200,COLUMBIA AREA CAREER CENTER             ,MO,65203-0000,Public       ,24,105,129,166,411,577
02295700,MISSOURI BEAUTY ACADEMY                 ,MO,63640-1827,Proprietary  ,9,29,38,23,89,112
02300105,EVEREST COLLEGE - EARTH CITY            ,MO,63045-1100,Private      ,3,15,18,11,54,65
02304000,MISSOURI TECH                           ,MO,63303-3887,Proprietary  ,3,14,17,63,122,185
02309100,AMERICAN COLLEGE OF HAIR DESIGN         ,MO,65301-2144,Proprietary  ,7,21,28,26,43,69
02313000,CASS CAREER CENTER                      ,MO,64701-0000,Public       ,2,14,16,12,67,79
02340500,ST LOUIS COLLEGE OF HEALTH CAREERS      ,MO,63110-0000,Proprietary  ,83,341,424,258,1122,1380
02342100,CAREER & TECHNOLOGY CTR AT FT OSAGE     ,MO,64058-0000,Public       ,1,14,15,11,70,81
02361600,CONCORDE CAREER COLLEGE                 ,MO,64111-0000,Proprietary  ,101,341,442,279,1120,1399
02497500,CLINTON TECHNICAL SCHOOL                ,MO,64735-2966,Public       ,2,19,21,14,67,81
02520800,MERRELL UNIV OF BTY ARTS & SCIENCES     ,MO,65109-0000,Proprietary  ,20,40,60,64,131,195
02530600,SAINT CHARLES COMMUNITY COLLEGE         ,MO,63376-0975,Public       ,648,685,1333,4227,2623,6850
02543800,PARIS II EDUCATIONAL CENTER (THE)       ,MO,64118-0000,Proprietary  ,12,27,39,34,79,113
02564700,ELAINE STEVEN BEAUTY COLLEGE            ,MO,63136-0000,Proprietary  ,21,84,105,72,212,284
02564702,ELAINE STEVEN BEAUTY COLLEGE - ADVANCE B,MO,63401-2269,Proprietary  ,0,5,5,9,21,30
02568500,GRABBER SCHOOL OF HAIR DESIGN           ,MO,63011-0000,Proprietary  ,30,42,72,99,127,226
02599700,VATTEROTT COLLEGE                       ,MO,63134-2900,Proprietary  ,129,417,546,339,1532,1871
02599701,VATTEROTT COLLEGE - KANSAS CITY         ,MO,64117-0000,Proprietary  ,56,196,252,171,755,926
02599702,VATTEROTT COLLEGE - SPRINGFIELD LOCATION,MO,65807-5340,Proprietary  ,39,194,233,145,699,844
02599703,VATTEROTT COLLEGE - JOPLIN              ,MO,64801-5033,Proprietary  ,16,156,172,73,498,571
02599705,VATTEROTT COLLEGE - SUNSET HILLS        ,MO,63127-1516,Proprietary  ,39,209,248,111,579,690
02599712,VATTEROTT COLLEGE - O'FALLON            ,MO,63366-2748,Proprietary  ,28,110,138,101,452,553
02599714,VATTEROTT COLLEGE - EX'TREME INSTITUTE B,MO,63102-2115,Proprietary  ,79,151,230,238,534,772
02603101,CRAVE BEAUTY ACADEMY-BALLWIN            ,MO,63011-3125,Proprietary  ,2,8,10,2,8,10
02608000,NEOSHO BEAUTY COLLEGE                   ,MO,64850-1525,Proprietary  ,6,13,19,17,33,50
02609202,VATTEROTT COLLEGE-ST JOSEPH             ,MO,64501-2911,Proprietary  ,19,63,82,53,238,291
02609203,VATTEROTT COLLEGE - L'ECOLE CULINAIRE   ,MO,63124-1103,Proprietary  ,31,106,137,103,325,428
02609206,VATTEROTT COLLEGE - L'ECOLE CULINAIRE   ,MO,64112-2110,Proprietary  ,23,99,122,73,303,376
02611004,HERITAGE COLLEGE-KANSAS CITY            ,MO,64131-4203,Proprietary  ,48,223,271,118,548,666
03066300,BRYAN CAREER COLLEGE                    ,MO,65806-2507,Proprietary  ,15,164,179,52,546,598
03066303,BRYAN COLLEGE - COLUMBIA                ,MO,65201-8248,Proprietary  ,17,73,90,72,252,324
03068600,SPECIAL SCHOOL DISTRICT OF ST. LOUIS CO.,MO,63127-1324,Public       ,11,72,83,54,357,411
03070200,CENTRAL COLLEGE OF COSMETOLOGY          ,MO,65583-0000,Proprietary  ,16,35,51,34,78,112
03070900,SE MO HOSP CLG NURSING & HEALTH SCI     ,MO,63703-4507,Private      ,15,58,73,163,395,558
03077200,COSMETOLOGY CONCEPTS INSTITUTE          ,MO,65202-1972,Proprietary  ,14,42,56,62,116,178
03083000,OZARKS TECHNICAL COMMUNITY COLLEGE      ,MO,65802-3601,Public       ,1567,2731,4298,7331,9913,17244
03092600,MESSENGER COLLEGE                       ,MO,64804-0000,Private      ,25,18,43,109,93,202
03097600,ST LOUIS HAIR ACADEMY                   ,MO,63107-1737,Proprietary  ,14,30,44,44,108,152
03101000,NEW DIMENSION SCHOOL OF HAIR DESIGN     ,MO,64801-5017,Proprietary  ,2,17,19,18,66,84
03106000,MISSOURI STATE UNIVERSITY - WEST PLAINS ,MO,65775-2715,Public       ,155,265,420,1272,1075,2347
03110900,HOUSE OF HEAVILIN BEAUTY COLLEGE        ,MO,64083-9195,Proprietary  ,6,8,14,24,40,64
03519300,MISSOURI COLLEGE OF COSMETOLOGY NORTH   ,MO,65803-0000,Proprietary  ,14,38,52,52,136,188
03579300,TEXAS COUNTY TECHNICAL INSTITUTE        ,MO,65483-2700,Private      ,3,41,44,37,207,244
03616300,AVIATION INSTITUTE OF MAINTENANCE       ,MO,64129-1811,Proprietary  ,21,61,82,56,216,272
03878300,PROFESSIONAL MASSAGE TRAINING CENTER    ,MO,65803-2939,Proprietary  ,0,0,0,13,53,66
03916300,ECLIPS SCHOOL OF COSMETOLOGY AND BARBERI,MO,63703-5809,Proprietary  ,9,34,43,25,115,140
03924300,HAIR ACADEMY 110 (THE)                  ,MO,63501-2915,Proprietary  ,4,8,12,10,22,32
03970400,WELLSPRING SCHOOL OF ALLIED HEALTH      ,MO,64114-3313,Proprietary  ,13,75,88,46,224,270
04037500,ACADEMY OF HAIR DESIGN                  ,MO,65804-2303,Proprietary  ,31,90,121,88,249,337
04051329,ART INSTITUTE OF PHOENIX (THE) - BROWN M,MO,63026-2564,Proprietary  ,20,37,57,95,171,266
04118700,AMERICAN BUSINESS & TECHNOLOGY UNIVERSIT,MO,64506-2961,Proprietary  ,7,97,104,33,296,329
04119100,CITY VISION COLLEGE                     ,MO,64141-3188,Private      ,3,45,48,18,142,160
04122300,GRANTHAM UNIVERSITY                     ,MO,64153-2262,Proprietary  ,159,2878,3037,526,10647,11173
04130600,"CENTER FOR HEALING ARTS (THE), LLC      ",MO,63143-2103,Proprietary  ,8,52,60,14,122,136
04133300,TREND SETTERS SCHOOL OF COSMETOLOGY     ,MO,63702-7607,Proprietary  ,5,23,28,28,92,120
04145200,TRANSFORMED BARBER AND COSMETOLOGY ACADE,MO,64137-1207,Proprietary  ,9,49,58,34,150,184
04145700,THE SYSTEM A PAUL MITCHELL PARTNER SCHL ,MO,65807-5969,Proprietary  ,20,55,75,83,170,253
04146100,URSHAN GRADUATE SCHOOL OF THEOLOGY      ,MO,63031-7526,Private      ,7,15,22,27,44,71
04152200,CARTHAGE R-9 SCHOOL DISTRICT/CARTHAGE TE,MO,64836-1332,Public       ,4,18,22,9,57,66
04170600,SALON PROFESSIONAL ACADEMY (THE)        ,MO,63301-1021,Proprietary  ,9,39,48,44,98,142
04170700,PAUL MITCHELL THE SCHOOL ST LOUIS       ,MO,63108-1554,Proprietary  ,47,63,110,206,238,444
04173900,COSMETOLOGY COLLEGE OF FRANKLIN COUNTY  ,MO,63077-3448,Proprietary  ,2,11,13,12,28,40
04174000,SKIN INSTITUTE                          ,MO,63128-1307,Proprietary  ,3,38,41,32,88,120
04174800,AMERICAN TRADE SCHOOL                   ,MO,63074-1807,Proprietary  ,14,25,39,33,135,168
04179000,"SALON PROFESSIONAL ACADEMY, THE         ",MO,65616-7216,Proprietary  ,0,0,0,1,4,5
04184400,SEYMOUR BEAUTY ACADEMY                  ,MO,65746-8743,Proprietary  ,1,9,10,5,30,35
04187000,DONNA'S ACADEMY OF HAIR DESIGN          ,MO,64089-9042,Proprietary  ,6,13,19,25,25,50
04212100,ACADEMY OF SALON PROFESSIONALS          ,MO,65301-6910,Proprietary  ,6,23,29,19,65,84
04218400,CITY POINTE BEAUTY ACADEMY              ,MO,64870-2502,Proprietary  ,9,30,39,36,86,122
04236300,BEYOND THE BASICS SCHOOL OF COSMETOLOGY ,MO,65706-0003,Proprietary  ,0,5,5,0,5,5
04243000,ESSENTIALS ACADEMY OF COSMETOLOGY       ,MO,64850-9104,Proprietary  ,2,4,6,2,4,6
04247100,ACADEMY OF COSMETOLOGY AND ESTHETICS    ,MO,64772-2805,Proprietary  ,4,5,9,4,5,9
04247400,EA LA MAR'S COSMETOLOGY & BARBER COLLEGE,MO,64127-1912,Proprietary  ,1,9,10,1,9,10
04249500,LEBANON COLLEGE OF COSMETOLOGY          ,MO,65536-3800,Proprietary  ,3,1,4,3,1,4
00314600,WESTERN OKLAHOMA STATE COLLEGE          ,OK,73521-1397,Public       ,144,266,410,541,829,1370
00314700,BACONE COLLEGE                          ,OK,74403-1597,Private      ,186,225,411,798,632,1430
00314900,SOUTHERN NAZARENE UNIVERSITY            ,OK,73008-2694,Private      ,163,554,717,1231,1817,3048
00315000,CAMERON UNIVERSITY                      ,OK,73505-6377,Public       ,425,943,1368,1992,3390,5382
00315100,OKLAHOMA WESLEYAN UNIVERSITY            ,OK,74006-6299,Private      ,63,255,318,1127,1149,2276
00315200,UNIV OF CENTRAL OKLAHOMA                ,OK,73034-5209,Public       ,1525,1866,3391,9902,7260,17162
00315300,CONNORS STATE COLLEGE                   ,OK,74469-2204,Public       ,233,427,660,1316,1474,2790
00315400,EAST CENTRAL UNIVERSITY                 ,OK,74820-6999,Public       ,410,618,1028,2846,2259,5105
00315500,EASTERN OKLAHOMA STATE COLLEGE          ,OK,74578-4999,Public       ,145,303,448,795,984,1779
00315600,REDLANDS COMMUNITY COLLEGE              ,OK,73036-5304,Public       ,153,296,449,725,921,1646
00315700,LANGSTON UNIVERSITY                     ,OK,73050-0000,Public       ,453,464,917,3381,1846,5227
00315800,MURRAY STATE COLLEGE                    ,OK,73460-3137,Public       ,256,413,669,1310,1416,2726
00316000,NORTHEASTERN OKLAHOMA A & M COLLEGE     ,OK,74354-6497,Public       ,253,306,559,1733,1054,2787
00316100,NORTHEASTERN STATE UNIVERSITY           ,OK,74464-2399,Public       ,641,1254,1895,5046,5626,10672
00316200,NORTHERN OKLAHOMA COLLEGE               ,OK,74653-0310,Public       ,457,489,946,1928,1662,3590
00316300,NORTHWESTERN OKLAHOMA STATE UNIV        ,OK,73717-2799,Public       ,252,258,510,1386,912,2298
00316400,OKLAHOMA BAPTIST UNIVERSITY             ,OK,74801-2590,Private      ,263,117,380,2730,484,3214
00316500,OKLAHOMA CHRISTIAN UNIVERSITY           ,OK,73131-0000,Private      ,305,268,573,2547,928,3475
00316600,OKLAHOMA CITY UNIVERSITY                ,OK,73106-1493,Private      ,311,572,883,2629,2579,5208
00316700,UNIV OF SCIENCE & ARTS OF OKLAHOMA      ,OK,73018-5322,Public       ,83,97,180,815,384,1199
00316800,ROGERS STATE UNIVERSITY                 ,OK,74017-3252,Public       ,392,668,1060,2677,2521,5198
00317000,OKLAHOMA STATE UNIVERSITY               ,OK,74078-1026,Public       ,2112,1604,3716,19175,7632,26807
00317200,OKLAHOMA STATE UNIVERSITY-OKMULGEE      ,OK,74447-3901,Public       ,304,477,781,1794,1684,3478
00317400,OKLAHOMA PANHANDLE STATE UNIVERSITY     ,OK,73939-0000,Public       ,181,121,302,799,362,1161
00317600,CARL ALBERT STATE COLLEGE               ,OK,74953-5208,Public       ,210,469,679,1220,1584,2804
00317800,SEMINOLE STATE COLLEGE                  ,OK,74818-0351,Public       ,211,309,520,937,1050,1987
00317900,SOUTHEASTERN OKLAHOMA STATE UNIV        ,OK,74701-0609,Public       ,409,633,1042,2277,2225,4502
00318000,SOUTHWESTERN CHRISTIAN UNIVERSITY       ,OK,73008-2335,Private      ,87,137,224,443,521,964
00318100,SOUTHWESTERN OKLAHOMA STATE UNIV        ,OK,73096-3098,Public       ,484,579,1063,3311,2057,5368
00318101,SOUTHWESTERN OK STATE UNIV AT SAYRE     ,OK,73662-0000,Public       ,27,64,91,157,176,333
00318300,ST GREGORY'S UNIVERSITY                 ,OK,74804-2499,Private      ,78,114,192,496,381,877
00318308,SAINT GREGORY'S UNIVERSITY - IPD TULSA  ,OK,74135-2499,Private      ,5,37,42,39,126,165
00318400,UNIVERSITY OF OKLAHOMA                  ,OK,73019-4078,Public       ,1630,1850,3480,18419,9298,27717
00318401,UNIVERSITY OF OKLAHOMA-HLTH SCI CTR     ,OK,73190-0000,Public       ,82,351,433,735,3080,3815
00318500,UNIVERSITY OF TULSA                     ,OK,74104-3189,Private      ,265,419,684,3703,1806,5509
00398500,ORAL ROBERTS UNIVERSITY                 ,OK,74171-0001,Private      ,352,482,834,3073,1889,4962
00531100,TULSA COUNTY AREA VOC TECH SCHOOL       ,OK,74145-0000,Public       ,187,404,591,680,1498,2178
00531200,RED RIVER TECHNOLOGY CENTER             ,OK,73533-2700,Public       ,16,56,72,35,152,187
00533900,METRO TECHNOLOGY CENTERS SCH DIST22     ,OK,73111-0000,Public       ,59,282,341,200,926,1126
00533903,METRO TECHNOLOGY CENTERS SCH DIST22     ,OK,73129-0000,Public       ,36,171,207,142,628,770
00694200,MID-AMERICA CHRISTIAN UNIVERSITY        ,OK,73170-4504,Private      ,123,711,834,578,2715,3293
00767800,SPARTAN COLLEGE OF AERONAUTICS AND TECHN,OK,74115-5800,Proprietary  ,110,196,306,861,740,1601
00791100,VIRGILS BEAUTY COLLEGE                  ,OK,74401-6802,Proprietary  ,2,29,31,9,55,64
00834300,AUTRY TECHNOLOGY CENTER                 ,OK,73703-2598,Public       ,27,72,99,85,213,298
00861900,TRI COUNTY TECHNOLOGY CENTER            ,OK,74006-6029,Public       ,0,0,0,19,65,84
00918500,ROSE STATE COLLEGE                      ,OK,73110-2799,Public       ,647,1491,2138,2824,4569,7393
00920400,KIAMICHI TECHNOLOGY CENTER              ,OK,74578-0548,Public       ,60,215,275,241,704,945
00961800,TULSA WELDING SCHOOL                    ,OK,74104-0000,Proprietary  ,400,807,1207,1803,2259,4062
00964700,"OKLAHOMA STATE UNIV, OKLA CITY          ",OK,73107-6159,Public       ,571,1632,2203,2776,5534,8310
00970800,EVES COLLEGE OF HAIRSTYLING             ,OK,73501-0000,Proprietary  ,7,68,75,15,130,145
00976300,TULSA COMMUNITY COLLEGE                 ,OK,74135-6198,Public       ,1541,2983,4524,8033,10699,18732
00996300,CADDO KIOWA VOC TECH CENTER             ,OK,73038-0000,Public       ,19,77,96,76,220,296
00996400,CENTRAL OKLAHOMA AREA VOC TECH SCH      ,OK,74030-9613,Public       ,24,71,95,91,236,327
00996500,CANADIAN VALLEY TECHNOLOGY CENTER       ,OK,73036-9117,Public       ,29,105,134,74,299,373
00996800,GORDON COOPER TECHNOLOGY CENTER         ,OK,74804-9913,Public       ,28,103,131,116,372,488
01005300,INDIAN CAPITAL TECHNOLGY CENTER #4      ,OK,74403-9907,Public       ,53,167,220,214,552,766
01026600,HILLSDALE FREE WILL BAPTIST COLLEGE     ,OK,73153-0000,Private      ,58,62,120,247,122,369
01034200,SOUTHERN OKLAHOMA TECHNOLOGY CENTER     ,OK,73401-2100,Public       ,18,76,94,80,257,337
01039100,OKLAHOMA CITY COMMUNITY COLLEGE         ,OK,73159-4444,Public       ,1306,2747,4053,5311,8350,13661
01050304,WTI TULSA CAMPUS                        ,OK,74112-3140,Proprietary  ,9,86,95,34,228,262
01071700,GREAT PLAINS TECHNOLOGY CENTER SCHOOL DI,OK,73505-8399,Public       ,51,142,193,179,516,695
01076200,WESTERN OK AREA VOC TECH SCH DIST12     ,OK,73624-1469,Public       ,14,37,51,45,111,156
01120600,PIONEER TECHNOLOGY CENTER               ,OK,74601-1106,Public       ,10,53,63,31,160,191
01128200,OKLAHOMA STATE UNV CLG OSTEOPTHC MD     ,OK,74107-0000,Public       ,26,118,144,143,716,859
01153700,MID-AMERICA TECHNOLOGY CENTER           ,OK,73095-0210,Public       ,14,23,37,44,101,145
01227200,MOORE-NORMAN TECHNOLOGY CENTER          ,OK,73069-8399,Public       ,77,227,304,242,798,1040
02052700,NORTHEAST TECHNOLOGY CENTER             ,OK,74361-0487,Public       ,40,136,176,143,436,579
02060800,MERIDIAN TECHNOLOGY CENTER              ,OK,74074-0000,Public       ,33,81,114,130,245,375
02126500,ENID BEAUTY COLLEGE                     ,OK,73701-0000,Proprietary  ,3,20,23,19,43,62
02184400,SAND SPRINGS BEAUTY COLLEGE             ,OK,74063-0000,Proprietary  ,10,30,40,24,79,103
02197300,HOLLYWOOD COSMETOLOGY CENTER            ,OK,73189-0000,Proprietary  ,6,23,29,22,64,86
02222700,FRANCIS TUTTLE TECHNOLOGY CENTER        ,OK,73142-0000,Public       ,103,434,537,319,1325,1644
02238500,CENTRAL STATE BEAUTY ACADEMY            ,OK,73162-6007,Proprietary  ,30,112,142,74,272,346
02250900,E OK COUNTY AREA VO-TECH                ,OK,73020-0000,Public       ,9,21,30,46,81,127
02256200,"BROKEN ARROW BEAUTY COLLEGE, INC        ",OK,74012-0000,Proprietary  ,22,55,77,60,177,237
02282100,HIGH PLAINS AREA VOC-TECH               ,OK,73801-0000,Public       ,4,39,43,22,85,107
02306800,PLATT COLLEGE                           ,OK,74145-0000,Proprietary  ,73,436,509,203,1178,1381
02306811,PLATT COLLEGE - LAWTON                  ,OK,73501-3808,Proprietary  ,26,165,191,75,406,481
02510300,BEAUTY TECHNICAL COLLEGE                ,OK,74465-0000,Proprietary  ,3,9,12,10,41,51
02531200,WOODWARD BEAUTY COLLEGE                 ,OK,73801-0000,Proprietary  ,1,10,11,6,42,48
02556500,YUKON BEAUTY COLLEGE                    ,OK,73099-4108,Proprietary  ,1,12,13,6,32,38
02560200,PHILLIPS THEOLOGICAL SEMINARY -         ,OK,74116-5612,Private      ,0,32,32,1,100,101
02581100,CLAREMORE BEAUTY COLLEGE                ,OK,74017-7034,Proprietary  ,7,20,27,15,33,48
02581200,CC'S COSMETOLOGY COLLEGE                ,OK,74129-0000,Proprietary  ,10,67,77,46,148,194
02591101,CAREER POINT INSTITUTE                  ,OK,74146-0000,Proprietary  ,14,97,111,62,302,364
02596501,ATI-CAREER TRAINING CENTER - OKLAHOMA CI,OK,73107-2442,Proprietary  ,2,22,24,11,82,93
02596502,ATI- CAREER TRAINING CENTER - OKLAHOMA C,OK,76101-2740,Proprietary  ,8,32,40,24,109,133
02597400,PONTOTOC TECHNOLOGY CENTER SCHOOL       ,OK,74820-8621,Public       ,20,39,59,74,155,229
02599706,VATTEROTT COLLEGE - TULSA               ,OK,74146-2205,Proprietary  ,13,119,132,53,386,439
02600000,NORTHWEST TECHNOLOG CTR SCH DIST 10     ,OK,73717-9600,Public       ,4,21,25,16,44,60
02600500,WES WATKINS TECHNOLOGY CENTER           ,OK,74883-9660,Public       ,3,19,22,23,98,121
02609205,VATTEROTT COLLEGE - OKLAHOMA CITY       ,OK,73127-2103,Proprietary  ,25,215,240,63,635,698
03008700,SOUTHWEST TECHNOLOGY CENTER             ,OK,73521-1527,Public       ,18,70,88,47,146,193
03024700,STILLWATER BEAUTY ACADEMY               ,OK,74075-3467,Proprietary  ,3,21,24,12,46,58
03030700,OKLAHOMA SCHOOL OF PHOTOGRAPHY          ,OK,73160-3320,Proprietary  ,5,27,32,31,83,114
03030800,AMERICAN BROADCASTING SCHOOL            ,OK,73115-3334,Proprietary  ,9,56,65,34,203,237
03051100,CHISHOLM TRAIL TECHNOLOGY CENTER        ,OK,73764-6335,Public       ,4,29,33,10,59,69
03078500,TECH INST OF COSMETOLOGY ARTS & SCI     ,OK,74120-3610,Proprietary  ,6,23,29,31,70,101
03103800,SOUTHERN SCHOOL OF BEAUTY               ,OK,74701-5008,Proprietary  ,6,11,17,16,36,52
03109800,PONCA CITY BEAUTY COLLEGE               ,OK,74601-4201,Proprietary  ,2,22,24,10,48,58
03109801,BARTLESVILLE BEAUTY COLLEGE             ,OK,74003-2835,Proprietary  ,4,8,12,7,32,39
03115100,HERITAGE COLLEGE                        ,OK,73119-0000,Proprietary  ,58,302,360,171,828,999
03124901,IMAGINE -  PAUL MITCHELL PARTNER SCHOOL ,OK,73072-4831,Proprietary  ,23,54,77,82,176,258
03126200,GREEN COUNTRY AREA VOC TECH SCHOOL      ,OK,74447-1217,Public       ,11,30,41,60,141,201
03198400,MID-DEL AREA VOCATIONAL & TECH SCH      ,OK,73110-4825,Public       ,17,60,77,54,160,214
03329400,PRYOR BEAUTY COLLEGE                    ,OK,74361-0000,Proprietary  ,5,9,14,9,25,34
03329401,PRYOR BEAUTY COLLEGE - GROVE BEAUTY COLL,OK,74345-0009,Proprietary  ,0,6,6,0,15,15
03329402,PRYOR BEAUTY COLLEGE - NORTH EAST OKLAHO,OK,74338-0000,Proprietary  ,0,0,0,0,1,1
03367400,COMMUNITY CARE COLLEGE                  ,OK,74145-6420,Proprietary  ,155,591,746,443,1648,2091
03453400,SHAWNEE BEAUTY COLLEGE                  ,OK,74801-7014,Proprietary  ,1,10,11,5,35,40
03676300,FAMILY OF FAITH COLLEGE                 ,OK,74802-1805,Private      ,1,8,9,7,26,33
03831300,INSTITUTE OF HAIR DESIGN                ,OK,74804-0000,Proprietary  ,1,8,9,5,24,29
03928300,CENTRAL STATE MASSAGE ACADEMY           ,OK,73162-6007,Proprietary  ,2,22,24,15,79,94
04051324,ART INSTITUTE OF PHOENIX (THE) - BROWN M,OK,74146-5234,Proprietary  ,16,49,65,57,253,310
04060300,AMERICAN INSTITUTE OF MEDICAL TECHNOLOGY,OK,74146-5201,Proprietary  ,20,70,90,98,256,354
04133600,CUTTER'S EDGE SCHOOL OF COSMETOLOGY     ,OK,74023-2905,Proprietary  ,1,2,3,4,15,19
04144400,ACADEMY OF HAIR DESIGN (THE)            ,OK,73120-6808,Proprietary  ,14,51,65,42,149,191
04184300,PAUL MITCHELL THE SCHOOL ARDMORE        ,OK,73401-3912,Proprietary  ,2,16,18,11,47,58
04213600,RIVER VALLEY COSMETOLOGY INSTITUTE      ,OK,74953-5260,Proprietary  ,3,18,21,14,59,73
04224700,JB'S HAIR DESIGN AND BARBER COLLEGE     ,OK,73139-1602,Proprietary  ,11,41,52,28,135,163
04224900,COLLEGE OF THE MUSCOGEE NATION          ,OK,74447-0917,Public       ,40,79,119,115,171,286
04225100,COMANCHE NATION COLLEGE                 ,OK,73501-7434,Public       ,10,31,41,23,102,125
04240500,PAUL MITCHELL THE SCHOOL TULSA          ,OK,74134-1410,Proprietary  ,23,58,81,86,190,276
00163700,BETHANY THEOLOGICAL SEMINARY            ,IN,47374-0000,Private      ,1,7,8,2,44,46
00178400,ANCILLA COLLEGE-FINANCIAL AID OFFC      ,IN,46513-0001,Private      ,39,47,86,538,373,911
00178500,ANDERSON UNIVERSITY                     ,IN,46012-3495,Private      ,55,170,225,2547,1060,3607
00178600,BALL STATE UNIVERSITY                   ,IN,47306-0880,Public       ,482,919,1401,23683,8517,32200
00178700,BETHEL COLLEGE INC                      ,IN,46545-5591,Private      ,31,148,179,1768,1305,3073
00178800,BUTLER UNIVERSITY                       ,IN,46208-3487,Private      ,162,186,348,8035,2155,10190
00178900,CHRISTIAN THEOLOGICAL SEMINARY          ,IN,46208-0000,Private      ,0,41,41,14,259,273
00179200,DEPAUW UNIVERSITY                       ,IN,46135-0037,Private      ,83,18,101,3279,168,3447
00179300,EARLHAM COLLEGE                         ,IN,47374-4095,Private      ,53,14,67,1588,159,1747
00179301,EARLHAM SCHOOL OF RELIGION              ,IN,47374-0000,Private      ,1,9,10,14,54,68
00179500,UNIVERSITY OF EVANSVILLE                ,IN,47722-0002,Private      ,62,97,159,3350,784,4134
00179800,FRANKLIN COLLEGE OF INDIANA             ,IN,46131-2623,Private      ,17,27,44,1944,339,2283
00179900,GOSHEN COLLEGE                          ,IN,46526-4794,Private      ,32,75,107,886,530,1416
00180000,GRACE COLLEGE & THEO SEMINARY           ,IN,46590-1224,Private      ,49,98,147,2237,710,2947
00180100,HANOVER COLLEGE                         ,IN,47243-0108,Private      ,48,12,60,2184,126,2310
00180300,HUNTINGTON UNIVERSITY                   ,IN,46750-1299,Private      ,17,52,69,1285,546,1831
00180400,UNIVERSITY OF INDIANAPOLIS              ,IN,46227-3697,Private      ,159,441,600,6770,4732,11502
00180500,INDIANA INSTITUTE OF TECHNOLOGY         ,IN,46803-1297,Private      ,235,1788,2023,2840,8269,11109
00180700,INDIANA STATE UNIVERSITY                ,IN,47809-2501,Public       ,382,896,1278,14868,7423,22291
00180800,UNIVERSITY OF SOUTHERN INDIANA          ,IN,47712-3596,Public       ,289,454,743,8443,3463,11906
00180900,INDIANA UNIVERSITY-BLOOMINGTON          ,IN,47405-7000,Public       ,883,1086,1969,34721,10925,45646
00181100,INDIANA UNIV-EAST                       ,IN,47374-1289,Public       ,83,419,502,2065,2838,4903
00181300,INDIANA UNIV-PURDUE UNIV INDPLS         ,IN,46202-5145,Public       ,731,2048,2779,24315,21778,46093
00181301,INDIANA UNIVERSITY - PURDUE UNIVERSITY I,IN,47203-1769,Public       ,76,213,289,2090,1845,3935
00181400,INDIANA UNIV KOKOMO                     ,IN,46902-3557,Public       ,89,287,376,2811,2426,5237
00181500,INDIANA UNIV-NORTHWEST                  ,IN,46408-1197,Public       ,267,728,995,4177,4702,8879
00181600,INDIANA UNIVERSITY - SOUTH BEND         ,IN,46615-0000,Public       ,207,532,739,5149,4796,9945
00181700,INDIANA UNIVERSITY-SOUTHEAST            ,IN,47150-6405,Public       ,306,630,936,4303,3657,7960
00182000,MANCHESTER UNIVERSITY                   ,IN,46962-1276,Private      ,31,22,53,2640,553,3193
00182100,MARIAN UNIVERSITY                       ,IN,46222-1997,Private      ,89,335,424,2492,3214,5706
00182200,INDIANA WESLEYAN UNIVERSITY             ,IN,46953-4974,Private      ,199,2569,2768,4315,15186,19501
00182300,ASSOCIATED MENNONITE BIBLICAL SEM       ,IN,46517-1999,Private      ,1,4,5,4,73,77
00182400,OAKLAND CITY UNIVERSITY                 ,IN,47660-1099,Private      ,22,92,114,477,598,1075
00182500,PURDUE UNIVERSITY                       ,IN,47907-2050,Public       ,705,852,1557,35188,7459,42647
00182600,PURDUE UNIV NORTH CENTRAL CAMPUS        ,IN,46391-9542,Public       ,150,239,389,3381,2126,5507
00182700,PURDUE UNIV CALUMET                     ,IN,46323-2094,Public       ,364,909,1273,5879,5963,11842
00182800,INDIANA UNIV-PURDUE UNIV FORT WAYNE     ,IN,46805-1499,Public       ,385,777,1162,9682,6499,16181
00183000,ROSE HULMAN INSTITUTE OF TECHNOLOGY     ,IN,47803-3999,Private      ,36,20,56,3313,208,3521
00183200,UNIVERSITY OF SAINT FRANCIS             ,IN,46808-3994,Private      ,48,203,251,2312,2024,4336
00183300,ST JOSEPH'S COLLEGE                     ,IN,47978-0000,Private      ,17,10,27,1477,204,1681
00183400,CALUMET COLLEGE OF SAINT JOSEPH         ,IN,46394-2195,Private      ,57,132,189,556,702,1258
00183500,SAINT MARY-OF-THE-WOODS COLLEGE         ,IN,47876-0067,Private      ,24,146,170,425,974,1399
00183600,ST MARY'S COLLEGE                       ,IN,46556-5007,Private      ,29,13,42,1911,194,2105
00183800,TAYLOR UNIVERSITY                       ,IN,46989-1001,Private      ,72,51,123,2471,245,2716
00183900,TRINE UNIVERSITY                        ,IN,46703-1764,Private      ,46,163,209,2990,1130,4120
00184000,UNIVERSITY OF NOTRE DAME                ,IN,46556-5602,Private      ,226,261,487,13693,2974,16667
00184200,VALPARAISO UNIVERSITY                   ,IN,46383-6493,Private      ,140,221,361,5698,1890,7588
00184300,VINCENNES UNIVERSITY                    ,IN,47591-1523,Public       ,363,821,1184,7399,4361,11760
00184400,WABASH COLLEGE                          ,IN,47933-0352,Private      ,11,13,24,1287,74,1361
00457900,INTERNATIONAL BUSINESS COLLEGE          ,IN,46804-0000,Proprietary  ,16,41,57,620,364,984
00457901,INTERNATIONAL BUSINESS COLLEGE          ,IN,46256-0000,Proprietary  ,22,47,69,623,467,1090
00625700,SAINT ELIZABETH SCHOOL OF NURSING       ,IN,47904-2198,Private      ,4,23,27,159,340,499
00638510,CHAMBERLAIN COLLEGE OF NURSING - INDIANA,IN,46240-2158,Proprietary  ,9,243,252,194,1699,1893
00726300,HOLY CROSS COLLEGE                      ,IN,46556-0308,Private      ,28,5,33,731,125,856
00727600,SAINT MEINRAD SCHOOL OF THEOLOGY        ,IN,47577-1002,Private      ,0,36,36,1,92,93
00732900,ITT TECHNICAL INSTITUTE                 ,IN,46268-1119,Proprietary  ,795,4328,5123,2856,14974,17830
00732933,ITT TECHNICAL INSTITUTE                 ,IN,46635-1512,Proprietary  ,21,139,160,280,756,1036
00732962,ITT TECHNICAL INSTITUTE                 ,IN,47630-7430,Proprietary  ,137,850,987,522,2951,3473
00732968,ITT TECHNICAL INSTITUTE                 ,IN,46410-0000,Proprietary  ,16,129,145,212,739,951
00732993,ITT TECHNICAL INSTITUTE                 ,IN,46825-2393,Proprietary  ,128,560,688,757,2406,3163
00736200,MEDTECH COLLEGE                         ,IN,46250-3970,Proprietary  ,27,199,226,261,1410,1671
00736202,MEDTECH COLLEGE - GREENWOOD             ,IN,46143-6478,Proprietary  ,14,80,94,96,538,634
00736204,MEDTECH COLLEGE - FORT WAYNE            ,IN,46804-2209,Proprietary  ,19,124,143,179,877,1056
00793800,LINCOLN COLLEGE OF TECHNOLOGY           ,IN,46202-0000,Proprietary  ,151,192,343,1512,975,2487
00951500,J MICHAEL HARROLD BEAUTY ACADEMY        ,IN,47807-3390,Proprietary  ,6,27,33,46,118,164
00961200,"APEX SCHOOL OF BEAUTY CULTURE, INC      ",IN,46016-0000,Proprietary  ,4,12,16,23,56,79
00961300,MERRILLVILLE BEAUTY COLLEGE             ,IN,46410-3401,Proprietary  ,8,33,41,39,165,204
00967300,RUDAE'S SCHOOL OF BEAUTY CULTURE        ,IN,46825-5444,Proprietary  ,42,60,102,137,210,347
00991700,IVY TECH COMMUNITY COLLEGE OF INDIANA   ,IN,46208-1763,Public       ,3515,11798,15313,40278,73791,114069
01015100,VINCENNES BEAUTY COLLEGE                ,IN,47591-1297,Proprietary  ,7,19,26,90,84,174
01040900,LAFAYETTE BEAUTY ACADEMY                ,IN,47901-1149,Proprietary  ,14,30,44,70,180,250
01048900,NATIONAL COLLEGE                        ,IN,46250-1930,Proprietary  ,9,59,68,52,371,423
01048910,NATIONAL COLLEGE - SOUTH BEND           ,IN,46617-3123,Proprietary  ,5,55,60,59,327,386
01048911,NATIONAL COLLEGE - FORT WAYNE           ,IN,46826-4905,Proprietary  ,2,35,37,43,201,244
01061800,MID-AMERICA CLG FUNERAL SERVICE         ,IN,47130-9990,Private      ,8,24,32,59,116,175
01150500,CREATIVE HAIR STYLING ACADEMY           ,IN,46322-1554,Proprietary  ,25,49,74,119,178,297
02084800,RAVENSCROFT BEAUTY COLLEGE              ,IN,46815-0000,Proprietary  ,20,66,86,104,222,326
02087600,CONCORDIA THEOLOGICAL SEMINARY          ,IN,46825-0000,Private      ,3,22,25,11,217,228
02100402,EVEREST INSTITUTE - EVEREST COLLEGE     ,IN,46410-7064,Proprietary  ,3,41,44,70,267,337
02140800,MARTIN UNIVERSITY                       ,IN,46218-0000,Private      ,16,153,169,146,1054,1200
02158400,HARRISON COLLEGE                        ,IN,46204-2611,Proprietary  ,88,444,532,600,2831,3431
02158401,HARRISON COLLEGE - COLUMBUS             ,IN,47203-1843,Proprietary  ,12,104,116,143,586,729
02158402,HARRISON COLLEGE - LAFAYETTE            ,IN,47905-4859,Proprietary  ,13,108,121,169,589,758
02158405,HARRISON COLLEGE - TERRE HAUTE          ,IN,47802-0000,Proprietary  ,10,82,92,116,619,735
02158407,HARRISON COLLEGE - ANDERSON             ,IN,46013-0000,Proprietary  ,15,94,109,151,586,737
02158409,HARRISON COLLEGE - EVANSVILLE           ,IN,47715-3901,Proprietary  ,12,120,132,176,536,712
02158410,HARRISON COLLEGE - EAST                 ,IN,46239-8903,Proprietary  ,23,178,201,228,1129,1357
02158412,HARRISON COLLEGE - FORT WAYNE           ,IN,46825-0000,Proprietary  ,19,101,120,140,621,761
02158413,HARRISON COLLEGE - NORTHWEST            ,IN,46278-0000,Proprietary  ,14,58,72,234,432,666
02158415,HARRISON COLLEGE - MUNCIE               ,IN,47303-0000,Proprietary  ,5,29,34,84,199,283
02158416,HARRISON COLLEGE - ELKHART              ,IN,46516-0000,Proprietary  ,11,77,88,69,314,383
02158800,DON ROBERTS BEAUTY SCHOOLS              ,IN,46383-0000,Proprietary  ,4,12,16,35,63,98
02164300,DON ROBERTS SCHOOL OF HAIR DESIGN       ,IN,46375-9999,Proprietary  ,6,25,31,27,76,103
02180108,ROSS MEDICAL EDUCATION CENTER -         ,IN,46530-4479,Proprietary  ,6,38,44,60,191,251
02201800,KAPLAN COLLEGE                          ,IN,46324-3347,Proprietary  ,47,189,236,220,764,984
02201806,KAPLAN COLLEGE - SOUTHEAST INDIANAPOLIS ,IN,46227-1493,Proprietary  ,74,390,464,392,1757,2149
02241700,PJ'S COLLEGE OF COSMETOLOGY             ,IN,47129-0000,Proprietary  ,11,39,50,67,153,220
02245505,FORTIS COLLEGE - INDIANAPOLIS CAMPUS    ,IN,46268-0000,Proprietary  ,14,87,101,94,620,714
02304800,PJ'S COLLEGE OF COSMETOLOGY             ,IN,47374-0000,Proprietary  ,4,13,17,48,81,129
02308900,MASTER'S OF COSMETOLOGY COLLEGE         ,IN,46809-0000,Proprietary  ,9,26,35,98,134,232
02339600,ROGER'S ACADEMY OF HAIR DESIGN          ,IN,47712-0000,Proprietary  ,17,51,68,77,131,208
02351300,KNOX BEAUTY COLLEGE                     ,IN,46534-0000,Proprietary  ,2,9,11,12,28,40
02490500,HAIR FASHIONS BY KAYE BEAUTY CLG        ,IN,46250-0000,Proprietary  ,7,71,78,83,298,381
02490800,HAIR FASHIONS BY KAYE BEAUTY CLG        ,IN,46060-0000,Proprietary  ,7,21,28,31,59,90
02607000,HAIR ARTS ACADEMY                       ,IN,47404-2419,Proprietary  ,10,30,40,63,111,174
02615800,COLLEGE OF COURT REPORTING              ,IN,46342-5969,Proprietary  ,6,60,66,32,247,279
03176300,AVIATION INSTITUTE OF MAINTENANCE       ,IN,46241-1445,Proprietary  ,16,61,77,135,342,477
03456700,CROSSROADS BIBLE COLLEGE                ,IN,46219-4912,Private      ,7,34,41,61,403,464
03538300,ALEXANDRIA SCH OF SCIENTIFIC THERAP     ,IN,46001-0287,Proprietary  ,2,19,21,19,69,88
04038700,IDEAL BEAUTY ACADEMY                    ,IN,47130-4215,Proprietary  ,0,20,20,15,55,70
04051304,ART INSTITUTE OF PHOENIX (THE) - ART  IN,IN,46268-1170,Proprietary  ,93,187,280,992,937,1929
04051311,ART INSTITUTE OF PHOENIX (THE) - BROWN M,IN,46410-5608,Proprietary  ,17,87,104,119,576,695
04051312,ART INSTITUTE OF PHOENIX (THE) - BROWN M,IN,46360-7362,Proprietary  ,5,11,16,41,106,147
04051318,ART INSTITUTE OF PHOENIX (THE) - BROWN M,IN,46204-1017,Proprietary  ,27,191,218,240,1219,1459
04051321,ART INSTITUTE OF PHOENIX (THE) - BROWN M,IN,46635-1176,Proprietary  ,22,85,107,136,520,656
04051322,ART INSTITUTE OF PHOENIX (THE) - BROWN M,IN,46805-0000,Proprietary  ,17,75,92,152,579,731
04100300,SUCCESS SCHOOLS                         ,IN,46410-5310,Proprietary  ,16,56,72,73,197,270
04121000,TECHSKILLS - INDIANAPOLIS               ,IN,46240-4302,Proprietary  ,17,174,191,99,493,592
04130900,HONORS BEAUTY COLLEGE                   ,IN,46256-3317,Proprietary  ,11,53,64,102,268,370
04155900,AVEDA FREDRIC'S INSTITUTE               ,IN,46250-4746,Proprietary  ,24,58,82,183,260,443
04166700,REM SPA INC                             ,IN,46013-3136,Proprietary  ,9,34,43,59,142,201
04171700,AVANT GARD THE SCHOOL                   ,IN,46214-6500,Proprietary  ,4,17,21,24,72,96
04172700,SALON PROFESSIONAL ACADEMY (THE)        ,IN,47715-7822,Proprietary  ,10,31,41,111,136,247
04184000,PAUL MITCHELL THE SCHOOL INDIANAPOLIS   ,IN,46227-6252,Proprietary  ,19,61,80,165,283,448
04186600,SALON PROFESSIONAL ACADEMY (THE)        ,IN,46901-6248,Proprietary  ,11,27,38,68,131,199
04205500,LIL LOU'S BARBER COLLEGE                ,IN,46409-2645,Proprietary  ,9,61,70,39,160,199
04230300,EXCEL ACADEMIES OF COSMETOLOGY - MERRILL,IN,46410-5540,Proprietary  ,13,19,32,71,93,164
00190100,ALLEN COUNTY COMMUNITY COLLEGE          ,KS,66749-1607,Public       ,197,379,576,1034,1147,2181
00190200,COWLEY COUNTY COMMUNITY COLLEGE & AREA V,KS,67005-2662,Public       ,338,675,1013,1449,1782,3231
00190300,BAKER UNIVERSITY                        ,KS,66006-0065,Private      ,101,501,602,1297,1613,2910
00190400,BETHANY COLLEGE                         ,KS,67456-1897,Private      ,80,31,111,898,132,1030
00190500,BETHEL COLLEGE                          ,KS,67117-8061,Private      ,48,13,61,724,152,876
00190600,BUTLER COUNTY COMMUNITY COLLEGE         ,KS,67042-3280,Public       ,886,1449,2335,4069,4384,8453
00190700,CENTRAL BAPTIST THEOLOGY SEMINARY       ,KS,66226-3513,Private      ,0,15,15,0,44,44
00190800,CENTRAL CHRISTIAN COLLEGE OF KANSAS     ,KS,67460-5799,Private      ,61,384,445,372,890,1262
00190900,CLOUD COUNTY COMMUNITY COLLEGE          ,KS,66901-1002,Public       ,130,257,387,715,811,1526
00191000,COFFEYVILLE COMMUNITY COLLEGE           ,KS,67337-5064,Public       ,184,144,328,939,468,1407
00191100,COLBY COMMUNITY COLLEGE                 ,KS,67701-4099,Public       ,91,126,217,555,486,1041
00191300,DODGE CITY COMMUNITY COLLEGE            ,KS,67801-2399,Public       ,183,228,411,853,609,1462
00191400,DONNELLY COLLEGE                        ,KS,66102-4298,Private      ,32,118,150,279,435,714
00191500,FORT HAYS STATE UNIVERSITY              ,KS,67601-4099,Public       ,430,1466,1896,4432,6415,10847
00191600,FORT SCOTT COMMUNITY COLLEGE            ,KS,66701-3199,Public       ,201,251,452,1056,732,1788
00191700,BARCLAY COLLEGE                         ,KS,67059-0288,Private      ,39,62,101,159,147,306
00191800,FRIENDS UNIVERSITY                      ,KS,67213-3397,Private      ,87,424,511,1275,1775,3050
00191900,GARDEN CITY COMMUNITY COLLEGE           ,KS,67846-6398,Public       ,182,202,384,1163,604,1767
00192000,HESSTON COLLEGE                         ,KS,67062-2093,Private      ,17,20,37,387,164,551
00192100,HIGHLAND COMMUNITY COLLEGE              ,KS,66035-4062,Public       ,223,342,565,1201,1152,2353
00192300,HUTCHINSON COMMUNITY COLLEGE            ,KS,67501-5894,Public       ,339,748,1087,2122,2236,4358
00192400,INDEPENDENCE COMMUNITY COLLEGE          ,KS,67301-0708,Public       ,111,108,219,604,338,942
00192500,KANSAS CITY KANSAS COMMUNITY CLG        ,KS,66112-9978,Public       ,457,1227,1684,1969,3900,5869
00192600,PITTSBURG STATE UNIVERSITY              ,KS,66762-7500,Public       ,614,564,1178,5351,2434,7785
00192700,EMPORIA STATE UNIVERSITY                ,KS,66801-5415,Public       ,419,501,920,3538,2546,6084
00192800,KANSAS STATE UNIVERSITY                 ,KS,66506-1104,Public       ,1229,1109,2338,16270,6221,22491
00192900,KANSAS WESLEYAN UNIVERSITY              ,KS,67401-6196,Private      ,47,60,107,987,282,1269
00193000,LABETTE COMMUNITY COLLEGE               ,KS,67357-4299,Public       ,95,234,329,572,720,1292
00193100,MANHATTAN CHRISTIAN COLLEGE             ,KS,66502-4081,Private      ,24,20,44,328,106,434
00193300,MCPHERSON COLLEGE                       ,KS,67460-3899,Private      ,72,34,106,862,165,1027
00193600,NEOSHO COUNTY COMMUNITY COLLEGE         ,KS,66720-2699,Public       ,121,265,386,722,946,1668
00193700,OTTAWA UNIVERSITY                       ,KS,66067-3399,Private      ,100,591,691,1053,2141,3194
00193800,PRATT COMMUNITY COLLEGE                 ,KS,67124-8432,Public       ,106,153,259,557,516,1073
00193900,NEWMAN UNIVERSITY                       ,KS,67213-2084,Private      ,102,299,401,1150,1374,2524
00194000,SOUTHWESTERN COLLEGE                    ,KS,67156-2499,Private      ,32,288,320,698,1118,1816
00194300,UNIVERSITY OF ST MARY                   ,KS,66048-5023,Private      ,82,214,296,826,813,1639
00194500,STERLING COLLEGE                        ,KS,67579-1533,Private      ,45,30,75,947,153,1100
00194600,TABOR COLLEGE                           ,KS,67063-1799,Private      ,61,86,147,792,260,1052
00194800,UNIVERSITY OF KANSAS                    ,KS,66045-7535,Public       ,1087,1226,2313,17799,9268,27067
00194900,WASHBURN UNIVERSITY                     ,KS,66621-1110,Public       ,340,705,1045,3572,3502,7074
00194901,WASHBURN INSTITUTE OF TECHNOLOGY        ,KS,66604-2199,Public       ,98,262,360,368,836,1204
00195000,WICHITA STATE UNIVERSITY                ,KS,67208-0000,Public       ,1058,1757,2815,8609,7405,16014
00460800,BARTON COUNTY COMMUNITY COLLEGE         ,KS,67530-9283,Public       ,155,627,782,917,1972,2889
00526400,FLINT HILLS TECHNICAL COLLEGE           ,KS,66801-5999,Public       ,64,84,148,276,350,626
00526500,NORTH CENTRAL KANSAS TECH COLG          ,KS,67420-0000,Public       ,77,74,151,378,271,649
00526700,NORTHWEST KANSAS TECHNICAL SCHOOL       ,KS,67735-3441,Public       ,56,20,76,341,93,434
00549800,WICHITA AREA TECHNICAL COLLEGE          ,KS,67211-2099,Public       ,246,954,1200,786,2418,3204
00549900,SALINA AREA TECHNICAL COLLEGE           ,KS,67401-8195,Public       ,23,67,90,159,264,423
00550000,MANHATTAN AREA TECHNICAL COLLEGE        ,KS,66503-2499,Public       ,60,173,233,368,601,969
00675500,BROWN MACKIE COLLEGE (THE)              ,KS,67401-7307,Proprietary  ,125,583,708,452,2068,2520
00703200,MID AMERICA NAZARENE UNIVERSITY         ,KS,66062-1899,Private      ,79,296,375,1091,1203,2294
00822800,SEWARD CO COMM CO/AREA TECHNICAL SCHOOL ,KS,67905-0000,Public       ,138,137,275,526,392,918
00824400,JOHNSON COUNTY COMMUNITY COLLEGE        ,KS,66210-1299,Public       ,930,1593,2523,5553,6111,11664
00833200,MARINELLO SCHOOL OF BEAUTY              ,KS,66502-6082,Proprietary  ,10,22,32,33,83,116
00833201,MARINELLO SCHOOL OF BEAUTY - LAWRENCE   ,KS,66046-2743,Proprietary  ,3,4,7,18,35,53
00869423,RASMUSSEN COLLEGE - OVERLAND PARK       ,KS,66210-2786,Proprietary  ,6,70,76,30,258,288
00869424,RASMUSSEN COLLEGE - TOPEKA              ,KS,66606-2339,Proprietary  ,14,95,109,55,369,424
01025600,BENEDICTINE COLLEGE                     ,KS,66002-1499,Private      ,112,37,149,2451,169,2620
01043800,HASKELL INDIAN NATIONS UNIVERSITY       ,KS,66046-4800,Public       ,183,150,333,894,600,1494
01050300,WICHITA TECHNICAL INSTITUTE             ,KS,67213-1927,Proprietary  ,54,251,305,173,754,927
01050302,WICHITA TECHNICAL INSTITUTE - WTI TOPEKA,KS,66609-1217,Proprietary  ,20,111,131,46,245,291
01050305,WICHITA TECHNICAL INSTITUTE - EAST CAMPU,KS,67208-4243,Proprietary  ,15,88,103,64,286,350
02090700,CLEVELAND CHIROPRACTIC COLLEGE          ,KS,66210-1613,Private      ,5,98,103,49,506,555
02134800,OLD TOWN BARBER AND BEAUTY COLLEGE      ,KS,67211-0000,Proprietary  ,14,33,47,35,101,136
02168900,KANSAS CITY COLLEGE & BIBLE SCHOOL      ,KS,66204-1975,Private      ,1,16,17,9,46,55
02257700,HAYS ACADEMY OF HAIR DESIGN             ,KS,67601-3685,Proprietary  ,6,12,18,45,46,91
02257702,HAYS ACADEMY OF HAIR DESIGN -           ,KS,67401-0000,Proprietary  ,4,14,18,42,51,93
02340700,LABARON HAIRDRESSING ACADEMY            ,KS,66204-0000,Proprietary  ,3,16,19,7,41,48
02590900,WRIGHT CAREER COLLEGE                   ,KS,66212-0000,Private      ,87,641,728,241,2279,2520
02599709,VATTEROTT COLLEGE - WICHITA             ,KS,67226-1304,Proprietary  ,19,111,130,57,380,437
02603100,CRAVE BEAUTY ACADEMY                    ,KS,67203-5428,Proprietary  ,24,53,77,97,194,291
02606300,PAUL MITCHELL THE SCHOOL WICHITA        ,KS,67226-2803,Proprietary  ,29,45,74,120,153,273
02611005,HERITAGE COLLEGE - WICHITA              ,KS,67210-1879,Proprietary  ,49,185,234,133,487,620
02613000,PINNACLE CAREER INSTITUTE               ,KS,66046-2703,Proprietary  ,9,54,63,47,215,262
03066200,BRYAN COLLEGE                           ,KS,66604-2496,Proprietary  ,10,60,70,29,207,236
03450300,MARINELLO SCHOOL OF BEAUTY              ,KS,66611-1101,Proprietary  ,10,41,51,46,112,158
03450301,MARINELLO SCHOOL OF BEAUTY - WICHITA    ,KS,67207-5148,Proprietary  ,11,26,37,39,99,138
03450302,MARINELLO SCHOOL OF BEAUTY - OVERLAND PA,KS,66212-5451,Proprietary  ,27,74,101,58,175,233
03529300,SIDNEY'S HAIRDRESSING COLLEGE           ,KS,67501-7094,Proprietary  ,2,3,5,16,21,37
04132900,Z HAIR ACADEMY                          ,KS,66046-4040,Proprietary  ,21,19,40,59,63,122
04162700,ERIC FISHER ACADEMY                     ,KS,67212-3376,Proprietary  ,48,62,110,158,190,348
04179600,ENTOURAGE INSTITUTE OF BEAUTY AND ESTHET,KS,66215-3803,Proprietary  ,12,40,52,25,106,131
04205300,MITSU SATO HAIR ACADEMY                 ,KS,66212-1457,Proprietary  ,7,15,22,15,35,50
04209300,PAUL MITCHELL THE SCHOOL - OVERLAND PARK,KS,66212-4050,Proprietary  ,39,51,90,119,159,278
00203300,UNIVERSITY OF MAINE-PRESQUE ISLE        ,ME,04769-2888,Public       ,33,92,125,1076,464,1540
00203600,BATES COLLEGE                           ,ME,04240-6028,Private      ,40,11,51,3122,116,3238
00203800,BOWDOIN COLLEGE                         ,ME,04011-8451,Private      ,40,12,52,3891,113,4004
00203900,COLBY COLLEGE                           ,ME,04901-8841,Private      ,57,8,65,3577,92,3669
00204000,UNIVERSITY OF MAINE-FARMINGTON          ,ME,04938-1990,Public       ,78,58,136,2548,454,3002
00204100,UNIVERSITY OF MAINE-FORT KENT           ,ME,04743-1292,Public       ,43,92,135,708,601,1309
00204300,HUSSON UNIVERSITY                       ,ME,04401-2999,Private      ,128,199,327,3237,1466,4703
00204400,MAINE MARITIME ACADEMY                  ,ME,04420-0001,Public       ,40,15,55,1177,193,1370
00205000,UNIVERSITY OF NEW ENGLAND               ,ME,04005-9599,Private      ,112,575,687,4813,5175,9988
00205100,SAINT JOSEPH'S COLLEGE                  ,ME,04084-5236,Private      ,41,265,306,1731,1264,2995
00205200,THOMAS COLLEGE                          ,ME,04901-5097,Private      ,64,46,110,1260,292,1552
00205300,UNIVERSITY OF MAINE                     ,ME,04469-0001,Public       ,277,320,597,13734,2767,16501
00205400,UNIVERSITY OF SOUTHERN MAINE            ,ME,04104-0000,Public       ,228,562,790,5562,4779,10341
00205500,UNIVERSITY OF MAINE-MACHIAS             ,ME,04654-1397,Public       ,34,56,90,585,357,942
00458615,KAPLAN UNIVERSITY - PORTLAND            ,ME,04106-2415,Proprietary  ,13,132,145,86,777,863
00458616,KAPLAN UNIVERSITY - LEWISTON            ,ME,04240-0000,Proprietary  ,18,126,144,90,841,931
00458617,KAPLAN UNIVERSITY - AUGUSTA             ,ME,04330-8038,Proprietary  ,19,201,220,125,939,1064
00520400,BEAL COLLEGE                            ,ME,04401-6896,Proprietary  ,25,92,117,195,578,773
00527600,CENTRAL MAINE COMMUNITY COLLEGE         ,ME,04210-6498,Public       ,207,394,601,1562,1837,3399
00527700,EASTERN MAINE COMMUNITY COLLEGE         ,ME,04401-4280,Public       ,170,309,479,1653,1638,3291
00552500,SOUTHERN MAINE COMMUNITY  COLLEGE       ,ME,04106-1698,Public       ,503,800,1303,3646,3582,7228
00576000,NORTHERN MAINE COMMUNITY COLLEGE        ,ME,04769-2016,Public       ,54,100,154,465,457,922
00630500,CENTRAL MAINE MEDICAL CENTER COLLEGE OF ,ME,04243-9986,Private      ,8,23,31,121,273,394
00676000,UNIVERSITY OF MAINE-AUGUSTA             ,ME,04330-9410,Public       ,162,726,888,1466,4492,5958
00685800,UNITY COLLEGE                           ,ME,04988-9502,Private      ,22,14,36,1085,117,1202
00903800,MR BERNARD'S SCH HAIR FASHION INC       ,ME,04243-1163,Proprietary  ,0,0,0,1,3,4
00923100,WASHINGTON COUNTY COMMUNITY COLLEGE     ,ME,04619-9704,Public       ,32,51,83,276,236,512
00945900,EMPIRE BEAUTY SCHOOL                    ,ME,04101-3348,Proprietary  ,158,380,538,485,1231,1716
00982600,KENNEBEC VALLEY  COMMUNITY  COLLEGE     ,ME,04937-1367,Public       ,115,347,462,927,1643,2570
01138500,COLLEGE OF THE ATLANTIC                 ,ME,04609-1105,Private      ,10,6,16,579,83,662
01167300,MAINE COLLEGE OF ART                    ,ME,04101-3987,Private      ,28,25,53,760,210,970
02104400,SPA TECH INSTITUTE                      ,ME,04093-0000,Proprietary  ,56,130,186,134,335,469
02347100,NEW ENGLAND SCHOOL OF COMMUNICATIONS    ,ME,04401-0000,Private      ,7,18,25,165,77,242
02361300,LANDING SCHOOL OF BOATBUILDING & DESIGN ,ME,04046-1490,Private      ,7,7,14,37,35,72
03122900,YORK COUNTY COMMUNITY COLLEGE           ,ME,04090-0529,Public       ,131,203,334,706,890,1596
03429300,SEACOAST CAREER SCHOOLS                 ,ME,04073-0000,Proprietary  ,28,92,120,64,270,334
03612300,BIRTHWISE MIDWIFERY SCHOOL              ,ME,04009-1110,Proprietary  ,1,9,10,14,81,95
04177400,CAPILO SCHOOL OF HAIR DESIGN            ,ME,04330-0000,Proprietary  ,17,49,66,77,122,199
04185100,NORTHEAST TECHNICAL INSTITUTE           ,ME,04074-0000,Proprietary  ,22,161,183,93,445,538
04188800,INSTITUTE FOR DOCTORAL STUDIES IN THE VI,ME,04102-0000,Private      ,0,11,11,2,56,58
04214100,COSMOTECH SCHOOL OF COSMETOLOGY         ,ME,04092-2878,Proprietary  ,7,15,22,24,45,69
00209300,ST JOHN'S COLLEGE                       ,NM,87505-4599,Private      ,17,27,44,315,170,485
00264900,SANTA FE UNIVERSITY OF ART AND DESIGN   ,NM,87505-7634,Proprietary  ,88,58,146,1402,360,1762
00265000,UNIVERSITY OF THE SOUTHWEST             ,NM,88240-9129,Private      ,90,334,424,347,841,1188
00265100,EASTERN NEW MEXICO UNIV PORTALES        ,NM,88130-6000,Public       ,548,776,1324,3161,2666,5827
00265101,EASTERN NEW MEXICO UNIV-ROSWELL CAM     ,NM,88202-0000,Public       ,250,424,674,921,1232,2153
00265300,NEW MEXICO HIGHLANDS UNIVERSITY         ,NM,87701-4436,Public       ,239,622,861,1861,2480,4341
00265400,NEW MEXICO INST OF MINING & TECH        ,NM,87801-4796,Public       ,139,96,235,1415,468,1883
00265500,NEW MEXICO JUNIOR COLLEGE               ,NM,88240-9123,Public       ,264,338,602,810,839,1649
00265600,NEW MEXICO MILITARY INSTITUTE           ,NM,88201-5173,Public       ,86,7,93,426,44,470
00265700,NEW MEXICO STATE UNIVERSITY             ,NM,88003-8001,Public       ,1422,1712,3134,11003,7163,18166
00265701,NEW MEXICO STATE UNIV-ALAMOGORDO        ,NM,88311-0000,Public       ,128,317,445,439,928,1367
00265702,NEW MEXICO STATE UNIV.-DONA ANA CLG     ,NM,88003-0000,Public       ,682,1113,1795,3100,3795,6895
00265703,NEW MEXICO STATE UNIV-CARLSBAD          ,NM,88220-0000,Public       ,100,171,271,301,488,789
00265704,NEW MEXICO STATE UNIV-GRANTS            ,NM,87020-0000,Public       ,74,174,248,190,409,599
00266000,SAN JUAN COLLEGE                        ,NM,87402-4699,Public       ,466,1129,1595,1928,4241,6169
00266300,THE UNIVERSITY OF NEW MEXICO            ,NM,87131-0001,Public       ,1832,3145,4977,18596,16988,35584
00266400,WESTERN NEW MEXICO UNIVERSITY           ,NM,88061-5417,Public       ,207,613,820,1359,2215,3574
00405701,NATIONAL AMERICAN UNIVERSITY            ,NM,87110-0000,Proprietary  ,7,130,137,65,508,573
00474200,CENTRAL NEW MEXICO COMMUNITY COLLEGE    ,NM,87106-4096,Public       ,1857,3742,5599,8329,12915,21244
00474300,CLOVIS COMMUNITY COLLEGE                ,NM,88101-8381,Public       ,228,583,811,681,1448,2129
00996200,LUNA COMMUNITY COLLEGE                  ,NM,87701-0000,Public       ,140,213,353,411,456,867
01063200,DEWOLFF CLG HAIRSTYLING/COSMETOLOGY     ,NM,87112-4113,Proprietary  ,7,39,46,48,121,169
01300500,OLYMPIAN UNIVERSITY OF COSMETOLOGY      ,NM,88310-5051,Proprietary  ,113,293,406,339,1013,1352
02083900,NORTHERN NEW MEXICO COLLEGE             ,NM,87530-0000,Public       ,98,179,277,441,604,1045
02146400,INSTITUTE OF AMERICAN INDIAN ARTS       ,NM,87508-0000,Public       ,48,94,142,184,315,499
02218808,BROOKLINE COLLEGE - ALBUQUERQUE         ,NM,87105-1649,Proprietary  ,36,169,205,175,577,752
02278100,SANTA FE COMMUNITY COLLEGE              ,NM,87507-0000,Public       ,247,609,856,1020,2084,3104
02293203,ATI CAREER TRAINING CENTER - ALBUQUERQUE,NM,87109-2016,Proprietary  ,6,50,56,46,149,195
02357600,NAVAJO TECHNICAL COLLEGE                ,NM,87313-0000,Public       ,189,486,675,518,1144,1662
02511000,SOUTHWESTERN INDIAN POLYTECH INST       ,NM,87184-0000,Public       ,106,142,248,274,385,659
02572003,COMPUTER CAREER CENTER - LAS CRUCES CAMP,NM,88011-8220,Proprietary  ,59,173,232,179,469,648
02622000,SOUTHWEST ACUPUNCTURE COLLEGE           ,NM,87505-0000,Proprietary  ,0,45,45,5,170,175
03076100,SOUTHWESTERN COLLEGE                    ,NM,87507-0000,Private      ,1,35,36,17,258,275
03206300,MESALANDS COMMUNITY COLLEGE             ,NM,88401-3352,Public       ,48,70,118,128,168,296
03430300,UNIVERSAL THERAPEUTIC MASSAGE INSTITUTE ,NM,87107-4403,Proprietary  ,12,37,49,43,171,214
03678300,PIMA MEDICAL INSTITUTE                  ,NM,87110-0000,Proprietary  ,56,172,228,329,652,981
03944300,MASSAGE THERAPY TRAINING INSTITUTE      ,NM,88007-0000,Proprietary  ,11,37,48,51,110,161
04162400,TONI AND GUY HAIRDRESSING  ACADEMY      ,NM,87110-4404,Proprietary  ,31,68,99,126,213,339
04174500,AVEDA INSTITUTE OF NEW MEXICO (THE)     ,NM,87110-3640,Proprietary  ,41,92,133,152,269,421
04178500,VOGUE COLLEGE OF COSMETOLOGY            ,NM,87505-7636,Proprietary  ,14,35,49,57,108,165
00223400,ADRIAN COLLEGE                          ,MI,49221-2575,Private      ,128,62,190,2976,362,3338
00223500,ALBION COLLEGE                          ,MI,49224-1831,Private      ,91,30,121,2431,158,2589
00223600,ALMA COLLEGE                            ,MI,48801-1599,Private      ,67,28,95,2427,150,2577
00223700,ALPENA COMMUNITY COLLEGE                ,MI,49707-1495,Public       ,125,236,361,943,766,1709
00223800,ANDREWS UNIVERSITY                      ,MI,49104-0750,Private      ,216,336,552,1683,1193,2876
00223900,AQUINAS COLLEGE                         ,MI,49506-1799,Private      ,126,153,279,2627,592,3219
00224000,BAY DE NOC COMMUNITY COLLEGE            ,MI,49829-2524,Public       ,158,389,547,981,1044,2025
00224100,CALVIN COLLEGE                          ,MI,49546-4388,Private      ,120,116,236,4659,578,5237
00224200,CALVIN THEOLOGICAL SEMINARY             ,MI,49546-4387,Private      ,1,12,13,14,155,169
00224300,CENTRAL MICHIGAN UNIVERSITY             ,MI,48859-0001,Public       ,1489,1962,3451,23029,9891,32920
00224600,CLEARY UNIVERSITY                       ,MI,48105-0000,Private      ,48,126,174,315,483,798
00224800,CRANBROOK ACADEMY OF ART                ,MI,48303-0000,Private      ,5,19,24,37,242,279
00224900,DAVENPORT UNIVERSITY                    ,MI,49503-0000,Private      ,426,2149,2575,4077,8884,12961
00225100,DELTA COLLEGE                           ,MI,48710-0001,Public       ,714,1478,2192,5536,6066,11602
00225400,MICHIGAN STATE UNIVERSITY COLLEGE OF LAW,MI,48824-1300,Private      ,27,141,168,307,1726,2033
00225900,EASTERN MICHIGAN UNIVERSITY             ,MI,48197-2214,Public       ,1640,2707,4347,19017,12348,31365
00226000,FERRIS STATE UNIVERSITY                 ,MI,49307-2251,Public       ,868,1146,2014,14924,7186,22110
00226100,CHARLES STEWART MOTT COMMUNITY CLG      ,MI,48503-2089,Public       ,1328,2350,3678,5329,7454,12783
00226200,KETTERING UNIVERSITY                    ,MI,48504-4898,Private      ,148,120,268,2579,496,3075
00226300,GLEN OAKS COMMUNITY COLLEGE             ,MI,49032-9784,Public       ,67,148,215,580,592,1172
00226400,GOGEBIC COMMUNITY COLLEGE               ,MI,49938-1365,Public       ,114,134,248,623,427,1050
00226500,GRACE BIBLE COLLEGE                     ,MI,49509-1998,Private      ,45,286,331,521,847,1368
00226600,CORNERSTONE UNIVERSITY                  ,MI,49525-5897,Private      ,82,356,438,2219,1602,3821
00226700,GRAND RAPIDS COMMUNITY COLLEGE          ,MI,49503-3295,Public       ,1485,2295,3780,10261,8573,18834
00226800,GRAND VALLEY STATE UNIVERSITY           ,MI,49401-9403,Public       ,1301,1198,2499,26732,7998,34730
00226900,GREAT LAKES CHRISTIAN COLLEGE           ,MI,48917-1299,Private      ,37,38,75,181,146,327
00227000,HENRY FORD COMMUNITY COLLEGE            ,MI,48128-1495,Public       ,2156,3255,5411,9814,12159,21973
00227300,HOPE COLLEGE                            ,MI,49423-3607,Private      ,104,29,133,4789,199,4988
00227400,JACKSON COMMUNITY COLLEGE               ,MI,49201-8399,Public       ,751,1124,1875,3692,3736,7428
00227500,KALAMAZOO COLLEGE                       ,MI,49006-3295,Private      ,72,57,129,2254,274,2528
00227600,KELLOGG COMMUNITY COLLEGE               ,MI,49017-3397,Public       ,389,1125,1514,2500,4047,6547
00227700,LAKE MICHIGAN COLLEGE                   ,MI,49022-1899,Public       ,376,679,1055,2028,2318,4346
00227800,LANSING COMMUNITY COLLEGE               ,MI,48933-1293,Public       ,1682,2457,4139,8820,8513,17333
00227900,LAWRENCE TECHNOLOGICAL UNIVERSITY       ,MI,48075-1058,Private      ,160,272,432,2335,1136,3471
00228200,MADONNA UNIVERSITY                      ,MI,48150-1173,Private      ,238,566,804,1785,2662,4447
00228400,MARYGROVE COLLEGE                       ,MI,48221-2599,Private      ,176,660,836,1215,2382,3597
00228800,ROCHESTER COLLEGE                       ,MI,48307-2764,Private      ,156,205,361,911,758,1669
00229000,MICHIGAN STATE UNIVERSITY               ,MI,48824-1113,Public       ,2514,1902,4416,40542,13539,54081
00229200,MICHIGAN TECHNOLOGICAL UNIV             ,MI,49931-1295,Public       ,369,170,539,6610,886,7496
00229300,LAKE SUPERIOR STATE UNIVERSITY          ,MI,49783-1691,Public       ,106,164,270,2531,817,3348
00229400,MONROE COUNTY COMMUNITY CLG             ,MI,48161-9746,Public       ,318,524,842,1588,1720,3308
00229500,MONTCALM COMMUNITY COLLEGE              ,MI,48885-9723,Public       ,152,326,478,909,1177,2086
00229700,MUSKEGON COMMUNITY COLLEGE              ,MI,49442-1432,Public       ,444,714,1158,2991,2561,5552
00229900,NORTH CENTRAL MICHIGAN COLLEGE          ,MI,49770-8740,Public       ,170,367,537,1147,1128,2275
00230100,NORTHERN MICHIGAN UNIVERSITY            ,MI,49855-5316,Public       ,570,454,1024,7651,2275,9926
00230200,NORTHWESTERN MICHIGAN COLLEGE           ,MI,49686-3061,Public       ,371,571,942,2491,2264,4755
00230301,OAKLAND COMMUNITY COLLEGE - ORCHARD RIDG,MI,48334-4579,Public       ,761,1330,2091,3423,4681,8104
00230302,OAKLAND COMMUNITY COLLEGE - ROYAL OAK CA,MI,48067-3898,Public       ,1039,1908,2947,4455,6581,11036
00230303,OAKLAND COMMUNITY COLLEGE - SOUTHFIELD C,MI,48075-4793,Public       ,790,2100,2890,3393,7246,10639
00230304,OAKLAND COMMUNITY COLLEGE - AUBURN HILLS,MI,48323-2845,Public       ,952,1467,2419,4869,5308,10177
00230305,OAKLAND COMMUNITY COLLEGE - HIGHLAND LAK,MI,48327-4187,Public       ,534,847,1381,2450,3164,5614
00230700,OAKLAND UNIVERSITY                      ,MI,48309-4401,Public       ,1509,1755,3264,17541,9394,26935
00230800,OLIVET COLLEGE                          ,MI,49076-9902,Private      ,65,36,101,1619,220,1839
00231000,ST. CLAIR COUNTY COMMUNITY COLLEGE      ,MI,48061-0000,Public       ,331,521,852,1922,1812,3734
00231100,KUYPER COLLEGE                          ,MI,49525-9749,Private      ,18,31,49,343,149,492
00231300,SACRED HEART MAJOR SEMINARY             ,MI,48206-1799,Private      ,3,50,53,35,177,212
00231400,SAGINAW VALLEY STATE UNIV               ,MI,48710-0001,Public       ,554,652,1206,10025,3745,13770
00231500,SCHOOLCRAFT COLLEGE                     ,MI,48152-2696,Public       ,1356,2440,3796,6829,8522,15351
00231600,SIENA HEIGHTS UNIVERSITY                ,MI,49221-1796,Private      ,150,424,574,1856,2168,4024
00231700,SOUTHWESTERN MICHIGAN COLLEGE           ,MI,49047-9793,Public       ,261,358,619,2168,1396,3564
00231800,SPRING ARBOR UNIVERSITY                 ,MI,49283-9984,Private      ,123,737,860,1938,2747,4685
00232200,FINLANDIA UNIVERSITY                    ,MI,49930-1882,Private      ,49,43,92,759,240,999
00232300,UNIVERSITY OF DETROIT MERCY             ,MI,48221-3038,Private      ,256,698,954,3633,3358,6991
00232303,UNIV OF DETROIT MERCY - LAW SCHOOL      ,MI,48226-0000,Private      ,12,93,105,58,577,635
00232330,UNIV OF DETROIT MERCY - DENTAL SCHOOL   ,MI,48208-2576,Private      ,30,100,130,199,664,863
00232500,UNIVERSITY OF MICHIGAN - ANN ARBOR      ,MI,48109-1316,Public       ,1051,1118,2169,37038,11414,48452
00232501,UNIVERSITY OF MICHIGAN-MEDICAL SCH      ,MI,48109-0000,Public       ,35,41,76,315,992,1307
00232503,UNIVERSITY OF MICHIGAN LAW SCHOOL       ,MI,48109-0000,Public       ,4,157,161,76,2099,2175
00232600,UNIVERSITY OF MICHIGAN-DEARBORN         ,MI,48128-2406,Public       ,678,1134,1812,7540,5360,12900
00232700,UNIVERSITY OF MICHIGAN-FLINT            ,MI,48502-1950,Public       ,542,1293,1835,5423,6326,11749
00232800,WASHTENAW COMMUNITY COLLEGE             ,MI,48106-0000,Public       ,1216,2108,3324,5028,6625,11653
00232900,WAYNE STATE UNIVERSITY                  ,MI,48202-0000,Public       ,2020,3860,5880,18939,19099,38038
00232901,WAYNE STATE UNIV SCH OF MEDICINE        ,MI,48201-3359,Public       ,116,182,298,754,1947,2701
00232902,WAYNE STATE UNIVERSITY - LAW SCHOOL     ,MI,48202-3424,Public       ,26,164,190,175,944,1119
00233000,WESTERN MICHIGAN UNIVERSITY             ,MI,49008-3899,Public       ,1720,1728,3448,21804,9648,31452
00233100,WESTERN THEOLOGICAL SEMINARY            ,MI,49423-0000,Private      ,0,31,31,3,168,171
00384256,CONCORDIA UNIVERSITY - WISCONSIN - ANN A,MI,48105-2750,Private      ,72,75,147,1036,344,1380
00407100,WALSH COLLEGE OF ACCT & BUS ADMN        ,MI,48007-7006,Private      ,70,683,753,365,1995,2360
00407200,NORTHWOOD UNIVERSITY                    ,MI,48640-2398,Private      ,158,475,633,2259,1894,4153
00467300,BAKER COLLEGE - FLINT                   ,MI,48507-5508,Private      ,468,1279,1747,2295,5036,7331
00467301,BAKER COLLEGE OF CADILLAC               ,MI,49601-0000,Private      ,76,359,435,562,1282,1844
00467302,BAKER COLLEGE OF CLINTON TOWNSHIP       ,MI,48035-0000,Private      ,279,933,1212,1284,3294,4578
00467303,BAKER COLLEGE OF MUSKEGON               ,MI,49442-0000,Private      ,246,689,935,1889,2547,4436
00467304,BAKER COLLEGE OF OWOSSO                 ,MI,48867-0000,Private      ,191,388,579,1256,1511,2767
00467305,BAKER COLLEGE OF AUBURN HILLS           ,MI,48326-0000,Private      ,191,604,795,937,2487,3424
00467306,BAKER COLLEGE OF PORT HURON             ,MI,48060-0000,Private      ,53,148,201,377,576,953
00467309,BAKER COLLEGE OF JACKSON                ,MI,49202-0000,Private      ,157,552,709,792,1927,2719
00467311,BAKER COLLEGE-CASS CITY                 ,MI,48726-0000,Private      ,21,60,81,127,222,349
00467313,BAKER COLLEGE - GRADUATE ON-LINE        ,MI,48507-0000,Private      ,112,1056,1168,396,4444,4840
00467317,BAKER COLLEGE-ALLEN PARK                ,MI,48101-0000,Private      ,273,1086,1359,1153,3642,4795
00467330,BAKER COLLEGE - CULINARY INSTITUTE OF MI,MI,49440-1246,Private      ,37,64,101,480,225,705
00467343,BAKER COLLEGE - CULINARY INSTITUTE OF MI,MI,48060-0000,Private      ,13,30,43,185,109,294
00467348,BAKER COLLEGE - AUTO DIESEL INSTITUTE OF,MI,48867-0000,Private      ,46,41,87,386,175,561
00469200,DORSEY SCHOOL OF BUSINESS               ,MI,48195-2334,Proprietary  ,25,92,117,73,256,329
00469201,DORSEY SCHOOL OF BUSINESS               ,MI,48184-0000,Proprietary  ,22,102,124,60,277,337
00469202,DORSEY SCHOOL OF BUSINESS               ,MI,48071-0000,Proprietary  ,50,156,206,142,474,616
00469204,DORSEY SCHOOL OF BUSINESS               ,MI,48066-0000,Proprietary  ,68,211,279,213,636,849
00469205,DORSEY BUSINESS SCHOOL - FARMINGTON HILL,MI,48334-3385,Proprietary  ,17,62,79,46,175,221
00469206,DORSEY BUSINESS SCHOOL - ROSEVILLE CULIN,MI,48066-4555,Proprietary  ,27,135,162,110,346,456
00469207,DORSEY BUSINESS SCHOOL - WATERFORD/PONTI,MI,48341-1037,Proprietary  ,34,105,139,94,328,422
00469208,DORSEY BUSINESS SCHOOL - SAGINAW CAMPUS ,MI,48603-5201,Proprietary  ,30,168,198,91,417,508
00469209,DORSEY SCHOOL OF BUSINESS - LANSING     ,MI,48911-5744,Proprietary  ,20,111,131,64,276,340
00469210,DORSEY SCHOOL OF BUSINESS - DEARBORN    ,MI,48228-3858,Proprietary  ,82,275,357,230,676,906
00676800,MID MICHIGAN COMMUNITY COLLEGE          ,MI,48625-9447,Public       ,438,627,1065,2260,2126,4386
00677100,COLLEGE FOR CREATIVE STUDIES            ,MI,48202-4034,Private      ,175,220,395,1913,863,2776
00694900,KALAMAZOO VALLEY COMMUNITY COLLEGE      ,MI,49003-4070,Public       ,1003,1655,2658,5116,5268,10384
00717100,KIRTLAND COMMUNITY COLLEGE              ,MI,48653-0000,Public       ,153,328,481,790,1293,2083
00732991,ITT TECHNICAL INSTITUTE                 ,MI,49519-1851,Proprietary  ,86,554,640,408,2035,2443
00761700,CARNEGIE INSTITUTE                      ,MI,48083-1159,Proprietary  ,18,62,80,63,306,369
00795000,WEST SHORE COMMUNITY COLLEGE            ,MI,49454-0000,Public       ,99,167,266,593,659,1252
00817800,EMPIRE BEAUTY SCHOOL                    ,MI,49525-2440,Proprietary  ,160,337,497,609,1301,1910
00890600,MACOMB COMMUNITY COLLEGE                ,MI,48088-3896,Public       ,2945,4056,7001,12433,12893,25326
00894600,PORT HURON COSMETOLOGY COLLEGE          ,MI,48329-1618,Proprietary  ,11,16,27,20,46,66
00923000,WAYNE COUNTY COMMUNITY CLG-DISTRICT     ,MI,48226-3010,Public       ,1897,6512,8409,7099,19200,26299
00982800,EVEREST INSTITUTE                       ,MI,48033-4400,Private      ,59,297,356,164,894,1058
00982801,EVEREST INSTITUTE- DEARBORN             ,MI,48124-1927,Private      ,47,197,244,161,613,774
00982803,EVEREST INSTITUTE - DETROIT             ,MI,48207-4291,Private      ,63,260,323,208,711,919
01047000,KALAMAZOO BEAUTY ACADEMY                ,MI,49002-5220,Proprietary  ,8,24,32,26,60,86
01082700,DAVID PRESSLEY PROF SCH OF COSMTLGY     ,MI,48067-3219,Proprietary  ,38,66,104,127,253,380
01109800,FLINT INSTITUTE OF BARBERING            ,MI,48504-4395,Proprietary  ,16,46,62,44,146,190
01229100,WRIGHT BEAUTY ACADEMY                   ,MI,49015-2696,Proprietary  ,15,28,43,35,88,123
01262700,THOMAS M. COOLEY LAW SCHOOL             ,MI,48901-1586,Private      ,1,600,601,19,1823,1842
01321800,M J MURPHY BTY CLG MT PLEASANT          ,MI,48858-2502,Proprietary  ,10,24,34,43,64,107
02060300,MICHIGAN INSTITUTE OF AERONAUTICS       ,MI,48188-2533,Proprietary  ,104,147,251,396,435,831
02099700,ROSS MEDICAL EDUCATION CENTER           ,MI,48532-0000,Proprietary  ,142,409,551,373,1089,1462
02099701,ROSS MEDICAL EDUCATION CENTER-SAGINAW   ,MI,48603-5227,Proprietary  ,5,35,40,45,144,189
02099702,ROSS MEDICAL EDUCATION CENTER-PORT HURON,MI,48060-1958,Proprietary  ,8,15,23,38,46,84
02099703,ROSS MEDICAL EDUCATION CENTER-ROOSEVELT ,MI,49441-4156,Proprietary  ,1,9,10,7,35,42
02100400,EVEREST INSTITUTE                       ,MI,49525-2301,Proprietary  ,8,49,57,48,178,226
02100401,EVEREST INSTITUTE - KALAMAZOO           ,MI,49009-3307,Proprietary  ,6,35,41,31,117,148
02125600,MICHIGAN COLLEGE OF BEAUTY              ,MI,48083-0000,Proprietary  ,44,90,134,139,255,394
02158600,MR BELA'S SCHOOL OF COSMETOLOGY         ,MI,48092-4637,Proprietary  ,16,35,51,35,103,138
02160303,INTERNATIONAL ACADEMY OF DESIGN AND TECH,MI,48083-2160,Proprietary  ,6,20,26,74,149,223
02180100,ROSS MEDICAL EDUCATION CENTER           ,MI,48092-0000,Proprietary  ,78,263,341,221,697,918
02180105,ROSS MEDICAL EDUCATION CENTER-REDFORD   ,MI,48239-1260,Proprietary  ,4,32,36,17,95,112
02198900,MICHIGAN SCHOOL OF PROFESSIONAL PSYCHOLO,MI,48334-4512,Private      ,3,68,71,18,223,241
02209200,TAYLORTOWN SCHOOL OF BEAUTY             ,MI,48180-0000,Proprietary  ,24,79,103,85,217,302
02237800,SPECS HOWARD SCHOOL OF MEDIA ARTS       ,MI,48075-0000,Proprietary  ,121,184,305,532,656,1188
02285700,BAYSHIRE BEAUTY ACADEMY                 ,MI,48708-5614,Proprietary  ,12,55,67,49,124,173
02324500,MICHIGAN COLLEGE OF BEAUTY              ,MI,48161-3901,Proprietary  ,26,39,65,76,121,197
02339700,ROSS MEDICAL EDUCATION CENTER           ,MI,48116-0000,Proprietary  ,80,305,385,224,915,1139
02339701,ROSS MEDICAL EDUCATION CENTER-ANN ARBOR ,MI,48108-1411,Proprietary  ,7,36,43,37,106,143
02339703,ROSS MEDICAL EDUCATION CENTER - DAVISON ,MI,48423-1751,Proprietary  ,4,12,16,23,51,74
02361500,MICHIGAN BARBER COLLEGE                 ,MI,48204-2244,Private      ,20,120,140,85,374,459
02363800,YESHIVA GEDOLAH OF GREATER DETROIT      ,MI,48237-0000,Private      ,11,1,12,15,3,18
02491000,WEST MI COLG OF BARBERING & BEAUTY      ,MI,49008-0000,Proprietary  ,12,39,51,38,109,147
02531806,PAUL MITCHELL THE SCHOOL -MICHIGAN      ,MI,48313-0000,Proprietary  ,47,99,146,198,288,486
02533600,ROSS MEDICAL EDUCATION CENTER           ,MI,48917-2108,Proprietary  ,90,217,307,228,663,891
02533601,ROSS MEDICAL EDUCATION CENTER - GRAND RA,MI,49546-2430,Proprietary  ,9,60,69,67,194,261
02588200,DOUGLAS J AVEDA INSTITUTE               ,MI,48823-4351,Proprietary  ,115,145,260,630,592,1222
02588201,DOUGLAS J AVEDA INSTITUTE - ANN ARBOR   ,MI,48104-2211,Proprietary  ,0,0,0,105,105,210
02595700,HILLSDALE BEAUTY COLLEGE                ,MI,49242-0000,Proprietary  ,7,12,19,55,39,94
02618400,MICHIGAN CAREER & TECHNICAL INST        ,MI,49080-9254,Public       ,86,37,123,298,109,407
03005700,DETROIT BUSINESS INST. DOWNRIVER        ,MI,48193-6761,Proprietary  ,3,55,58,24,171,195
03066600,BAY MILLS COMMUNITY COLLEGE             ,MI,49715-9750,Public       ,42,137,179,197,393,590
03075200,TWIN CITY BEAUTY COLLEGE                ,MI,49085-3305,Proprietary  ,23,49,72,85,134,219
03075201,TWIN CITY BEAUTY COLLEGE - TRAVERSE CITY,MI,49686-5119,Proprietary  ,6,11,17,26,43,69
03090000,SHARP'S ACADEMY OF HAIRSTYLING          ,MI,48439-1838,Proprietary  ,2,11,13,26,42,68
03109700,HOUGHTON LAKE INST OF COSMETOLOGY       ,MI,48629-0669,Proprietary  ,7,13,20,22,49,71
03110300,THE SCHOOL OF CREATIVE HAIR DESIGN      ,MI,49036-1139,Proprietary  ,14,24,38,28,56,84
03124000,NORTHWESTERN TECHNOLOGICAL INST         ,MI,48075-2412,Proprietary  ,28,123,151,78,321,399
03284300,MICHIGAN JEWISH INSTITUTE               ,MI,48237-0000,Private      ,652,913,1565,1140,1455,2595
03490300,PAUL MITCHELL THE SCHOOL ESCANABA       ,MI,49829-0000,Proprietary  ,4,13,17,42,44,86
03588300,IRENE'S MYOMASSOLOGY INSTITUTE          ,MI,48033-2404,Proprietary  ,10,89,99,52,244,296
03704300,BLUE WATER COLLEGE OF COSMETOLOGY       ,MI,48040-2093,Proprietary  ,2,16,18,12,27,39
03772300,SAGINAW CHIPPEWA TRIBAL COLLEGE         ,MI,48858-0000,Public       ,16,56,72,41,98,139
03815300,IN SESSION-ARTS OF COSMETOLOGY BEAU     ,MI,48609-0000,Proprietary  ,14,34,48,43,116,159
03907300,PAUL MITCHELL THE SCHOOL GREAT LAKES    ,MI,48060-0000,Proprietary  ,21,31,52,76,72,148
03915300,CAREER QUEST LEARNING CENTER            ,MI,48910-4732,Proprietary  ,28,165,193,101,564,665
03915301,CAREER QUEST LEARNING CENTER - JACKSON  ,MI,49201-2475,Proprietary  ,25,89,114,76,345,421
03915302,CAREER QUEST LEARNING CENTER - KALAMAZOO,MI,49002-1711,Proprietary  ,0,0,0,6,26,32
03968300,LAKEWOOD SCHOOL OF THERAPEUTIC MASSAGE  ,MI,48060-0000,Proprietary  ,6,13,19,16,52,68
03976500,ANN ARBOR INSTITUTE OF MASSAGE THERAPY  ,MI,48103-0000,Proprietary  ,10,35,45,43,95,138
04002400,ECUMENICAL THEOLOGICAL SEMINARY         ,MI,48201-3035,Private      ,2,47,49,8,117,125
04006300,NUVO COLLEGE OF COSMETOLOGY             ,MI,49441-3822,Proprietary  ,8,16,24,31,66,97
04014300,P&A SCHOLARS BEAUTY SCHOOL              ,MI,48204-0000,Proprietary  ,59,178,237,173,523,696
04094300,ROBERT B. MILLER COLLEGE (THE)          ,MI,49017-3306,Private      ,12,85,97,101,366,467
04121100,GALLERY COLLEGE OF BEAUTY (THE)         ,MI,48036-3591,Proprietary  ,12,53,65,33,132,165
04136300,FOCUS:  HOPE INFORMATION TECHNOLOGIES CE,MI,48238-2949,Private      ,20,108,128,110,365,475
04138400,SCHOOL OF DESIGNING ARTS                ,MI,49015-2853,Proprietary  ,12,31,43,58,97,155
04140900,INTERNATIONAL COSMETOLOGY ACADEMY       ,MI,49508-1308,Proprietary  ,16,27,43,51,84,135
04141100,FRENCH ACADEMY OF COSMETOLOGY           ,MI,49456-3207,Proprietary  ,11,18,29,29,51,80
04158400,L'ESPRIT ACADEMY                        ,MI,48150-0000,Proprietary  ,38,47,85,96,120,216
04159300,MARKETTI ACADEMY OF COSMETOLOGY         ,MI,48329-3506,Proprietary  ,22,17,39,57,64,121
04163300,COMPASS COLLEGE OF CINEMATIC ARTS       ,MI,49503-4227,Private      ,9,24,33,164,81,245
04164700,KEWEENAW BAY OJIBWA COMMUNITY COLLEGE   ,MI,49908-0000,Public       ,5,24,29,16,54,70
04183300,ABCOTT INSTITUTE                        ,MI,48075-5227,Proprietary  ,14,87,101,36,160,196
04184700,PROTEGE ACADEMY                         ,MI,48823-8660,Proprietary  ,10,29,39,53,122,175
04207000,SCHOOL OF MISSIONARY AVIATION TECHNOLOGY,MI,48846-7412,Private      ,1,4,5,17,30,47
04211200,BRIGHTON INSTITUTE OF COSMETOLOGY       ,MI,48116-8360,Proprietary  ,8,15,23,27,38,65
04222300,MANTHANO CHRISTIAN COLLEGE              ,MI,48185-1919,Private      ,0,15,15,5,45,50
04230200,EXCEL ACADEMIES OF COSMETOLOGY          ,MI,48085-1300,Proprietary  ,7,13,20,36,42,78
04230400,EXCEL ACADEMIES OF COSMETOLOGY          ,MI,48912-4686,Proprietary  ,3,18,21,34,64,98
04230500,EXCEL ACADEMIES OF COSMETOLOGY          ,MI,49512-1781,Proprietary  ,9,12,21,45,30,75
04231800,PRINCESS BEAUTY SCHOOL                  ,MI,48127-2999,Proprietary  ,10,38,48,58,105,163
00233200,ANOKA-RAMSEY CC-CAMBRIDGE/COONRAPID     ,MN,55433-3499,Public       ,1306,1442,2748,3545,3736,7281
00233400,AUGSBURG COLLEGE                        ,MN,55454-1351,Private      ,172,413,585,3084,2127,5211
00233500,RIVERLAND COMMUNITY COLLEGE             ,MN,55912-1473,Public       ,304,539,843,876,1291,2167
00233600,BEMIDJI STATE UNIVERSITY                ,MN,56601-2699,Public       ,463,596,1059,3671,2081,5752
00233700,BETHANY LUTHERAN COLLEGE INC            ,MN,56001-6163,Private      ,50,17,67,591,66,657
00233900,CENTRAL LAKES COLG-BRAINERD/STAPLES     ,MN,56401-3900,Public       ,359,574,933,1106,1438,2544
00234000,CARLETON COLLEGE                        ,MN,55057-4001,Private      ,39,12,51,3405,85,3490
00234100,COLLEGE OF ST BENEDICT                  ,MN,56374-2099,Private      ,136,15,151,2139,68,2207
00234200,ST. CATHERINE UNIVERSITY                ,MN,55105-1789,Private      ,204,759,963,2725,3094,5819
00234300,COLLEGE OF ST SCHOLASTICA               ,MN,55811-4199,Private      ,298,815,1113,2435,2391,4826
00234500,UNIVERSITY OF ST THOMAS                 ,MN,55105-1096,Private      ,385,862,1247,6524,3051,9575
00234600,CONCORDIA COLLEGE-MOORHEAD              ,MN,56562-0001,Private      ,164,43,207,2445,188,2633
00234700,"CONCORDIA UNIVERSITY, ST PAUL, MN       ",MN,55104-5494,Private      ,265,1275,1540,1775,3450,5225
00235000,VERMILION COMMUNITY COLLEGE             ,MN,55731-1996,Public       ,79,35,114,428,131,559
00235300,GUSTAVUS ADOLPHUS COLLEGE               ,MN,56082-1498,Private      ,274,29,303,3212,104,3316
00235400,HAMLINE UNIVERSITY                      ,MN,55104-1284,Private      ,350,696,1046,3566,2125,5691
00235500,HIBBING COMMUNITY COLLEGE               ,MN,55746-3300,Public       ,222,371,593,532,847,1379
00235600,ITASCA COMMUNITY COLLEGE                ,MN,55744-3397,Public       ,176,192,368,712,498,1210
00235700,LUTHER SEMINARY                         ,MN,55108-0000,Private      ,0,46,46,4,299,303
00235800,MACALESTER COLLEGE                      ,MN,55105-1899,Private      ,50,33,83,3545,152,3697
00236000,"MINNESOTA STATE UNIVERSITY, MANKATO     ",MN,56002-0000,Public       ,1718,1083,2801,11753,3928,15681
00236100,MARTIN LUTHER COLLEGE                   ,MN,56073-3965,Private      ,24,17,41,687,58,745
00236200,MINNEAPOLIS COMM AND TECH COLLEGE       ,MN,55403-1779,Public       ,1111,2912,4023,3605,7714,11319
00236500,MINNEAPOLIS COLLEGE OF ART & DESIGN     ,MN,55404-4343,Private      ,62,73,135,941,487,1428
00236600,CROSSROADS COLLEGE                      ,MN,55902-2382,Private      ,33,26,59,88,67,155
00236700,MINNESOTA STATE UNIVERSITY MOORHEAD     ,MN,56563-0001,Public       ,769,659,1428,4200,2132,6332
00236900,NORTH CENTRAL UNIVERSITY                ,MN,55404-1391,Private      ,135,113,248,1133,419,1552
00237000,NORTH HENNEPIN COMMUNITY COLLEGE        ,MN,55445-2299,Public       ,1058,1789,2847,2902,4844,7746
00237100,UNIVERSITY OF NORTHWESTERN- ST PAUL     ,MN,55113-1598,Private      ,239,294,533,2141,739,2880
00237300,ROCHESTER COMMUNITY/TECH COLLEGE        ,MN,55904-4999,Public       ,767,1105,1872,2457,2977,5434
00237500,SOUTHWEST MINNESOTA STATE UNIVERSITY    ,MN,56258-1598,Public       ,234,340,574,2006,998,3004
00237700,ST CLOUD STATE UNIVERSITY               ,MN,56301-4498,Public       ,1718,1528,3246,9286,4576,13862
00237900,SAINT JOHNS UNIVERSITY                  ,MN,56321-2000,Private      ,164,28,192,1882,94,1976
00238000,SAINT MARY'S UNIVERSITY                 ,MN,55987-1399,Private      ,88,1190,1278,1629,3238,4867
00238200,ST OLAF COLLEGE                         ,MN,55057-1098,Private      ,77,20,97,4033,140,4173
00238300,CROWN COLLEGE                           ,MN,55375-9001,Private      ,94,275,369,779,616,1395
00238500,NORTHLAND COMMUNITY & TECHNICAL CLG     ,MN,56701-2598,Public       ,408,623,1031,1204,1455,2659
00238600,UNITED THEOLGCL SEMINRY TWIN CITIES     ,MN,55112-0000,Private      ,0,33,33,2,83,85
00238800,"UNIVERSITY OF MINNESOTA, DULUTH         ",MN,55812-2496,Public       ,1431,562,1993,9694,2069,11763
00238900,"UNIVERSITY OF MINNESOTA, MORRIS         ",MN,56267-2113,Public       ,207,71,278,2257,283,2540
00239100,WILLIAM MITCHELL COLLEGE OF LAW         ,MN,55105-0000,Private      ,0,171,171,3,948,951
00239300,MINNESOTA STATE COLLEGE-SE TECH         ,MN,55987-0409,Public       ,227,435,662,673,1110,1783
00239400,WINONA STATE UNIVERSITY                 ,MN,55987-5838,Public       ,1124,570,1694,7139,1654,8793
00396900,UNIVERSITY OF MINNESOTA-TWIN CITIES     ,MN,55455-0422,Public       ,3081,3190,6271,33907,14757,48664
00400900,MESABI RANGE CMNTY & TECH COLLEGE       ,MN,55792-0000,Public       ,190,232,422,470,506,976
00405708,NATIONAL AMERICAN UNIVERSITY            ,MN,55113-0000,Proprietary  ,7,56,63,22,262,284
00405715,NATIONAL AMERICAN UNIVERSITY - BLOOMINGT,MN,55425-5550,Proprietary  ,13,73,86,30,345,375
00406900,UNIVERSITY OF MINNESOTA-CROOKSTON       ,MN,56716-5001,Public       ,152,343,495,1009,972,1981
00438600,VETERAN'S MEDICAL CTR- SCH RAD TECH     ,MN,55417-2399,Public       ,1,4,5,7,17,24
00464100,DUNWOODY COLLEGE OF TECHNOLOGY          ,MN,55403-1192,Private      ,171,323,494,689,1037,1726
00464200,GLOBE UNIVERSITY                        ,MN,55125-5408,Proprietary  ,138,454,592,709,1996,2705
00464500,MINNEAPOLIS BUSINESS COLLEGE            ,MN,55113-4036,Proprietary  ,37,37,74,221,160,381
00464600,MINNESOTA SCHOOL OF BUSINESS            ,MN,55423-0000,Proprietary  ,135,408,543,551,1645,2196
00525200,RIDGEWATER COLLEGE                      ,MN,56201-2098,Public       ,440,526,966,1749,1529,3278
00526300,MINNESOTA WEST CMNTY & TECH COLG        ,MN,56241-1096,Public       ,218,439,657,735,1122,1857
00553300,"SAINT PAUL COLLEGE, COMMUNITY/TECHNICAL ",MN,55102-1800,Public       ,834,2161,2995,3255,5901,9156
00553400,SAINT CLOUD TECHNICAL COLLEGE AND COMMUN,MN,56303-1240,Public       ,949,917,1866,2775,2394,5169
00553500,PINE TECHNICAL COLLEGE                  ,MN,55063-2198,Public       ,82,274,356,231,617,848
00553700,SOUTH CENTRAL COLLEGE                   ,MN,56003-0000,Public       ,461,589,1050,1485,1628,3113
00554100,MINNESOTA STATE COMMUNITY AND TECHNICAL ,MN,56573-1405,Public       ,736,997,1733,2048,2714,4762
00554400,ALEXANDRIA TECHNICAL COLLEGE            ,MN,56308-3799,Public       ,253,249,502,1127,739,1866
00575700,LAKE SUPERIOR COLLEGE                   ,MN,55811-3399,Public       ,667,909,1576,1790,2302,4092
00575900,NORTHWEST TECHNICAL COLLEGE - BEMIDJI   ,MN,56601-4907,Public       ,73,253,326,300,715,1015
00677500,RAINY RIVER COMMUNITY COLLEGE           ,MN,56649-2187,Public       ,62,40,102,156,111,267
00735000,ANOKA-HENNEPIN TECHNICAL COLLEGE        ,MN,55303-1590,Public       ,297,782,1079,883,1966,2849
00735100,BROWN COLLEGE                           ,MN,55120-1004,Proprietary  ,19,42,61,72,321,393
00795400,NORMANDALE COMMUNITY COLLEGE            ,MN,55431-4399,Public       ,1341,1566,2907,4451,4593,9044
00869400,RASMUSSEN COLLEGE - ST. CLOUD           ,MN,56301-3713,Proprietary  ,51,286,337,208,1153,1361
00869401,RASMUSSEN COLLEGE - BROOKLYN PARK       ,MN,55445-1512,Proprietary  ,41,280,321,127,964,1091
00869406,RASMUSSEN COLLEGE - EAGAN               ,MN,55122-1346,Proprietary  ,49,248,297,139,882,1021
00869407,RASMUSSEN COLLEGE - BLOOMINGTON         ,MN,55435-5444,Proprietary  ,59,305,364,194,1302,1496
00869409,RASMUSSEN COLLEGE - MANKATO             ,MN,56001-8658,Proprietary  ,55,187,242,215,770,985
00869412,RASMUSSEN COLLEGE - LAKE ELMO           ,MN,55042-8624,Proprietary  ,22,161,183,107,641,748
00869416,RASMUSSEN COLLEGE - MOORHEAD            ,MN,56560-4513,Proprietary  ,30,158,188,142,550,692
00869417,RASMUSSEN COLLEGE - BLAINE              ,MN,55014-0000,Proprietary  ,52,272,324,156,1047,1203
00905800,BETHEL UNIVERSITY                       ,MN,55112-6999,Private      ,288,728,1016,2923,1938,4861
00960000,COSMETOLOGY CAREERS UNLTD-DULUTH        ,MN,55802-2031,Proprietary  ,5,13,18,14,39,53
00974000,INVER HILLS COMMUNITY COLLEGE           ,MN,55076-3224,Public       ,686,1043,1729,2173,3060,5233
00983100,MODEL COLLEGE OF HAIR DESIGN            ,MN,56301-4280,Proprietary  ,11,26,37,56,70,126
00989200,"DULUTH BUSINESS UNIV, INC.              ",MN,55807-0000,Proprietary  ,28,77,105,78,241,319
00999200,OAK HILLS CHRISTIAN COLLEGE             ,MN,56601-0000,Private      ,15,20,35,118,71,189
01024800,ART INSTITUTES INTL MINNESOTA           ,MN,55402-3137,Proprietary  ,163,150,313,710,609,1319
01037400,METROPOLITAN STATE UNIVERSITY           ,MN,55106-5000,Public       ,590,2883,3473,2357,8520,10877
01040200,DAKOTA COUNTY TECHNICAL COLLEGE         ,MN,55068-2999,Public       ,395,674,1069,1086,1649,2735
01049000,REGENCY BEAUTY INSTITUTE                ,MN,55428-0000,Proprietary  ,689,1311,2000,2447,4475,6922
01049100,HENNEPIN TECHNICAL COLLEGE              ,MN,55445-2399,Public       ,619,1810,2429,1685,4720,6405
01054600,CENTURY COLLEGE                         ,MN,55110-1894,Public       ,1336,1914,3250,4293,5870,10163
01173200,"MAYO CLINIC, COLLEGE OF MEDICINE        ",MN,55905-0000,Private      ,9,28,37,61,405,466
01173201,MAYO SCHOOL OF HEALTH-RELATED SCIEN     ,MN,55905-0000,Private      ,11,35,46,79,201,280
01173206,MAYO GRAD SCHOOL                        ,MN,55901-0000,Private      ,0,5,5,3,40,43
01173207,MAYO MEDICAL SCHOOL                     ,MN,55901-0000,Private      ,5,10,15,23,157,180
01232800,NORTHWESTERN HEALTH SCIENCES UNIV       ,MN,55431-1599,Private      ,19,387,406,74,808,882
02050300,ACADEMY COLLEGE                         ,MN,55420-1554,Proprietary  ,14,60,74,46,153,199
02097300,HASTINGS BEAUTY SCHOOL                  ,MN,55033-1205,Proprietary  ,4,6,10,11,34,45
02123200,AVEDA INSTITUTE                         ,MN,55414-0000,Proprietary  ,83,85,168,352,367,719
02159800,COSMETOLOGY CAREERS UNLTD - HIBBING     ,MN,55746-0000,Proprietary  ,7,11,18,12,25,37
02160901,PCI ACADEMY - PCI ACADEMY               ,MN,55446-4928,Proprietary  ,13,22,35,38,80,118
02238100,MINNESOTA SCHOOL OF COSMETOLOGY         ,MN,55125-0000,Proprietary  ,43,51,94,131,219,350
02260500,SUMMIT ACAD OPPORTUNITIES IND CTR       ,MN,55405-0000,Private      ,39,247,286,71,496,567
02504200,WALDEN UNIVERSITY                       ,MN,55401-2511,Proprietary  ,64,15013,15077,252,49603,49855
02514100,AMERICAN INDIAN OPPORTUNITIES CTR       ,MN,55404-0000,Private      ,4,39,43,14,94,108
03001200,MCNALLY SMITH COLLEGE OF MUSIC          ,MN,55101-2220,Proprietary  ,78,57,135,483,219,702
03051900,ALFRED ADLER GRADUATE SCHOOL            ,MN,55305-0000,Private      ,1,71,72,2,296,298
03096400,LEECH LAKE TRIBAL COLLEGE               ,MN,56633-0000,Public       ,43,194,237,62,345,407
03129100,FOND DU LAC TRIBAL & COMMUNITY CLG      ,MN,55720-2984,Public       ,152,305,457,411,690,1101
03267300,CAPELLA UNIVERSITY                      ,MN,55402-3389,Proprietary  ,90,10104,10194,356,49041,49397
03833300,AMERICAN ACADEMY OF ACUPUNCTURE AND ORIE,MN,55113-0000,Proprietary  ,1,26,27,3,50,53
03921400,WHITE EARTH TRIBAL AND COMMUNITY COLLEGE,MN,56557-0478,Private      ,9,52,61,15,87,102
04044300,HAZELDEN GRADUATE SCHOOL OF ADDICTION ST,MN,55012-0000,Private      ,0,54,54,1,179,180
04130200,INST. OF PRODUCTION AND RECORDING       ,MN,55401-1315,Proprietary  ,48,73,121,246,230,476
04148800,CENTERPOINT MASSAGE & SHIATSU THERAPY SC,MN,55414-4525,Proprietary  ,9,39,48,19,90,109
04157600,NOVA ACADEMY OF COSMETOLOGY             ,MN,55906-4103,Proprietary  ,16,24,40,31,52,83
04160500,AVALON SCHOOL OF COSMETOLOGY            ,MN,56187-1930,Proprietary  ,3,6,9,18,34,52
04174400,ROCHESTER SCHOOL OF HAIR DESIGN         ,MN,55901-4310,Proprietary  ,3,13,16,15,31,46
04175600,PARK AVENUE SCHOOL OF COSMETOLOGY       ,MN,56470-3361,Proprietary  ,7,32,39,22,70,92
04227800,BETHANY GLOBAL UNIVERSITY               ,MN,55438-2849,Private      ,24,15,39,149,55,204
00239600,ALCORN STATE UNIVERSITY                 ,MS,39096-7500,Public       ,727,1103,1830,4366,3336,7702
00239700,BELHAVEN UNIVERSITY                     ,MS,39202-1789,Private      ,298,1740,2038,2109,5318,7427
00239800,BLUE MOUNTAIN COLLEGE                   ,MS,38610-9370,Private      ,82,107,189,525,310,835
00240100,COAHOMA COMMUNITY COLLEGE               ,MS,38614-9799,Public       ,480,843,1323,1650,1720,3370
00240200,COPIAH-LINCOLN COMMUNITY COLLEGE        ,MS,39191-0649,Public       ,575,642,1217,2079,1756,3835
00240300,DELTA STATE UNIVERSITY                  ,MS,38733-0000,Public       ,573,816,1389,3485,2645,6130
00240400,EAST CENTRAL COMMUNITY COLLEGE          ,MS,39327-0129,Public       ,413,483,896,1928,1439,3367
00240500,EAST MISSISSIPPI COMM COLLEGE           ,MS,39358-0000,Public       ,1015,960,1975,3336,2433,5769
00240700,HINDS COMMUNITY COLLEGE                 ,MS,39154-9799,Public       ,2144,3196,5340,7500,8664,16164
00240800,HOLMES COMMUNITY COLLEGE                ,MS,39079-0000,Public       ,1103,1826,2929,3902,4985,8887
00240900,ITAWAMBA COMMUNITY COLLEGE              ,MS,38843-1099,Public       ,1041,1117,2158,3878,2786,6664
00241000,JACKSON STATE UNIVERSITY                ,MS,39217-0001,Public       ,1529,3222,4751,9671,9643,19314
00241100,JONES COUNTY JUNIOR COLLEGE             ,MS,39437-3999,Public       ,790,700,1490,3797,2278,6075
00241300,MERIDIAN COMMUNITY COLLEGE              ,MS,39307-5890,Public       ,612,863,1475,2092,2301,4393
00241400,MILLSAPS COLLEGE                        ,MS,39201-0000,Private      ,137,190,327,1630,649,2279
00241500,MISSISSIPPI COLLEGE                     ,MS,39058-0001,Private      ,502,764,1266,3137,3107,6244
00241501,MISSISSIPPI COLLEGE - SCHOOL OF LAW     ,MS,39201-1391,Private      ,21,142,163,95,691,786
00241600,MISSISSIPPI DELTA CMTY COLLEGE          ,MS,38761-0000,Public       ,628,679,1307,2104,1719,3823
00241700,MISSISSIPPI GULF CST CLG                ,MS,39573-0000,Public       ,1293,2148,3441,5290,6249,11539
00242200,MISSISSIPPI UNIV FOR WOMEN              ,MS,39701-5818,Public       ,299,659,958,1801,2295,4096
00242300,MISSISSIPPI STATE UNIVERSITY            ,MS,39762-9698,Public       ,2248,1829,4077,18523,7193,25716
00242400,MISSISSIPPI VALLEY STATE UNIVERSITY     ,MS,38941-1400,Public       ,583,904,1487,3126,2552,5678
00242600,NORTHEAST MS CMNTY COLLEGE              ,MS,38829-1731,Public       ,597,560,1157,2907,1669,4576
00242700,NORTHWEST MISSISSIPPI COMMUNITY CLG     ,MS,38668-1703,Public       ,1358,1487,2845,5880,4650,10530
00243000,PEARL RIVER COMMUNITY COLLEGE           ,MS,39470-2201,Public       ,848,925,1773,3318,2807,6125
00243300,RUST COLLEGE                            ,MS,38635-2328,Private      ,270,194,464,1432,671,2103
00243500,SOUTHEASTERN BAPTIST COLLEGE            ,MS,39440-0000,Private      ,7,31,38,21,72,93
00243600,SOUTHWEST MISSISSIPPI CMNTY CLG         ,MS,39666-8099,Public       ,383,430,813,1485,1248,2733
00243900,TOUGALOO COLLEGE                        ,MS,39174-9799,Private      ,276,257,533,1418,782,2200
00244000,UNIVERSITY OF MISSISSIPPI               ,MS,38677-1848,Public       ,2341,1701,4042,17437,6347,23784
00244001,UNIVERSITY OF MISSISSIPPI - MED CTR     ,MS,39216-0000,Public       ,96,426,522,751,2568,3319
00244100,UNIVERSITY OF SOUTHERN MISSISSIPPI      ,MS,39406-0001,Public       ,1656,2134,3790,12033,9088,21121
00244700,WILLIAM CAREY UNIVERSITY                ,MS,39401-5499,Private      ,409,974,1383,2110,4136,6246
00489809,MCCANN SCHOOL OF BUSINESS & TECHNOLOGY -,MS,39503-3167,Proprietary  ,12,44,56,29,158,187
01289101,ANTONELLI COLLEGE - JACKSON             ,MS,39232-9514,Proprietary  ,38,423,461,127,1242,1369
01289102,ANTONELLI COLLEGE - HATTIESBURG         ,MS,39401-3056,Proprietary  ,40,189,229,138,625,763
02074900,CHRIS' BEAUTY COLLEGE                   ,MS,39501-0000,Proprietary  ,13,43,56,34,124,158
02160500,NORTH MISSISSIPPI MED CTR MED TECH      ,MS,38801-0000,Private      ,16,52,68,40,114,154
02235900,ACADEMY OF HAIR DESIGN #4               ,MS,39208-0000,Proprietary  ,10,33,43,51,115,166
02244300,ACADEMY OF HAIR DESIGN #1               ,MS,39204-5008,Proprietary  ,23,95,118,85,265,350
02244305,ACADEMY OF HAIR DESIGN #1-ACADEMY OF HAI,MS,38901-5108,Proprietary  ,11,25,36,44,95,139
02249900,DELTA BEAUTY COLLEGE                    ,MS,38701-0000,Proprietary  ,9,36,45,30,82,112
02251600,ACADEMY OF HAIR DESIGN #6               ,MS,39401-7581,Proprietary  ,27,61,88,83,211,294
02251700,FOSTER'S COSMETOLOGY COLLEGE            ,MS,38663-0000,Proprietary  ,3,30,33,8,45,53
02302800,MISSISSIPPI COLLEGE OF BEAUTY CULT      ,MS,39440-0000,Proprietary  ,11,22,33,31,76,107
02320800,MAGNOLIA COLLEGE OF COSMETOLOGY         ,MS,39206-0000,Proprietary  ,35,107,142,95,269,364
02502100,CREATIONS COLLEGE OF COSMETOLOGY        ,MS,38803-0000,Proprietary  ,1,7,8,19,60,79
02516200,WESLEY BIBLICAL SEMINARY                ,MS,39206-0000,Private      ,0,43,43,4,116,120
02586000,J & J HAIR DESIGN COLLEGE               ,MS,39051-3716,Proprietary  ,5,27,32,27,84,111
03010603,VIRGINIA COLLEGE - JACKSON              ,MS,39206-5602,Proprietary  ,40,207,247,130,645,775
03010610,VIRGINIA COLLEGE - BILOXI               ,MS,39532-2124,Proprietary  ,28,129,157,96,397,493
03032400,KC'S SCHOOL OF HAIR DESIGN              ,MS,38863-0000,Proprietary  ,6,27,33,24,84,108
03263300,TRAXLER'S SCHOOL OF HAIR                ,MS,39212-2529,Proprietary  ,5,32,37,15,80,95
03294305,BLUE CLIFF COLLEGE - GULFPORT           ,MS,39503-0000,Proprietary  ,30,158,188,84,356,440
03464300,ACADEMY OF HAIR DESIGN                  ,MS,39562-0000,Proprietary  ,2,15,17,14,44,58
03848300,DAY SPA CAREER COLLEGE                  ,MS,39564-0000,Proprietary  ,7,32,39,18,89,107
03963300,HEALING TOUCH CAREER COLLEGE            ,MS,39402-1300,Proprietary  ,20,102,122,47,264,311
04131300,CORINTH ACADEMY OF COSMETOLOGY          ,MS,38834-4813,Proprietary  ,10,51,61,39,139,178
04140200,"MISSISSIPPI INSTITUTE OF AESTHETICS, NAI",MS,39056-5628,Proprietary  ,8,44,52,37,103,140
00252600,CARROLL COLLEGE                         ,MT,59625-0002,Private      ,46,37,83,2371,232,2603
00252700,UNIVERSITY OF GREAT FALLS               ,MT,59405-4996,Private      ,105,146,251,1018,514,1532
00252800,MILES COMMUNITY COLLEGE                 ,MT,59301-4799,Public       ,48,68,116,245,203,448
00252900,DAWSON COMMUNITY COLLEGE                ,MT,59330-1405,Public       ,31,40,71,191,110,301
00253000,MONTANA STATE UNIVERSITY - BILLINGS     ,MT,59101-0298,Public       ,368,734,1102,2546,2735,5281
00253100,MONTANA TECH OF THE UNIV OF MONTANA     ,MT,59701-8997,Public       ,157,252,409,1542,1206,2748
00253200,MONTANA STATE UNIVERSITY - BOZEMAN      ,MT,59717-4160,Public       ,912,854,1766,12940,4266,17206
00253300,MONTANA STATE UNIVERSITY-NORTHERN       ,MT,59501-3148,Public       ,104,200,304,795,722,1517
00253400,ROCKY MOUNTAIN COLLEGE                  ,MT,59102-1796,Private      ,81,79,160,1239,432,1671
00253600,UNIVERSITY OF MONTANA (THE)             ,MT,59812-0001,Public       ,795,1207,2002,8183,6496,14679
00253700,UNIVERSITY OF MONTANA WESTERN (THE)     ,MT,59725-3598,Public       ,113,120,233,1367,529,1896
00677700,FLATHEAD VALLEY COMMUNITY COLLEGE       ,MT,59901-2699,Public       ,130,309,439,831,1230,2061
00757000,HELENA COLLEGE OF TECHNOLOGY            ,MT,59601-3098,Public       ,84,204,288,463,795,1258
00790000,BUTTE ACADEMY OF BEAUTY CULTURE         ,MT,59701-9197,Proprietary  ,11,11,22,29,41,70
00931400,GREAT FALLS COLLEGE MONTANA STATE UNIVER,MT,59405-4907,Public       ,119,407,526,603,1424,2027
02143400,SALISH KOOTENAI COLLEGE                 ,MT,59855-0000,Public       ,76,237,313,330,721,1051
02286600,LITTLE BIG HORN COLLEGE                 ,MT,59022-0000,Public       ,30,67,97,97,122,219
02343000,FT PECK COMMUNITY COLLEGE               ,MT,59255-0000,Public       ,23,80,103,54,146,200
02510600,BLACKFEET COMMUNITY COLLEGE             ,MT,59417-0000,Private      ,51,211,262,143,354,497
02517500,FORT BELKNAP COLLEGE                    ,MT,59526-0000,Public       ,16,46,62,54,109,163
02545200,CHIEF DULL KNIFE COLLEGE                ,MT,59043-0098,Public       ,20,40,60,57,93,150
02610900,STONE CHILD COLLEGE                     ,MT,59521-9796,Public       ,20,83,103,75,149,224
02621300,ACADEMY OF COSMETOLOGY                  ,MT,59715-3544,Proprietary  ,5,9,14,49,43,92
03205300,MODERN BEAUTY SCHOOL                    ,MT,59801-8386,Proprietary  ,5,19,24,38,60,98
03763400,BOLD BEAUTY ACADEMY                     ,MT,59101-0000,Proprietary  ,14,37,51,70,125,195
03778300,HEALTH WORKS INSTITUTE                  ,MT,59715-0000,Proprietary  ,9,33,42,49,109,158
04163700,BITTERROOT SCHOOL OF COSMETOLOGY        ,MT,59840-3118,Proprietary  ,4,5,9,14,29,43
04164100,MONTANA ACADEMY OF SALON                ,MT,59405-0000,Proprietary  ,13,23,36,51,74,125
04187700,CREVIER'S SCHOOL OF COSMETOLOGY         ,MT,59901-4402,Proprietary  ,8,20,28,44,101,145
00253900,CHADRON STATE COLLEGE                   ,NE,69337-2690,Public       ,199,332,531,1789,1193,2982
00254000,COLLEGE OF ST MARY                      ,NE,68106-2606,Private      ,66,223,289,587,1034,1621
00254100,CONCORDIA UNIVERSITY                    ,NE,68434-1594,Private      ,93,452,545,1439,1244,2683
00254200,CREIGHTON UNIVERSITY                    ,NE,68178-0315,Private      ,240,510,750,6274,4958,11232
00254400,DOANE COLLEGE                           ,NE,68333-2421,Private      ,106,315,421,1580,1042,2622
00254700,GRACE UNIVERSITY                        ,NE,68108-3629,Private      ,52,100,152,374,339,713
00254800,HASTINGS COLLEGE                        ,NE,68901-7621,Private      ,106,63,169,1464,251,1715
00255100,UNIVERSITY OF NEBRASKA AT KEARNEY       ,NE,68849-0001,Public       ,410,499,909,4255,1996,6251
00255200,MCCOOK COMMUNITY COLLEGE                ,NE,69001-2631,Public       ,0,0,0,23,17,40
00255300,MIDLAND UNIVERSITY                      ,NE,68025-4254,Private      ,175,90,265,1611,356,1967
00255400,UNIVERSITY OF NEBRASKA-OMAHA            ,NE,68182-0001,Public       ,948,1448,2396,9415,6650,16065
00255500,NEBRASKA WESLEYAN UNIVERSITY            ,NE,68504-2796,Private      ,201,175,376,1908,770,2678
00255700,MID-PLAINS COMM. COLLEGE-ALL CAMPUSES   ,NE,69101-9420,Public       ,151,245,396,607,701,1308
00255900,PERU STATE COLLEGE                      ,NE,68421-0010,Public       ,165,269,434,1180,950,2130
00256000,WESTERN NEBRASKA COMMUNITY COLLEGE      ,NE,69361-1815,Public       ,122,199,321,665,679,1344
00256300,UNION COLLEGE                           ,NE,68506-4387,Private      ,148,94,242,861,390,1251
00256500,UNIVERSITY OF NEBRASKA-LINCOLN          ,NE,68588-0419,Public       ,1250,736,1986,16332,4745,21077
00256596,UNIVERSITY OF NEBRASKA - CURTIS         ,NE,69025-9522,Public       ,32,20,52,276,55,331
00256600,WAYNE STATE COLLEGE                     ,NE,68787-1172,Public       ,318,225,543,2960,838,3798
00256700,YORK COLLEGE                            ,NE,68467-2699,Private      ,102,39,141,394,105,499
00443600,REGNL WST MEDCL CTR SCHL RAD            ,NE,69361-0000,Private      ,2,1,3,16,11,27
00458608,KAPLAN UNIVERSITY - OMAHA               ,NE,68134-1002,Proprietary  ,26,399,425,128,1346,1474
00458609,KAPLAN UNIVERSITY - LINCOLN             ,NE,68508-2668,Proprietary  ,19,201,220,94,944,1038
00639900,BRYANLGH COLLEGE OF HEALTH SCIENCES     ,NE,68506-1398,Private      ,44,86,130,407,427,834
00640400,NEBR METHODIST CLG OF NURS ALLD HLTH    ,NE,68114-2852,Private      ,56,258,314,459,982,1441
00689500,UNIVERSITY OF NEBRASKA-MED CTR          ,NE,68198-4265,Public       ,45,271,316,695,2463,3158
00750100,VATTEROTT COLLEGE                       ,NE,68137-1237,Proprietary  ,3,53,56,23,175,198
00849200,ALEGENT HEALTH SCHOOLS                  ,NE,68114-2767,Private      ,5,39,44,64,195,259
00952300,BAHNER COLLEGE OF HAIRSTYLING           ,NE,68025-3297,Proprietary  ,1,9,10,12,30,42
00961700,CAPITOL BEAUTY SCHOOL                   ,NE,68144-0000,Proprietary  ,29,51,80,130,169,299
00974300,BELLEVUE UNIVERSITY                     ,NE,68005-0000,Private      ,187,2189,2376,753,7306,8059
00986200,CLARKSON COLLEGE                        ,NE,68131-2739,Private      ,45,297,342,503,1234,1737
01151900,JOSEPH'S COLLEGE OF BEAUTY/ALL CAMPUSES ,NE,68510-2226,Proprietary  ,31,57,88,172,237,409
01166700,NORTHEAST COMMUNITY COLLEGE             ,NE,68702-0000,Public       ,325,346,671,1927,1147,3074
01258600,METROPOLITAN COMMUNITY COLLEGE          ,NE,68103-0000,Public       ,1086,2722,3808,4643,9028,13671
01297600,NEBRASKA CHRISTIAN COLLEGE              ,NE,68046-4256,Private      ,16,13,29,120,54,174
02079700,COLLEGE OF HAIR DESIGN                  ,NE,68508-0000,Proprietary  ,33,48,81,125,180,305
02099500,CENTRAL COMMUNITY COLLEGE-ALL CAMPUSES  ,NE,68801-7299,Public       ,384,682,1066,1822,2040,3862
02508300,SOUTHEAST COMM. COLLEGE-ALL CAMPUSES    ,NE,68520-0000,Public       ,880,1233,2113,3993,4624,8617
02550800,NEBRASKA INDIAN COMMUNITY COLLEGE       ,NE,68039-0000,Public       ,17,57,74,29,102,131
02610500,XENON INTERNATIONAL ACADEMY II          ,NE,68127-3522,Proprietary  ,27,53,80,181,223,404
03164300,THE CREATIVE CENTER                     ,NE,68164-2911,Proprietary  ,15,17,32,101,73,174
03279300,MYOTHERAPY INSTITUTE                    ,NE,68516-0000,Proprietary  ,5,11,16,26,48,74
03323300,LITTLE PRIEST TRIBAL COLLEGE            ,NE,68071-0000,Private      ,12,65,77,34,105,139
03821400,UNIVERSAL COLLEGE OF HEALING ARTS       ,NE,68112-1810,Proprietary  ,6,31,37,21,104,125
00256800,UNIVERSITY OF NEVADA RENO               ,NV,89557-0002,Public       ,1003,972,1975,18281,6960,25241
00256900,UNIVERSITY OF NEVADA-LAS VEGAS          ,NV,89154-1001,Public       ,1911,2835,4746,21867,17694,39561
00697700,GREAT BASIN COLLEGE                     ,NV,89801-3348,Public       ,164,411,575,715,1201,1916
00732954,ITT TECHNICAL INSTITUTE                 ,NV,89014-6712,Proprietary  ,52,194,246,227,716,943
00736700,MARINELLO SCHOOLS OF BEAUTY             ,NV,89110-3563,Proprietary  ,33,125,158,162,500,662
00736701,MARINELLO SCHOOLS OF BEAUTY -           ,NV,89014-2244,Proprietary  ,20,56,76,72,170,242
00737100,MARINELLO SCHOOL OF BEAUTY              ,NV,89502-6530,Proprietary  ,27,60,87,132,243,375
00919200,SIERRA NEVADA COLLEGE                   ,NV,89451-0000,Private      ,78,205,283,569,699,1268
01036200,COLLEGE OF SOUTHERN NEVADA              ,NV,89146-1139,Public       ,2780,5939,8719,15801,25275,41076
01036300,WESTERN NEVADA COLLEGE                  ,NV,89703-0000,Public       ,263,600,863,1139,2355,3494
01246110,LINCOLN TECHNICAL INSTITUTE-EUPH INST OF,NV,89117-8803,Proprietary  ,39,80,119,139,309,448
01246111,LINCOLN TECHNICAL INSTITUTE-EUPH INS OFB,NV,89052-4964,Proprietary  ,31,31,62,67,119,186
01323200,ACADEMY OF HAIR DESIGN                  ,NV,89146-1617,Proprietary  ,42,139,181,173,447,620
02107700,TRUCKEE MEADOWS COMMUNITY CLG           ,NV,89512-0000,Public       ,656,1411,2067,4238,5986,10224
02237500,EVEREST COLLEGE                         ,NV,89103-0000,Private      ,94,345,439,457,1405,1862
02338512,GLENDALE CAREER COLLEGE - NEVADA CAREER ,NV,89131-3268,Proprietary  ,15,71,86,71,252,323
02616703,SCOTTSDALE CULINARY INSTITUTE - LE CORDO,NV,89144-7047,Proprietary  ,25,90,115,144,323,467
02621500,CAREER COLLEGE OF NORTHERN NEVADA       ,NV,89434-7905,Proprietary  ,83,214,297,243,712,955
03030603,UTAH CLG OF MASSAGE THERAPY-NSMT        ,NV,89123-0000,Proprietary  ,37,125,162,105,345,450
03031405,INTERNATIONAL ACADEMY OF DESIGN AND TECH,NV,89074-7750,Proprietary  ,20,52,72,105,199,304
03043200,KAPLAN COLLEGE                          ,NV,89102-8618,Proprietary  ,150,578,728,642,2008,2650
03787300,EXPERTISE SCHOOL OF BEAUTY              ,NV,89106-2516,Private      ,17,94,111,73,271,344
03838500,NORTHWEST HEALTH CAREERS                ,NV,89128-0255,Proprietary  ,50,216,266,212,672,884
03975300,INSTITUTE OF PROFESSIONAL CAREERS       ,NV,89119-7825,Proprietary  ,18,117,135,97,381,478
04051303,ART INSTITUTE OF PHOENIX (THE) - ART INS,NV,89074-7737,Proprietary  ,49,90,139,367,392,759
04065300,ROSEMAN UNIVERSITY OF HEALTH SCIENCES   ,NV,89014-2333,Private      ,18,159,177,153,1789,1942
04114300,NEVADA STATE COLLEGE                    ,NV,89002-9455,Public       ,317,718,1035,2419,3941,6360
04142601,TOURO UNIVERSITY - NEVADA               ,NV,89014-8800,Private      ,15,94,109,136,955,1091
04144800,INTERNATIONAL ACADEMY OF STYLE          ,NV,89509-3450,Proprietary  ,19,37,56,77,140,217
04147600,AVEDA INSTITUTE LAS VEGAS               ,NV,89119-6103,Proprietary  ,64,160,224,179,408,587
04171000,ADVANCED TRAINING INSTITUTE             ,NV,89115-7504,Proprietary  ,77,275,352,218,764,982
04180500,ADVANCED BEAUTY SCHOOL OF COSMETOLOGY   ,NV,89103-5864,Proprietary  ,24,69,93,80,231,311
04186300,PAUL MITCHELL THE SCHOOL LAS VEGAS      ,NV,89123-8014,Proprietary  ,66,142,208,263,423,686
04190300,AMERICAN INSTITUTE OF MEDICAL SONOGRAPHY,NV,89146-6597,Proprietary  ,0,0,0,92,208,300
04203100,PAUL MITCHELL THE SCHOOL RENO           ,NV,89501-3356,Proprietary  ,30,50,80,118,173,291
04226200,HEALTHCARE PREPARATORY INSTITUTE        ,NV,89130-2580,Proprietary  ,32,132,164,140,417,557
00257200,COLBY-SAWYER COLLEGE                    ,NH,03257-4648,Private      ,33,20,53,2172,122,2294
00257300,DARTMOUTH COLLEGE                       ,NH,03755-3529,Private      ,133,96,229,11099,1690,12789
00257500,FRANKLIN PIERCE UNIVERSITY              ,NH,03461-0060,Private      ,77,177,254,3153,1150,4303
00257900,NEW ENGLAND COLLEGE                     ,NH,03242-3293,Private      ,130,429,559,2463,1903,4366
00258000,SOUTHERN NEW HAMPSHIRE UNIVERSITY       ,NH,03106-1045,Private      ,1446,15227,16673,9366,64537,73903
00258100,NHTI  - CONCORD'S COMMUNITY COLLEGE     ,NH,03301-7412,Public       ,510,494,1004,2592,1865,4457
00258200,MANCHESTER COMMUNITY COLLEGE            ,NH,03102-8518,Public       ,383,510,893,1431,1784,3215
00258300,GREAT BAY COMMUNITY COLLEGE             ,NH,03801-0000,Public       ,264,294,558,1024,1204,2228
00258600,RIVIER UNIVERSITY                       ,NH,03060-5086,Private      ,47,223,270,1309,1070,2379
00258700,SAINT ANSELM COLLEGE                    ,NH,03102-1310,Private      ,61,38,99,3912,166,4078
00258900,UNIVERSITY OF NEW HAMPSHIRE             ,NH,03824-2511,Public       ,318,343,661,21585,3725,25310
00258903,UNIVERSITY OF NEW HAMPSHIRE - SCHOOL OF ,NH,03301-4115,Public       ,0,0,0,0,14,14
00259000,KEENE STATE COLLEGE                     ,NH,03431-0000,Public       ,167,67,234,6909,621,7530
00259100,PLYMOUTH STATE UNIVERSITY               ,NH,03264-1595,Public       ,129,166,295,6745,1323,8068
00301004,ANTIOCH UNIVERSITY                      ,NH,03431-0000,Private      ,1,67,68,11,714,725
00472900,MOUNT WASHINGTON COLLEGE                ,NH,03103-7230,Proprietary  ,35,203,238,179,876,1055
00472901,HESSER COLLEGE - NASHUA CAMPUS          ,NH,03063-1286,Proprietary  ,0,0,0,0,2,2
00473100,DANIEL WEBSTER COLLEGE                  ,NH,03063-1300,Proprietary  ,85,80,165,821,301,1122
00529100,WHITE MOUNTAINS COMMUNITY COLLEGE       ,NH,03570-3799,Public       ,64,171,235,361,495,856
00702500,LEBANON COLLEGE                         ,NH,03766-0000,Private      ,0,0,0,0,1,1
00755500,LAKES REGION COMMUNITY COLLEGE          ,NH,03246-1326,Public       ,126,178,304,609,635,1244
00756000,RIVER VALLEY COMMUNITY COLLEGE          ,NH,03743-9707,Public       ,88,165,253,337,711,1048
00864500,EMPIRE BEAUTY SCHOOL                    ,NH,03220-0000,Proprietary  ,48,61,109,111,158,269
00923600,NASHUA COMMUNITY COLLEGE                ,NH,03063-2052,Public       ,322,277,599,1076,942,2018
01318900,CONTINENTAL ACADEMIE OF HAIR DESIGN     ,NH,03051-3754,Proprietary  ,12,7,19,46,32,78
02140400,ST JOSEPH SCH OF PRAC NRSG              ,NH,03060-0000,Private      ,5,37,42,53,222,275
02174800,MICHAEL'S SCHOOL OF HAIR DESIGN & ESTHET,NH,03110-0000,Proprietary  ,24,33,57,88,89,177
02179600,EMPIRE BEAUTY SCHOOL                    ,NH,03878-0000,Proprietary  ,27,46,73,69,124,193
02211600,PORTSMOUTH BTY SCH OF HAIR DESIGN       ,NH,03801-4084,Proprietary  ,12,18,30,40,34,74
02223300,NORTHEAST CATHOLIC COLLEGE              ,NH,03278-4012,Private      ,11,4,15,88,13,101
02245400,KEENE BEAUTY ACADEMY                    ,NH,03431-0000,Proprietary  ,5,11,16,42,48,90
02247000,NEW ENGLAND SCHOOL OF HAIR DESIGN       ,NH,03784-0000,Proprietary  ,0,10,10,18,34,52
03043100,THOMAS MORE COLLEGE OF LIBERAL ARTS     ,NH,03054-4818,Private      ,10,2,12,101,12,113
03101300,GRANITE STATE COLLEGE                   ,NH,03301-6400,Public       ,99,492,591,437,2344,2781
03182300,NEW HAMPSHIRE INSTITUTE OF ART          ,NH,03104-4858,Private      ,39,40,79,596,195,791
03437300,UPPER VALLEY TEACHER TRANING PROGRAM    ,NH,03766-1358,Private      ,0,6,6,0,37,37
03729300,NH INSTITUTE FOR THERAPEUTIC ARTS       ,NH,03051-4906,Proprietary  ,2,17,19,9,40,49
04162200,LAIRD INSTITUTE OF SPA THERAPY          ,NH,03102-5263,Proprietary  ,10,18,28,21,50,71
00267000,SUMMIT UNIVERSITY OF PENNSYLVANIA       ,PA,18411-1297,Private      ,61,108,169,523,414,937
00322800,BRYN ATHYN COLLEGE OF THE NEW CHURCH    ,PA,19009-0717,Private      ,17,10,27,325,51,376
00322900,ALBRIGHT COLLEGE                        ,PA,19612-5234,Private      ,119,137,256,4674,1067,5741
00323000,ALLEGHENY COLLEGE                       ,PA,16335-3902,Private      ,49,17,66,3319,135,3454
00323100,COMM CLG OF ALLEGHENY-ALLEGHENY CMP     ,PA,15212-0000,Public       ,561,1206,1767,2782,4948,7730
00323101,"COMM CLG OF ALLEGHENY, BOYCE CAMPUS     ",PA,15146-0000,Public       ,279,519,798,1352,2087,3439
00323102,"COMM CLG OF ALLEGHENY, NORTH CAMPUS     ",PA,15237-0000,Public       ,362,545,907,1719,1984,3703
00323103,"COMM CLG OF ALLEGHENY, SOUTH CAMPUS     ",PA,15122-0000,Public       ,310,451,761,1552,1819,3371
00323300,ALVERNIA UNIVERSITY                     ,PA,19607-1799,Private      ,82,263,345,2336,1620,3956
00323500,ARCADIA UNIVERSITY                      ,PA,19038-3295,Private      ,132,209,341,6245,1722,7967
00323700,BRYN MAWR COLLEGE                       ,PA,19010-2899,Private      ,36,38,74,1902,478,2380
00323800,BUCKNELL UNIVERSITY                     ,PA,17837-2122,Private      ,75,25,100,6383,208,6591
00323900,BUCKS COUNTY COMMUNITY COLLEGE          ,PA,18940-1320,Public       ,730,792,1522,3832,3327,7159
00324000,BUTLER COUNTY COMMUNITY COLLEGE         ,PA,16001-0000,Public       ,313,381,694,1893,1490,3383
00324100,CABRINI COLLEGE                         ,PA,19087-3698,Private      ,116,216,332,2160,673,2833
00324200,CARNEGIE MELLON UNIVERSITY              ,PA,15213-3890,Private      ,287,188,475,13154,1490,14644
00324201,CARNEGIE MELLON UNIV- THE HEINZ COLLEGE ,PA,15213-0000,Private      ,7,52,59,143,557,700
00324202,CARNEGIE MELLON- TEPPER SCHOOL OF BUSINE,PA,15213-0000,Private      ,10,62,72,245,473,718
00324300,CEDAR CREST COLLEGE                     ,PA,18104-6196,Private      ,34,164,198,1125,1265,2390
00324400,CHATHAM UNIVERSITY                      ,PA,15232-2826,Private      ,34,241,275,1058,1615,2673
00324500,CHESTNUT HILL COLLEGE                   ,PA,19118-2693,Private      ,116,366,482,1623,1944,3567
00324700,MISERICORDIA  UNIVERSITY                ,PA,18612-1008,Private      ,93,231,324,2477,1375,3852
00324900,COMMUNITY COLLEGE OF PHILADELPHIA       ,PA,19130-3991,Public       ,2240,4936,7176,11998,20240,32238
00325100,CURTIS INSTITUTE OF MUSIC               ,PA,19103-6187,Private      ,9,6,15,274,138,412
00325200,DELAWARE VALLEY COLLEGE                 ,PA,18901-2697,Private      ,144,96,240,2729,467,3196
00325300,DICKINSON COLLEGE                       ,PA,17013-2896,Private      ,83,13,96,3607,180,3787
00325600,DREXEL UNIVERSITY                       ,PA,19104-2875,Private      ,682,2226,2908,24240,15857,40097
00325800,DUQUESNE UNIVERSITY                     ,PA,15282-0001,Private      ,147,288,435,8193,3493,11686
00325900,EASTERN UNIVERSITY                      ,PA,19087-3696,Private      ,122,376,498,2238,2194,4432
00326200,ELIZABETHTOWN COLLEGE                   ,PA,17022-2298,Private      ,69,97,166,2826,694,3520
00326300,EVANGELICAL SCHOOL OF THEOLOGY          ,PA,17067-0000,Private      ,0,13,13,1,94,95
00326500,FRANKLIN & MARSHALL COLLEGE             ,PA,17604-0000,Private      ,52,24,76,4062,203,4265
00326600,GANNON UNIVERSITY                       ,PA,16541-0001,Private      ,91,146,237,3644,1270,4914
00326700,GENEVA COLLEGE                          ,PA,15010-3599,Private      ,76,127,203,1808,722,2530
00326800,GETTYSBURG COLLEGE                      ,PA,17325-1486,Private      ,55,30,85,4375,195,4570
00326900,GROVE CITY COLLEGE                      ,PA,16127-2104,Private      ,18,8,26,1702,53,1755
00327000,GWYNEDD-MERCY COLLEGE                   ,PA,19437-0901,Private      ,77,273,350,1562,1796,3358
00327200,HARCUM COLLEGE                          ,PA,19010-3476,Private      ,92,263,355,819,1714,2533
00327300,HARRISBURG AREA COMMUNITY COLLEGE       ,PA,17110-2999,Public       ,1599,2875,4474,9039,13261,22300
00327400,HAVERFORD COLLEGE                       ,PA,19041-1392,Private      ,42,8,50,2140,69,2209
00327500,HOLY FAMILY UNIVERSITY                  ,PA,19114-2094,Private      ,107,253,360,1968,1651,3619
00327600,IMMACULATA UNIVERSITY                   ,PA,19345-0647,Private      ,108,288,396,1583,1316,2899
00327700,INDIANA UNIVERSITY OF PENNSYLVANIA      ,PA,15705-1097,Public       ,788,567,1355,13733,3407,17140
00327900,JUNIATA COLLEGE                         ,PA,16652-2196,Private      ,29,11,40,2408,121,2529
00328000,KEYSTONE COLLEGE                        ,PA,18440-0200,Private      ,92,72,164,1552,541,2093
00328200,KINGS COLLEGE                           ,PA,18711-0801,Private      ,101,78,179,3057,538,3595
00328300,LACKAWANNA COLLEGE                      ,PA,18509-9961,Private      ,227,208,435,1541,1008,2549
00328400,LAFAYETTE COLLEGE                       ,PA,18042-1768,Private      ,65,15,80,4555,152,4707
00328500,LANCASTER BIBLE COLLEGE                 ,PA,17601-5036,Private      ,66,254,320,909,1038,1947
00328600,LANCASTER THEOLOGICAL SEMINARY          ,PA,17603-0000,Private      ,1,17,18,3,116,119
00328700,LASALLE UNIVERSITY                      ,PA,19141-1199,Private      ,310,586,896,6156,3732,9888
00328800,LEBANON VALLEY COLLEGE                  ,PA,17003-1400,Private      ,34,28,62,2868,264,3132
00328900,LEHIGH UNIVERSITY                       ,PA,18015-1588,Private      ,128,111,239,8954,787,9741
00329000,LINCOLN UNIVERSITY                      ,PA,19352-0999,Public       ,244,227,471,3549,1099,4648
00329100,LUTHERAN THEOLOG SEMINARY-GETTYSBRG     ,PA,17325-0000,Private      ,0,15,15,1,76,77
00329200,LUTHERAN THEOLOGICAL SEMINARY           ,PA,19119-0000,Private      ,2,45,47,2,181,183
00329300,LYCOMING COLLEGE                        ,PA,17701-5192,Private      ,50,15,65,1925,153,2078
00329400,MANOR COLLEGE                           ,PA,19046-3399,Private      ,66,80,146,713,565,1278
00329600,MARYWOOD UNIVERSITY                     ,PA,18509-1598,Private      ,90,150,240,2681,1314,3995
00329700,MERCYHURST UNIVERSITY                   ,PA,16546-0001,Private      ,181,256,437,3626,1413,5039
00329800,MESSIAH COLLEGE                         ,PA,17027-0000,Private      ,96,90,186,3308,555,3863
00330000,MOORE COLLEGE OF ART & DESIGN           ,PA,19103-1179,Private      ,48,44,92,687,318,1005
00330100,MORAVIAN COLLEGE                        ,PA,18018-6650,Private      ,39,72,111,2638,464,3102
00330101,MORAVIAN THEOLOGICAL SEMINARY           ,PA,18018-0000,Private      ,2,8,10,10,85,95
00330200,MOUNT ALOYSIUS COLLEGE                  ,PA,16630-1999,Private      ,32,65,97,1340,743,2083
00330300,CARLOW UNIVERSITY                       ,PA,15213-3165,Private      ,58,351,409,1314,1896,3210
00330400,MUHLENBERG COLLEGE                      ,PA,18104-5586,Private      ,68,64,132,3770,366,4136
00330600,VALLEY FORGE CHRISTIAN COLLEGE          ,PA,19460-2399,Private      ,64,126,190,768,396,1164
00330900,PEIRCE COLLEGE                          ,PA,19102-4699,Private      ,94,506,600,454,2347,2801
00331100,SALUS UNIVERSITY                        ,PA,19027-1598,Private      ,1,40,41,25,1252,1277
00331300,WIDENER UNIVERSITY                      ,PA,19013-5792,Private      ,239,421,660,4947,2700,7647
00331302,WIDENER UNIV SCH OF LAW- HARRISBURG     ,PA,17106-9381,Private      ,4,44,48,26,432,458
00331500,BLOOMSBURG UNIVERSITY OF PA             ,PA,17815-1301,Public       ,658,258,916,12830,2103,14933
00331600,CALIFORNIA UNIV OF PENNSYLVANIA         ,PA,15419-1394,Public       ,465,725,1190,5859,4211,10070
00331700,CHEYNEY UNIVERSITY OF PENNSYLVANIA      ,PA,19319-0200,Public       ,145,145,290,1456,737,2193
00331800,CLARION UNIVERSITY OF PENNSYLVANIA      ,PA,16214-1232,Public       ,156,260,416,4536,2079,6615
00332000,EAST STROUDSBURG UNIVERSITY             ,PA,18301-2999,Public       ,400,249,649,7955,2035,9990
00332100,EDINBORO UNIVERSITY OF PENNSYLVANIA     ,PA,16444-0001,Public       ,304,381,685,5569,2741,8310
00332200,KUTZTOWN UNIVERSITY OF PENNSYLVANIA     ,PA,19530-9339,Public       ,595,320,915,10980,2124,13104
00332300,LOCK HAVEN UNIV OF PENNSYLVANIA         ,PA,17745-2439,Public       ,193,149,342,5077,1269,6346
00332400,MANSFIELD UNIVERSITY                    ,PA,16933-1123,Public       ,173,122,295,2665,653,3318
00332500,MILLERSVILLE UNIVERSITY OF PA           ,PA,17551-1800,Public       ,429,315,744,8406,2400,10806
00332600,SHIPPENSBURG UNIVERSITY                 ,PA,17257-2299,Public       ,410,238,648,8231,1604,9835
00332700,SLIPPERY ROCK UNIVERSITY                ,PA,16057-1326,Public       ,367,313,680,8583,2061,10644
00332800,WEST CHESTER UNIVERSITY                 ,PA,19383-0001,Public       ,765,677,1442,17473,5064,22537
00332900,PENNSYLVANIA STATE UNIVERSITY (THE)     ,PA,16802-1503,Public       ,4272,4495,8767,74259,27786,102045
00335000,UNIVERSITY OF THE ARTS (THE)            ,PA,19102-9493,Private      ,141,95,236,2802,623,3425
00335100,CAIRN UNIVERSITY                        ,PA,19047-2942,Private      ,49,91,140,781,366,1147
00335200,PHILADELPHIA CLG OSTEOPATHIC MED        ,PA,19131-0000,Private      ,5,193,198,48,3410,3458
00335300,UNIVERSITY OF THE SCIENCES IN PHILADELPH,PA,19104-4495,Private      ,57,105,162,3033,1584,4617
00335400,PHILADELPHIA UNIVERSITY                 ,PA,19144-5497,Private      ,186,440,626,4126,2459,6585
00335600,PITTSBURGH THEOLOGICAL SEMINARY         ,PA,15206-0000,Private      ,0,22,22,6,170,176
00335700,POINT PARK UNIVERSITY                   ,PA,15222-1912,Private      ,132,388,520,3798,2219,6017
00335800,REFORMED PRESBYTERIAN THEOL SEMINAR     ,PA,15208-0000,Private      ,0,6,6,1,18,19
00335900,ROBERT MORRIS UNIVERSITY                ,PA,15108-1189,Private      ,153,270,423,5243,1859,7102
00336000,ROSEMONT COLLEGE                        ,PA,19010-1699,Private      ,41,138,179,702,550,1252
00336200,SETON HILL UNIVERSITY                   ,PA,15601-1599,Private      ,96,78,174,2096,818,2914
00336400,ST. CHARLES BORROMEO SEMINARY           ,PA,19096-0000,Private      ,4,10,14,26,24,50
00336600,SAINT FRANCIS UNIVERSITY                ,PA,15940-0600,Private      ,85,110,195,2198,755,2953
00336700,SAINT JOSEPH'S UNIVERSITY               ,PA,19131-1395,Private      ,358,800,1158,7665,3216,10881
00336800,ST VINCENT COLLEGE                      ,PA,15650-2690,Private      ,78,38,116,2082,264,2346
00336900,SUSQUEHANNA UNIVERSITY                  ,PA,17870-1001,Private      ,42,6,48,3834,124,3958
00337000,SWARTHMORE COLLEGE                      ,PA,19081-1397,Private      ,57,16,73,4115,120,4235
00337100,TEMPLE UNIVERSITY                       ,PA,19122-6003,Private      ,1888,2474,4362,36579,18622,55201
00337500,THEOLOGICAL SEMINARY REFORMED EPISCOPAL ,PA,19422-1257,Private      ,0,2,2,0,2,2
00337600,THIEL COLLEGE                           ,PA,16125-2181,Private      ,84,15,99,1536,114,1650
00337800,UNIVERSITY OF PENNSYLVANIA              ,PA,19104-6216,Private      ,491,1052,1543,22955,11438,34393
00337900,UNIVERSITY OF PITTSBURGH                ,PA,15260-0000,Public       ,1094,1132,2226,31776,9154,40930
00337906,UNIVERSITY OF PITTSBURGH - SCHOOL OF MED,PA,15261-0001,Public       ,15,21,36,191,922,1113
00337907,UNIVERSITY OF PITTSBURGH - SCHOOL OF DEN,PA,15261-2523,Public       ,7,17,24,100,363,463
00338400,UNIVERSITY OF SCRANTON                  ,PA,18510-4622,Private      ,191,283,474,7939,1351,9290
00338500,URSINUS COLLEGE                         ,PA,19426-1000,Private      ,57,10,67,2665,92,2757
00338600,VALLEY FORGE MILITARY COLLEGE           ,PA,19087-3695,Private      ,57,11,68,515,76,591
00338800,VILLANOVA UNIVERSITY                    ,PA,19085-1699,Private      ,175,511,686,12485,2782,15267
00338801,VILLANOVA UNIV SCH OF LAW               ,PA,19085-0000,Private      ,2,82,84,32,952,984
00338900,WASHINGTON & JEFFERSON COLLEGE          ,PA,15301-4801,Private      ,93,12,105,2666,111,2777
00339100,WAYNESBURG UNIVERSITY                   ,PA,15370-1222,Private      ,41,133,174,1919,544,2463
00339200,WESTMINSTER COLLEGE                     ,PA,16172-0002,Private      ,23,43,66,1808,161,1969
00339300,WESTMINSTER THEOLOGICAL SEMINARY        ,PA,19038-0000,Private      ,1,19,20,7,269,276
00339400,WILKES UNIVERSITY                       ,PA,18766-0998,Private      ,160,443,603,3546,1692,5238
00339500,PENNSYLVANIA COLLEGE OF TECHNOLOGY      ,PA,17701-5779,Public       ,294,252,546,4785,2033,6818
00339600,WILSON COLLEGE                          ,PA,17201-1285,Private      ,18,95,113,604,470,1074
00339900,YORK COLLEGE OF PENNSYLVANIA            ,PA,17405-7199,Private      ,358,160,518,6960,1104,8064
00398600,DESALES UNIVERSITY                      ,PA,18034-9568,Private      ,99,204,303,2787,1418,4205
00398700,LA ROCHE COLLEGE                        ,PA,15237-5898,Private      ,46,91,137,1199,509,1708
00398800,NEUMANN UNIVERSITY                      ,PA,19014-1298,Private      ,146,230,376,2771,1402,4173
00405800,GRATZ COLLEGE                           ,PA,19027-3097,Private      ,1,26,27,2,79,81
00445200,MONTGOMERY COUNTY COMMUNITY COLLEGE     ,PA,19422-6300,Public       ,894,1215,2109,5050,5227,10277
00488900,CAMBRIA-ROWE BUSINESS COLLEGE           ,PA,15902-2494,Proprietary  ,11,19,30,71,98,169
00488901,CAMBRIA ROWE BUSINESS COLLEGE - INDIANA ,PA,15701-2804,Proprietary  ,4,15,19,62,92,154
00488902,CAMBRIA ROWE BUSINESS COLLEGE - SCHOOL O,PA,15904-1945,Proprietary  ,3,8,11,12,24,36
00489000,CENTRAL PENN COLLEGE                    ,PA,17093-0309,Proprietary  ,87,203,290,929,1516,2445
00489300,DU BOIS BUSINESS COLLEGE                ,PA,15801-2401,Proprietary  ,13,33,46,111,172,283
00489800,MCCANN SCHOOL OF BUSINESS & TECHNOL     ,PA,17901-1335,Proprietary  ,295,1038,1333,990,3695,4685
00489807,MCCANN SCHOOL OF BUSINESS & TECHNOLOGY -,PA,17013-3180,Proprietary  ,8,20,28,52,148,200
00489900,MERCY HOSP SCH OF NURSING               ,PA,15219-5166,Private      ,9,28,37,116,162,278
00490200,PENN COMMERCIAL BUSINESS/TECHNICAL SCHL ,PA,15301-2871,Proprietary  ,39,74,113,202,345,547
00491000,KAPLAN CAREER INSTITUTE                 ,PA,17111-3571,Proprietary  ,38,179,217,154,518,672
00491001,THOMPSON INSTITUTE-PHILADEPHIA CAMPUS   ,PA,19104-3386,Proprietary  ,73,196,269,216,617,833
00500701,WEST VIRGINIA CAREER INSTITUTE          ,PA,15456-0000,Proprietary  ,8,13,21,49,77,126
00531000,PITTSBURGH INST OF AERONAUTICS          ,PA,15236-0000,Private      ,47,52,99,350,247,597
00533000,FAYETTE CNTY AREA VOC TECH PRC NRSG     ,PA,15401-0000,Public       ,13,21,34,37,94,131
00533500,CENTRAL PENN INST OF SCI & TECH PNP     ,PA,16823-0000,Public       ,25,70,95,88,196,284
00536500,YORK CO AREA VOC-TECH SCH-PRAC NSG      ,PA,17402-0000,Public       ,26,90,116,94,297,391
00653400,CITIZENS SCHOOL OF NURSING              ,PA,15068-6591,Private      ,8,27,35,100,172,272
00653700,CONEMAUGH VLY MEM HOSP SCH NRSNG        ,PA,15905-4398,Proprietary  ,9,17,26,93,88,181
00655100,ST MARGARET SCHL OF NURSING             ,PA,15238-3205,Private      ,5,25,30,73,155,228
00656000,OHIO VALLEY HOSP SCH OF NURSING         ,PA,15136-1694,Private      ,9,7,16,44,52,96
00656500,READING HOSPITAL SCHOOL OF HEALTH SCIENC,PA,19611-1744,Private      ,15,56,71,221,431,652
00657400,"ST LUKE'S HOSPITAL OF BETHLEHEM, PA     ",PA,18015-1065,Private      ,8,28,36,101,242,343
00657700,UPMC SHADYSIDE SCHOOL OF NURSING        ,PA,15232-1381,Private      ,37,70,107,221,311,532
00657800,SHARON REGIONAL HEALTH SYSTEM SCHOOL OF ,PA,16146-3395,Private      ,0,9,9,35,56,91
00658200,WASHINGTON HOSP SCH OF NURSING          ,PA,15301-3398,Private      ,12,15,27,47,77,124
00658202,WASHINGTON HOSP SCH OF RAD TECH         ,PA,15301-3398,Private      ,1,4,5,8,18,26
00658300,WESTERN PENN HOSP-SCH OF NURSING        ,PA,15224-1790,Private      ,8,32,40,138,186,324
00680700,COMMUNITY COLLEGE OF BEAVER COUNTY      ,PA,15061-2588,Public       ,244,345,589,1085,1230,2315
00681000,LEHIGH CARBON COMMUNITY COLLEGE         ,PA,18078-2598,Public       ,490,734,1224,3292,3445,6737
00681100,LUZERNE COUNTY COMMUNITY COLLEGE        ,PA,18634-3899,Public       ,489,753,1242,2780,3244,6024
00708700,ABINGTON MEM HOSP SCHL OF NURSING       ,PA,19090-1284,Private      ,0,3,3,123,321,444
00709100,EVEREST INSTITUTE                       ,PA,15222-1320,Private      ,23,84,107,83,380,463
00711000,DELAWARE COUNTY COMMUNITY COLLEGE       ,PA,19063-1094,Public       ,1081,1802,2883,5798,7458,13256
00719100,NORTHAMPTON COMMUNITY COLLEGE           ,PA,18020-7599,Public       ,742,980,1722,6163,5617,11780
00730305,LINCOLN TECHNICAL INSTITUTE - PHILADELPH,PA,19136-1530,Proprietary  ,47,107,154,248,417,665
00732955,ITT TECHNICAL INSTITUTE                 ,PA,19406-1212,Proprietary  ,29,130,159,176,533,709
00743000,ANTONELLI INST OF ART & PHOTOGRAPHY     ,PA,19038-8242,Proprietary  ,5,9,14,234,35,269
00743600,KAPLAN CAREER INSTITUTE - ICM CAMPUS    ,PA,15222-1977,Proprietary  ,39,204,243,172,715,887
00743700,PITTSBURGH TECHNICAL INSTITUTE          ,PA,15071-3205,Proprietary  ,176,187,363,2200,1233,3433
00746900,"HUSSIAN SCHOOL OF ART, INC.             ",PA,19106-0000,Proprietary  ,9,9,18,105,40,145
00747000,"ART INSTITUTE OF PITTSBURGH, THE        ",PA,15219-1328,Proprietary  ,711,3720,4431,2512,9058,11570
00752900,"CHESTER COUNTY INTERMEDIATE UNIT, PNP   ",PA,19335-3043,Public       ,8,25,33,42,139,181
00777900,LANSDALE SCHOOL OF BUSINESS             ,PA,19454-4114,Proprietary  ,7,61,68,52,316,368
00778000,NEW CASTLE SCHOOL OF TRADES             ,PA,16143-0000,Proprietary  ,66,152,218,291,545,836
00778100,CHI INSTITUTE/RETS CAMPUS               ,PA,19008-3516,Proprietary  ,32,84,116,92,271,363
00783900,TRIANGLE TECH                           ,PA,15214-3897,Proprietary  ,26,63,89,167,253,420
00791200,THADDEUS STEVENS CLG OF TECHNOLOGY      ,PA,17602-0000,Public       ,57,68,125,1226,547,1773
00791600,FRANKLIN CNTY CAREER & TECH CTR-PNP     ,PA,17201-0000,Public       ,7,17,24,39,95,134
00793807,LINCOLN TECHNICAL INSITUTE - ALLENTOWN  ,PA,18104-3212,Proprietary  ,50,149,199,263,542,805
00820000,JAMESON MEMORIAL HOSP SCH NURSING       ,PA,16105-2595,Private      ,2,9,11,35,72,107
00835000,ART INSTITUTE OF PHILADELPHIA           ,PA,19103-5198,Proprietary  ,285,427,712,1938,1848,3786
00844100,ANTHEM INSTITUTE                        ,PA,19064-1243,Proprietary  ,1,6,7,5,22,27
00856800,VET TECH INSTITUTE                      ,PA,15222-3400,Proprietary  ,37,33,70,358,208,566
00865300,JEFFERSON CO DUBOIS VOC TECH-PR NSG     ,PA,15851-0000,Public       ,3,11,14,13,20,33
00895500,SALON PROFESSIONAL ACADEMY (THE)        ,PA,16602-0000,Proprietary  ,8,13,21,23,37,60
00915705,WYOTECH - BLAIRSVILLE                   ,PA,15717-8060,Private      ,75,80,155,419,376,795
00918600,DEAN INSTITUTE OF TECHNOLOGY            ,PA,15226-1197,Proprietary  ,13,30,43,43,99,142
00944900,PENNCO TECH                             ,PA,19007-0000,Proprietary  ,56,96,152,184,318,502
00966400,EMPIRE BEAUTY SCHOOL                    ,PA,18052-5730,Proprietary  ,144,314,458,541,1213,1754
00972100,BRADFORD SCHOOL                         ,PA,15219-2602,Proprietary  ,32,27,59,542,178,720
00972300,ARIA HEALTH SCHOOL OF NURSING           ,PA,19053-6939,Private      ,12,27,39,144,311,455
00986300,PENNSYLVANIA COLLEGE OF HEALTH SCIENCES ,PA,17602-4955,Private      ,72,192,264,649,1049,1698
01000600,GREATER JOHNSTOWN AREA VOC TECH SCH     ,PA,15904-0000,Public       ,19,57,76,64,194,258
01005500,CRAWFORD CNTY AREA VO-TECH PRAC NUR     ,PA,16335-0000,Public       ,1,1,2,13,32,45
01017600,WESTMORELAND COUNTY COMMUNITY CLG       ,PA,15697-1895,Public       ,614,765,1379,2812,2806,5618
01038800,READING AREA COMMUNITY COLLEGE          ,PA,19603-1706,Public       ,486,854,1340,2061,3134,5195
01054200,EMPIRE BEAUTY SCHOOL                    ,PA,18701-0000,Proprietary  ,165,343,508,576,1291,1867
01081400,PITTSBURGH INST MORTUARY SCIENCE        ,PA,15206-3706,Private      ,11,50,61,104,273,377
01086000,GREATER ALTOONA CAREER/TECH CENTER      ,PA,16602-0000,Public       ,26,55,81,91,196,287
01096300,GREENE COUNTY VOC-TECH SCHOOL           ,PA,15370-0000,Public       ,1,6,7,9,30,39
01099800,PENNSYLVANIA INSTITUTE OF TECH          ,PA,19063-4098,Private      ,88,239,327,313,834,1147
01162100,AUTOMOTIVE TRAINING CENTER              ,PA,19341-1310,Proprietary  ,85,78,163,750,335,1085
01162200,WELDER TRAINING & TESTING INST          ,PA,18109-3253,Proprietary  ,9,28,37,31,89,120
01171500,SCHUYLKILL HEALTH SCHOOL OF NURSING     ,PA,17901-3692,Private      ,2,8,10,58,67,125
01191900,BEAVER FALLS BEAUTY ACADEMY             ,PA,15010-4208,Proprietary  ,9,18,27,22,36,58
01205000,ROSEDALE TECHNICAL INSTITUTE            ,PA,15205-9791,Private      ,48,81,129,310,340,650
01239300,THOMAS JEFF UNIV-CLG ALLIED HEALTH      ,PA,19107-0000,Private      ,20,133,153,285,1489,1774
01239301,THOMAS JEFFERSON UNIVERSITY - JEFFERSON ,PA,19107-5001,Private      ,36,214,250,396,2395,2791
01239303,THOMAS JEFFERSON UNIVERSITY - COLLEGE OF,PA,19107-6731,Private      ,26,140,166,230,760,990
01246104,LINCOLN TECHNICAL INSTITUTE             ,PA,19104-0202,Proprietary  ,64,151,215,272,607,879
01246105,LINCOLN TECHNICAL INSTITUTE             ,PA,19116-4202,Proprietary  ,38,133,171,192,492,684
01252300,TALMUDICAL YESHIVA OF PHILA             ,PA,19131-1296,Private      ,5,0,5,24,2,26
01260600,EMPIRE BEAUTY SCHOOL                    ,PA,17901-3859,Proprietary  ,115,283,398,468,1064,1532
01292900,SOUTH HILLS BEAUTY ACADEMY              ,PA,15216-2335,Proprietary  ,22,60,82,62,144,206
01313400,YESHIVATH BETH MOSHE                    ,PA,18505-2196,Private      ,18,0,18,23,3,26
01321400,ROXBOROUGH MEM HOSP SCH OF NURSING      ,PA,19128-0000,Proprietary  ,4,33,37,99,356,455
01326300,SOUTH HILLS SCHOOL OF BUSINESS & TECHNOL,PA,16801-4516,Proprietary  ,26,60,86,418,407,825
02061000,VENUS BEAUTY ACADEMY                    ,PA,19079-0000,Proprietary  ,16,35,51,32,57,89
02068300,DOUGLAS SCHOOL OF BUSINESS              ,PA,15062-0000,Proprietary  ,32,62,94,223,220,443
02090200,TRIANGLE TECH                           ,PA,16502-0000,Proprietary  ,5,6,11,51,43,94
02092500,LAUREL TECHNICAL INSTITUTE              ,PA,16146-0000,Proprietary  ,39,58,97,164,245,409
02092502,BUSINESS INSTITUTE OF PENNSYLVANIA      ,PA,16335-0000,Proprietary  ,0,7,7,15,19,34
02104003,HARRIS SCHOOL OF BUSINESS - UPPER DARBY ,PA,19082-2528,Proprietary  ,2,11,13,11,55,66
02107300,PENNSYLVANIA ACADEMY OF FINE ARTS       ,PA,19102-1424,Private      ,23,35,58,294,285,579
02112200,GREAT LAKES INSTITUTE OF TECHNOLOGY     ,PA,16509-0000,Proprietary  ,50,85,135,262,359,621
02114200,JOHNSON COLLEGE                         ,PA,18508-0000,Private      ,49,52,101,449,270,719
02118000,LEVITTOWN BEAUTY ACADEMY LLC            ,PA,19054-1713,Proprietary  ,6,19,25,17,35,52
02119300,PA ACAD OF COSMETOLOGY ARTS & SCI       ,PA,15904-0000,Proprietary  ,19,26,45,45,66,111
02120800,"YORKTOWNE BUSINESS INSTITUTE, INC.      ",PA,17404-0000,Proprietary  ,0,0,0,55,88,143
02127400,YORK TECHNICAL INSTITUTE                ,PA,17402-0000,Proprietary  ,148,204,352,950,1097,2047
02129000,TRIANGLE TECH                           ,PA,15601-0000,Proprietary  ,44,50,94,201,216,417
02129001,TRIANGLE TECH - BUSINESS CAREERS INSTITU,PA,15601-3304,Proprietary  ,4,6,10,13,11,24
02144000,TONI & GUY  HAIRDRESSING ACADEMY        ,PA,18109-1629,Proprietary  ,11,51,62,41,108,149
02151500,CENTRAL SUSQUEHANNA LPN CENTER          ,PA,17837-8818,Public       ,8,11,19,60,126,186
02158300,JUNIATA-MIFFLIN CO AREA VOC TECH        ,PA,17044-0000,Public       ,5,9,14,15,42,57
02161400,NORTHEASTERN HOSP SCH OF NRSG           ,PA,19134-0000,Private      ,3,27,30,37,153,190
02169600,CLEARFIELD CTY CAREER AND TECH CNTR     ,PA,16830-0000,Public       ,12,20,32,49,91,140
02174400,TRIANGLE TECH                           ,PA,15801-0000,Proprietary  ,51,38,89,251,165,416
02178900,ACADEMY OF HAIR DESIGN                  ,PA,18202-1465,Proprietary  ,42,93,135,92,226,318
02183000,ORLEANS TECHNICAL INSTITUTE             ,PA,19111-0000,Private      ,28,102,130,129,321,450
02192800,WALNUT HILL COLLEGE                     ,PA,19104-0000,Proprietary  ,49,78,127,482,352,834
02202300,PITTSBURGH CAREER INSTITUTE             ,PA,15219-1907,Proprietary  ,19,78,97,116,310,426
02203900,ERIE INSTITUTE OF TECHNOLOGY            ,PA,16565-1002,Proprietary  ,31,48,79,159,239,398
02206200,TONI & GUY HAIRDRESSING ACADEMY         ,PA,19002-4527,Proprietary  ,54,74,128,119,158,277
02206300,STROUDSBURG SCHOOL OF COSMETOLOGY       ,PA,18360-0000,Proprietary  ,14,26,40,45,53,98
02212700,LANCASTER SCHOOL OF COSMETOLOGY         ,PA,17602-0000,Proprietary  ,21,56,77,55,122,177
02234200,ACADEMY OF MEDICAL ARTS & BUSINESS      ,PA,17112-0000,Proprietary  ,19,36,55,168,263,431
02251200,SCHUYLKILL COUNTY AREA VOC TECH SCH     ,PA,17931-0000,Public       ,2,4,6,19,52,71
02251202,SCHUYLKILL COUNTY AREA VOC TECH SCH     ,PA,17931-0000,Public       ,1,1,2,2,15,17
02253900,BERKS TECHNICAL INSTITUTE               ,PA,19610-1168,Proprietary  ,186,551,737,774,1660,2434
02269900,PENNSYLVANIA COLLEGE OF ART & DESIGN    ,PA,17603-3528,Private      ,18,13,31,412,103,515
02270500,BUCKS COUNTY SCHOOL OF BEAUTY CULT      ,PA,19053-0000,Proprietary  ,10,12,22,27,41,68
02273400,RECONSTRUCTIONIST RABBINICAL COLLEG     ,PA,19095-0000,Private      ,0,2,2,0,36,36
02276600,HANOVER PUBLIC SCH DIST PRAC NURSG      ,PA,17331-0000,Public       ,0,0,0,0,1,1
02282500,LENAPE SCHOOL OF PRACTICAL NURSING      ,PA,16226-0000,Public       ,8,52,60,56,175,231
02289500,PACE INSTITUTE                          ,PA,19601-0000,Proprietary  ,0,0,0,2,0,2
02289600,CONSOLIDATED SCHOOL OF BUSINESS         ,PA,17404-0000,Proprietary  ,12,45,57,66,146,212
02289700,ACADEMY OF CREATIVE HAIR DESIGN         ,PA,18702-0000,Proprietary  ,30,76,106,81,176,257
02289800,CHI INSTITUTE - FRANKLIN MILLS          ,PA,19154-0000,Proprietary  ,67,146,213,251,564,815
02290400,"ALTOONA BEAUTY SCHOOL, INC              ",PA,16602-0000,Proprietary  ,7,13,20,27,39,66
02292700,LANSDALE SCHOOL OF COSMETOLOGY          ,PA,19446-0000,Proprietary  ,5,7,12,14,21,35
02299300,TRINITY EPISCOPAL SCHOOL MINISTRY       ,PA,15003-0000,Private      ,0,12,12,1,80,81
02301300,PRISM CAREER INSTITUTE                  ,PA,19082-2448,Proprietary  ,5,25,30,43,153,196
02306200,VENANGO COUNTY AREA VOC TECH SCHOOL     ,PA,16301-0000,Public       ,9,15,24,35,55,90
02310800,LANCASTER COUNTY CAREER & TECH CTR      ,PA,17584-0000,Public       ,51,146,197,176,478,654
02323000,BIBLICAL THEOLOGICAL SEMINARY           ,PA,19440-2421,Private      ,0,36,36,1,92,93
02330300,LEBANON CO CAREER & TECHNOLOGY CTR      ,PA,17042-0000,Public       ,19,44,63,72,211,283
02330600,PENNSYLVANIA GUNSMITH SCHOOL            ,PA,15202-0000,Proprietary  ,6,23,29,53,83,136
02350100,WESTERN AREA CAREER & TECHNOLOGY CT     ,PA,15317-0000,Public       ,8,31,39,23,72,95
02350200,INDIANA COUNTY TECH CTR SCH PR NSG      ,PA,15701-1465,Public       ,10,35,45,48,119,167
02353100,NORTHERN TIER CAREER CENTER             ,PA,18848-0000,Public       ,5,13,18,21,53,74
02362300,MERCER COUNTY AREA VOC TECH SCHOOL      ,PA,16137-0000,Public       ,3,8,11,12,40,52
02492600,EASTERN CTR ARTS AND TECH PR NSG        ,PA,19090-0000,Public       ,9,55,64,26,119,145
02495500,ALL-STATE CAREER SCHOOL                 ,PA,19029-0000,Proprietary  ,50,280,330,144,698,842
02529800,WILKES BARRE AREA CAREER AND TECHNICAL C,PA,18705-0000,Public       ,17,40,57,78,195,273
02536600,COMMONWEALTH TECH INSTIT @ HIRAM G      ,PA,15905-0000,Public       ,37,30,67,152,67,219
02544300,BUTLER BEAUTY SCHOOL                    ,PA,16001-0000,Proprietary  ,17,39,56,32,67,99
02546200,LAUREL BUSINESS INSTITUTE               ,PA,15401-0877,Proprietary  ,36,49,85,154,174,328
02550000,CLARION CO AREA VOC-TECH PRAC NRSG      ,PA,16254-4637,Public       ,9,24,33,28,62,90
02554500,HAZLETON AREA CAREER CENTER PRACTICAL NU,PA,18201-0000,Public       ,6,10,16,35,65,100
02557800,ART INSTITUTE OF YORK (THE) - PENNSYLVAN,PA,17402-9012,Proprietary  ,29,25,54,353,160,513
02574800,PENNSYLVANIA INSTITUTE OF TAXIDERMY     ,PA,15931-0000,Proprietary  ,2,5,7,7,15,22
02609500,CAREER TRAINING ACADEMY                 ,PA,15068-6308,Proprietary  ,30,82,112,74,213,287
02609501,CAREER TRAINING ACADEMY                 ,PA,15146-0000,Proprietary  ,3,7,10,21,33,54
02616100,JEAN MADELINE ED CTR FOR COSM           ,PA,19147-1542,Proprietary  ,60,99,159,186,281,467
02617507,EVEREST COLLEGE - EVEREST INSTITUTE - BE,PA,19020-2062,Private      ,2,7,9,13,50,63
03010800,FORTIS INSTITUTE                        ,PA,16506-1013,Proprietary  ,128,335,463,479,1402,1881
03011500,FORTIS INSTITUTE                        ,PA,18702-0000,Proprietary  ,22,49,71,60,148,208
03011600,FORTIS INSTITUTE                        ,PA,18509-2903,Proprietary  ,25,77,102,161,408,569
03029900,CONSOLIDATED SCHOOL OF BUSINESS         ,PA,17603-2389,Proprietary  ,10,19,29,83,104,187
03067000,ANTONELLI MEDICAL & PROF INST           ,PA,19464-9244,Proprietary  ,17,58,75,46,146,192
03072600,DCI CAREER INSTITUTE                    ,PA,15061-2307,Proprietary  ,9,24,33,24,65,89
03081900,YTI CAREER INSTITUTE - ALTOONA          ,PA,16602-4457,Proprietary  ,20,65,85,206,343,549
03090800,LAKE ERIE COLL OF OSTEOPATHIC MED       ,PA,16509-0000,Private      ,5,155,160,65,4331,4396
03098600,CAREER TECH CTR OF LACKAWANNA CNTY      ,PA,18508-0000,Public       ,10,28,38,56,141,197
03101400,FORBES ROAD CAREER & TECHNOLOGY CTR     ,PA,15146-1550,Public       ,5,9,14,22,27,49
03101500,BIDWELL TRAINING CENTER                 ,PA,15233-2233,Private      ,6,28,34,28,95,123
03103300,JNA INSTITUTE OF CULINARY ARTS          ,PA,19146-3119,Proprietary  ,19,42,61,77,158,235
03109100,METROPOLITAN CAREER CENTER              ,PA,19144-0000,Private      ,6,35,41,18,101,119
03110700,AVIATION INSTITUTE OF MAINTENANCE       ,PA,19114-1017,Proprietary  ,61,135,196,169,393,562
03120400,REGIONAL CAREER & TECHNICAL CENTER      ,PA,16509-4699,Public       ,1,4,5,11,15,26
03128400,DELAWARE COUNTY TECHNICAL SCHOOL        ,PA,19008-1928,Public       ,7,35,42,39,143,182
03180400,PENNSYLVANIA HIGHLANDS COMMUNITY COLLEGE,PA,15904-2927,Public       ,128,168,296,936,734,1670
03236400,L T INTERNATIONAL BEAUTY SCHOOL         ,PA,19130-2235,Proprietary  ,11,33,44,32,92,124
03353300,ACADEMY OF VOCAL ARTS                   ,PA,19103-6685,Private      ,11,14,25,44,83,127
03380301,STAR CAREER ACADEMY - STAR PHILADELPHIA ,PA,19114-2204,Proprietary  ,123,369,492,311,1014,1325
03380304,STAR CAREER ACADEMY - STAR NORRISTOWN   ,PA,19403-2422,Proprietary  ,21,60,81,62,198,260
03493302,ALL-STATE CAREER - WEST MIFFLIN CAMPUS  ,PA,15122-0000,Proprietary  ,1,21,22,14,52,66
03535300,HUNTINGDON COUNTY CAREER AND TECHNO     ,PA,17060-0905,Public       ,8,7,15,17,26,43
03561400,SUSQUEHANNA COUNTY CAREER & TECHNOL     ,PA,18816-0100,Public       ,8,19,27,29,50,79
03766300,PENNSYLVANIA SCHOOL OF MUSCLE THERAPY   ,PA,19406-3101,Proprietary  ,15,88,103,46,173,219
03781300,PRINCETON INFORMATION TECHNOLOGY CENTER ,PA,19038-4535,Proprietary  ,5,74,79,20,220,240
03923300,PRECISION MANUFACTURING INSTITUTE       ,PA,16335-8380,Private      ,4,22,26,25,52,77
03948300,HARRISBURG UNIVERSITY OF SCIENCE AND TEC,PA,17101-2116,Private      ,36,53,89,503,239,742
03949300,WON INSTITUTE OF GRADUATE STUDIES       ,PA,19038-4535,Private      ,0,30,30,1,56,57
03950500,NORTHWEST REGIONAL TECHNOLOGY INSTITUTE ,PA,16508-2820,Proprietary  ,3,31,34,17,58,75
03952300,NATIONAL MASSAGE THERAPY INSTITUTE      ,PA,19116-3965,Proprietary  ,0,0,0,18,52,70
04024300,EDUCATION AND TECHNOLOGY INSTITUTE      ,PA,15601-9214,Private      ,2,7,9,10,18,28
04041300,BERKS CAREER & TECHNOLOGY CENTER        ,PA,19533-9112,Public       ,10,17,27,30,56,86
04118000,BYZANTINE CATHOLIC SEMINARY OF SAINTS CY,PA,15214-2229,Private      ,0,1,1,1,8,9
04124600,PROFESSIONAL ACADEMY OF COSMETOLOGY     ,PA,19401-0000,Proprietary  ,1,2,3,2,9,11
04127500,CDE CAREER INSTITUTE                    ,PA,18372-9034,Proprietary  ,5,34,39,38,97,135
04145800,PULSE BEAUTY ACADEMY A PAUL MITCHELL PAR,PA,19335-0000,Proprietary  ,23,22,45,51,55,106
04149800,SOMERSET COUNTY TECHNOLOGY CENTER       ,PA,15501-1444,Public       ,3,18,21,29,84,113
04151700,BELLA CAPELLI ACADEMY                   ,PA,15146-2388,Proprietary  ,21,23,44,69,50,119
04151701,BELLA CAPELLI ACADEMY -                 ,PA,15205-2388,Proprietary  ,23,33,56,87,98,185
04155100,INSTITUTE OF MEDICAL CAREERS            ,PA,15235-3718,Proprietary  ,8,64,72,45,169,214
04158000,METRO BEAUTY ACADEMY                    ,PA,18106-9693,Proprietary  ,21,33,54,92,131,223
04164900,BARONE BEAUTY ACADEMY                   ,PA,17701-5316,Proprietary  ,4,8,12,16,32,48
04167200,COMMONWEALTH MEDICAL COLLEGE (THE)      ,PA,18509-3240,Private      ,2,41,43,12,747,759
04175900,LEWISTOWN HOSPITAL SCHOOL OF NURSING    ,PA,17044-1167,Private      ,2,6,8,15,42,57
04215500,CHAMP'S BARBER SCHOOL                   ,PA,17603-3809,Proprietary  ,1,12,13,9,32,41
04221300,PHILADELPHIA TECHNICIAN TRAINING        ,PA,19138-1324,Private      ,14,107,121,66,345,411
04224600,BARBER SCHOOL OF PITTSBURGH             ,PA,15220-5537,Proprietary  ,7,29,36,30,95,125
04226300,DIVINE CROWN ACADEMY OF COSMETOLOGY     ,PA,17104-2103,Proprietary  ,11,25,36,23,60,83
04232000,STUDIO INCAMMINATI                      ,PA,19107-1105,Private      ,1,2,3,3,10,13
04236800,FOUNTAIN OF YOUTH ACADEMY OF COSMETOLOGY,PA,16046-2430,Proprietary  ,1,2,3,4,6,10
00267813,BRYANT & STRATTON COLLEGE - MIL DOWNTOWN,WI,53203-2608,Proprietary  ,145,398,543,596,2055,2651
00383200,ALVERNO COLLEGE                         ,WI,53234-3922,Private      ,124,340,464,1356,2027,3383
00383500,BELOIT COLLEGE                          ,WI,53511-5595,Private      ,29,22,51,2320,139,2459
00383700,CARDINAL STRITCH UNIVERSITY             ,WI,53217-9884,Private      ,99,533,632,1212,2499,3711
00383800,CARROLL UNIVERSITY                      ,WI,53186-5593,Private      ,142,143,285,3889,876,4765
00383900,CARTHAGE COLLEGE                        ,WI,53141-0000,Private      ,194,136,330,5127,742,5869
00384000,WESTERN TECHNICAL COLLEGE               ,WI,54601-0908,Public       ,494,704,1198,1926,1986,3912
00384200,CONCORDIA UNIVERSITY WISCONSIN          ,WI,53097-2402,Private      ,237,1041,1278,3475,4261,7736
00384800,EDGEWOOD COLLEGE                        ,WI,53711-1958,Private      ,47,200,247,1757,1086,2843
00385000,SILVER LAKE COLLEGE                     ,WI,54220-9319,Private      ,31,74,105,221,284,505
00385400,LAKELAND COLLEGE                        ,WI,53082-0000,Private      ,95,475,570,1191,1734,2925
00385600,LAWRENCE UNIVERSITY                     ,WI,54912-0599,Private      ,59,16,75,2397,115,2512
00386100,MARIAN UNIVERSITY                       ,WI,54935-4699,Private      ,108,184,292,1511,867,2378
00386300,MARQUETTE UNIVERSITY                    ,WI,53201-1881,Private      ,200,354,554,15524,3594,19118
00386600,MILWAUKEE AREA TECH COLLEGE             ,WI,53233-1443,Public       ,1751,4244,5995,6074,13466,19540
00386800,MILWAUKEE SCHOOL OF ENGINEERING         ,WI,53202-3109,Private      ,139,158,297,3053,831,3884
00386900,MOUNT MARY UNIVERSITY                   ,WI,53222-4597,Private      ,70,164,234,929,1119,2048
00387400,NASHOTAH HOUSE                          ,WI,53058-0000,Private      ,0,1,1,0,40,40
00387500,NORTHLAND COLLEGE                       ,WI,54806-3999,Private      ,52,20,72,751,113,864
00388400,RIPON COLLEGE                           ,WI,54971-0248,Private      ,17,10,27,1370,78,1448
00389200,ST. NORBERT COLLEGE                     ,WI,54115-2099,Private      ,85,25,110,3091,128,3219
00389500,UNIVERSITY OF WISCONSIN-MADISON         ,WI,53715-1382,Public       ,1682,1120,2802,26005,8649,34654
00389600,UNIVERSITY OF WISCONSIN-MILWAUKEE       ,WI,53201-3165,Public       ,1857,2214,4071,17696,11817,29513
00389700,UNIVERSITY OF WISCONSIN COLLEGES        ,WI,53708-8680,Public       ,338,450,788,4228,2084,6312
00389701,UNIVERSITY OF WISCONSIN-BARABOO         ,WI,53913-1098,Public       ,72,62,134,399,177,576
00389702,UNIVERSITY OF WISCONSIN-BARRON          ,WI,54868-2497,Public       ,57,59,116,382,187,569
00389703,UNIVERSITY OF WISCONSIN-FOND DU LAC     ,WI,54935-2998,Public       ,76,68,144,461,214,675
00389704,UNIVERSITY OF WISCONSIN-FOX VALLEY      ,WI,54952-1297,Public       ,215,126,341,1071,402,1473
00389705,UNIVERSITY OF WISCONSIN-MANITOWOC       ,WI,54220-6699,Public       ,68,50,118,303,133,436
00389706,UNIVERSITY OF WISCONSIN-MARATHON        ,WI,54401-5396,Public       ,92,84,176,654,265,919
00389707,UNIVERSITY OF WISCONSIN-MARINETTE       ,WI,54143-4299,Public       ,31,35,66,294,124,418
00389708,UNIVERSITY OF WISCONSIN-MARSHFIELD      ,WI,54449-3310,Public       ,53,48,101,303,150,453
00389709,UNIVERSITY OF WISCONSIN-RICHLAND        ,WI,53581-1399,Public       ,42,28,70,245,107,352
00389710,UNIVERSITY OF WISCONSIN COLLEGES - ROCK ,WI,53546-5699,Public       ,171,133,304,744,495,1239
00389711,UNIVERSITY OF WISCONSIN-SHEBOYGAN       ,WI,53081-4789,Public       ,92,82,174,467,271,738
00389712,UNIVERSITY OF WISCONSIN-WASHINGTON      ,WI,53095-3699,Public       ,120,57,177,576,218,794
00389713,UNIVERSITY OF WISCONSIN-WAUKESHA        ,WI,53188-2799,Public       ,307,167,474,1685,609,2294
00389900,UNIVERSITY OF WISCONSIN-GREEN BAY       ,WI,54311-7001,Public       ,413,518,931,4290,2490,6780
00391100,VITERBO UNIVERSITY                      ,WI,54601-4777,Private      ,80,264,344,1675,1125,2800
00391500,UNIVERSITY OF WISCONSIN-STOUT           ,WI,54751-0790,Public       ,863,532,1395,6396,2066,8462
00391700,UNIVERSITY OF WISCONSIN-EAU CLAIRE      ,WI,54702-4004,Public       ,928,413,1341,9093,1703,10796
00391900,UNIVERSITY OF WISCONSIN-LA CROSSE       ,WI,54601-3742,Public       ,688,282,970,9094,1587,10681
00392000,UNIVERSITY OF WISCONSIN-OSHKOSH         ,WI,54901-8604,Public       ,1043,709,1752,8754,2970,11724
00392100,UNIVERSITY OF WISCONSIN-PLATTEVILLE     ,WI,53818-3099,Public       ,654,411,1065,7393,1572,8965
00392300,UNIVERSITY OF WISCONSIN-RIVER FALLS     ,WI,54022-5013,Public       ,675,406,1081,4613,1284,5897
00392400,UNIVERSITY OF WISCONSIN-STEVENS POINT   ,WI,54481-3897,Public       ,772,360,1132,8155,1862,10017
00392500,UNIVERSITY OF WISCONSIN-SUPERIOR        ,WI,54880-2898,Public       ,228,313,541,1514,1259,2773
00392600,UNIVERSITY OF WISCONSIN-WHITEWATER      ,WI,53190-1792,Public       ,1011,558,1569,10379,2563,12942
00400700,MADISON AREA TECHNICAL COLLEGE          ,WI,53704-2599,Public       ,1142,2023,3165,4696,6609,11305
00501500,UNIVERSITY OF WISCONSIN-PARKSIDE        ,WI,53141-2000,Public       ,602,536,1138,3738,2141,5879
00529400,WAUKESHA COUNTY TECHNICAL COLLEGE       ,WI,53072-4696,Public       ,354,791,1145,1470,2806,4276
00530100,NORTHEAST WISCONSIN TECHNICAL COLLEGE   ,WI,54307-9042,Public       ,835,1439,2274,2977,4339,7316
00530400,CHIPPEWA VALLEY TECHNICAL COLLEGE       ,WI,54701-6162,Public       ,422,650,1072,2140,2695,4835
00538000,MID-STATE TECHNICAL COLLEGE             ,WI,54494-5512,Public       ,210,457,667,827,1607,2434
00538400,NICOLET AREA TECHNICAL COLLEGE          ,WI,54501-0000,Public       ,120,192,312,431,576,1007
00538700,NORTHCENTRAL TECHNICAL COLLEGE          ,WI,54401-1899,Public       ,372,768,1140,1410,2483,3893
00538900,GATEWAY TECHNICAL COLLEGE               ,WI,53144-1690,Public       ,635,1258,1893,2307,5502,7809
00539000,BLACKHAWK TECHNICAL COLLEGE             ,WI,53547-5009,Public       ,200,494,694,923,2065,2988
00663900,BELLIN COLLEGE                          ,WI,54305-0000,Private      ,23,47,70,299,204,503
00732934,ITT TECHNICAL INSTITUTE                 ,WI,53220-4612,Proprietary  ,65,426,491,180,1081,1261
00766900,SOUTHWEST WISCONSIN TECH COLLEGE        ,WI,53809-0000,Public       ,127,215,342,714,788,1502
00821700,PAUL MITCHELL THE SCHOOL GREEN BAY      ,WI,54324-0257,Proprietary  ,16,32,48,72,92,164
00869405,RASMUSSEN COLLEGE - WAUSAU              ,WI,54401-7804,Proprietary  ,17,111,128,76,483,559
00869414,RASMUSSEN COLLEGE - GREEN BAY           ,WI,54303-2349,Proprietary  ,23,140,163,121,604,725
00869419,RASMUSSEN COLLEGE - APPLETON            ,WI,54915-7305,Proprietary  ,17,93,110,60,467,527
00919400,LAKESHORE TECHNICAL COLLEGE             ,WI,53015-1412,Public       ,165,332,497,631,1266,1897
00925600,MORAINE PARK TECHNICAL COLLEGE          ,WI,54936-0000,Public       ,144,371,515,933,2067,3000
00941900,STATE CLG OF BEAUTY CULT-WAUSAU         ,WI,54403-4667,Proprietary  ,7,10,17,27,34,61
00962100,HERZING UNIVERSITY                      ,WI,53718-4236,Proprietary  ,306,2712,3018,973,9952,10925
00974400,FOX VALLEY TECHNICAL COLLEGE            ,WI,54913-0000,Public       ,649,1194,1843,2793,4319,7112
01091300,MADISON MEDIA INSTITUTE                 ,WI,53718-6787,Proprietary  ,93,111,204,437,370,807
01148400,ADVANCED INSTITUTE OF HAIR DESIGN       ,WI,53225-0000,Proprietary  ,43,53,96,155,152,307
01182400,WISCONSIN INDIANHEAD TECH CLG WITC      ,WI,54871-9300,Public       ,220,411,631,960,1694,2654
02077100,MILWAUKEE INST OF ART & DESIGN          ,WI,53202-0000,Private      ,77,57,134,941,289,1230
02078000,SACRED HEART SCHOOL OF THEOLOGY         ,WI,53130-0000,Private      ,0,1,1,0,3,3
02136600,WISCONSIN LUTHERAN COLLEGE              ,WI,53226-0000,Private      ,60,101,161,1196,358,1554
02271300,WI SCH OF PROFESSIONAL PSYCHOLOGY       ,WI,53225-0000,Private      ,6,47,53,25,148,173
02317200,MARANATHA BAPTIST UNIVERSITY            ,WI,53094-7638,Private      ,147,47,194,736,160,896
02453500,MEDICAL COLLEGE OF WISCONSIN            ,WI,53226-0000,Private      ,18,47,65,94,1114,1208
02494300,GILL-TECH ACADEMY OF HAIR DESIGN        ,WI,54911-0000,Proprietary  ,6,14,20,20,39,59
02532200,LAC COURTE OREILLES OJIBWA CMTY CLG     ,WI,54843-0000,Public       ,25,182,207,47,319,366
03061200,MIDWEST COLLEGE OF ORIENTAL MEDICINE    ,WI,53403-9747,Proprietary  ,7,54,61,18,189,207
03125100,COLLEGE OF MENOMINEE NATION             ,WI,54135-0000,Private      ,32,116,148,77,292,369
03125102,COLLEGE OF  THE MENOMINEE NATION - GREEN,WI,54304-4964,Private      ,9,44,53,33,152,185
03220300,"SALON PROFESSIONAL ACADEMY, THE         ",WI,54701-7633,Proprietary  ,8,24,32,29,54,83
03309300,MONTESSORI INSTITUTE OF MILWAUKEE       ,WI,53207-0000,Private      ,3,10,13,9,34,43
03808300,INSTITUTE OF BEAUTY AND WELLNESS (AIM)  ,WI,53202-5715,Proprietary  ,41,80,121,177,241,418
03822300,PAUL MITCHELL THE SCHOOL - MONROE       ,WI,53566-0000,Proprietary  ,6,12,18,34,46,80
03872500,NORTHLAND INTERNATIONAL UNIVERSITY      ,WI,54119-9285,Private      ,1,0,1,44,9,53
03925300,BLUE SKY SCHOOL OF PROFESSIONAL MASSAGE ,WI,53024-9699,Private      ,1,1,2,2,5,7
03925301,BLUE SKY SCHOOL OF PROFESSIONAL MASSAGE ,WI,54115-7407,Private      ,1,3,4,4,9,13
03925303,BLUE SKY SCHOOL OF PROFESSIONAL MASSAGE ,WI,53713-2366,Private      ,1,11,12,9,30,39
04117400,MILWAUKEE CAREER COLLEGE                ,WI,53222-4305,Proprietary  ,82,120,202,240,387,627
04118600,ACADEMY OF COSMETOLOGY                  ,WI,53548-3307,Proprietary  ,10,23,33,41,65,106
04124800,VISIONS IN HAIR DESIGN INSTITUTE OF COSM,WI,53210-1120,Proprietary  ,0,0,0,0,1,1
04132600,WISCONSIN ACADEMY (THE)                 ,WI,54157-1726,Proprietary  ,8,12,20,30,33,63
04137900,BRENSTEN EDUCATION                      ,WI,53186-0000,Proprietary  ,2,32,34,24,244,268
04138200,SALON PROFESSIONAL ACADEMY (THE)        ,WI,54914-3921,Proprietary  ,14,24,38,44,57,101
04157700,SALON PROFESSIONAL ACADEMY (THE)        ,WI,54650-8699,Proprietary  ,10,29,39,46,65,111
04159400,COLUMBIA COLLEGE OF NURSING             ,WI,53211-2952,Private      ,20,37,57,206,243,449
04165300,ACADEMY WAUKESHA (THE)                  ,WI,53072-5524,Proprietary  ,21,38,59,78,101,179
04179200,ADVANCED COLLEGE OF COSMETOLOGY         ,WI,53963-0000,Proprietary  ,9,4,13,27,19,46
04182100,FIRST CLASS COSMETOLOGY SCHOOL          ,WI,52511-0000,Proprietary  ,7,33,40,36,72,108
04183600,SALON PROFESSIONAL ACADEMY OF KENOSHA (T,WI,53142-4950,Proprietary  ,8,22,30,54,95,149
04193800,SHEPHERDS COLLEGE                       ,WI,53182-1527,Private      ,4,5,9,26,22,48
04202800,PANACHE ACADEMY OF BEAUTY               ,WI,53913-2596,Proprietary  ,5,15,20,20,51,71
04219300,EAST-WEST HEALING ARTS INSTITUTE        ,WI,53719-1133,Proprietary  ,7,22,29,21,78,99
04231400,BELLA ACADEMY OF COSMETOLOGY            ,WI,54901-4738,Proprietary  ,2,12,14,18,30,48
04237400,WRIGHT GRADUATE UNIVERSITY FOR THE REALI,WI,53121-2556,Private      ,4,11,15,14,32,46
00290500,NORTH CAROLINA A&T STATE UNIV           ,NC,27411-0001,Public       ,1174,1144,2318,15377,6447,21824
00290600,APPALACHIAN STATE UNIVERSITY            ,NC,28608-2059,Public       ,940,678,1618,17425,4822,22247
00290700,UNIVERSITY OF NC AT ASHEVILLE           ,NC,28804-3299,Public       ,291,290,581,4573,1739,6312
00290800,BARTON COLLEGE                          ,NC,27893-3104,Private      ,131,171,302,1498,750,2248
00291000,BELMONT ABBEY COLLEGE                   ,NC,28012-1802,Private      ,120,193,313,1509,865,2374
00291100,BENNETT COLLEGE                         ,NC,27401-3239,Private      ,72,66,138,954,385,1339
00291200,BREVARD COLLEGE                         ,NC,28712-3306,Private      ,106,41,147,1284,191,1475
00291300,CAMPBELL UNIVERSITY                     ,NC,27506-0036,Private      ,450,906,1356,5396,4514,9910
00291400,CATAWBA COLLEGE                         ,NC,28144-2488,Private      ,112,124,236,1928,595,2523
00291500,CENTRAL PIEDMONT COMMUNITY COLLEGE      ,NC,28204-2297,Public       ,2711,4461,7172,10415,15130,25545
00291600,CHOWAN UNIVERSITY                       ,NC,27855-1850,Private      ,153,76,229,2392,454,2846
00291700,COLLEGE OF THE ALBEMARLE                ,NC,27909-2327,Public       ,209,388,597,839,1349,2188
00291800,DAVIDSON COLLEGE                        ,NC,28035-7157,Private      ,61,56,117,3553,245,3798
00291900,DAVIDSON COUNTY COMMUNITY COLLEGE       ,NC,27293-0000,Public       ,271,802,1073,1694,3764,5458
00292000,DUKE UNIVERSITY                         ,NC,27708-0397,Private      ,435,255,690,17399,2660,20059
00292001,DUKE UNIV - SCHOOL OF MEDICINE          ,NC,27710-0000,Private      ,35,89,124,235,960,1195
00292002,DUKE UNIV - SCHOOL OF LAW               ,NC,27708-0000,Private      ,7,67,74,71,1849,1920
00292003,DUKE UNIV - GRAD SCH ARTS & SCIENCE     ,NC,27708-0000,Private      ,19,82,101,208,656,864
00292004,DUKE UNIV - FUQUA SCH OF BUSINESS       ,NC,27708-0000,Private      ,21,80,101,178,921,1099
00292005,DUKE UNIV/NICHOLAS SCH OF ENVIRON.      ,NC,27708-0000,Private      ,4,14,18,47,326,373
00292006,DUKE UNIV - DIVINITY SCHOOL             ,NC,27708-0000,Private      ,36,104,140,791,804,1595
00292007,DUKE UNIV - SCHOOL OF NURSING           ,NC,27710-0000,Private      ,32,233,265,189,1470,1659
00292010,DUKE UNIVERSITY - SCHOOL OF PUBLIC POLIC,NC,27708-0239,Private      ,5,14,19,33,212,245
00292300,EAST CAROLINA UNIVERSITY                ,NC,27858-1818,Public       ,1843,1975,3818,25091,12125,37216
00292600,ELIZABETH CITY STATE UNIVERSITY         ,NC,27909-7806,Public       ,212,229,441,2234,1067,3301
00292700,ELON UNIVERSITY                         ,NC,27244-2010,Private      ,246,174,420,7333,1185,8518
00292800,FAYETTEVILLE STATE UNIVERSITY           ,NC,28301-4298,Public       ,618,1732,2350,5211,7061,12272
00292900,GARDNER-WEBB UNIVERSITY                 ,NC,28017-0000,Private      ,277,865,1142,2776,3226,6002
00293000,GREENSBORO COLLEGE                      ,NC,27401-1875,Private      ,130,200,330,1688,1020,2708
00293100,GUILFORD COLLEGE                        ,NC,27410-4171,Private      ,225,504,729,2621,2129,4750
00293300,HIGH POINT UNIVERSITY                   ,NC,27262-4221,Private      ,258,162,420,7063,722,7785
00293400,ISOTHERMAL COMMUNITY COLLEGE            ,NC,28160-0804,Public       ,162,349,511,851,1094,1945
00293500,LAUREL UNIVERSITY                       ,NC,27265-3197,Private      ,21,47,68,92,184,276
00293600,JOHNSON C SMITH UNIVERSITY              ,NC,28216-5398,Private      ,261,332,593,2571,1623,4194
00293700,KING'S COLLEGE-CHARLOTTE                ,NC,28204-2435,Proprietary  ,83,137,220,658,554,1212
00293900,LEES MCRAE COLLEGE                      ,NC,28604-0000,Private      ,86,92,178,1168,516,1684
00294000,LENOIR COMMUNITY COLLEGE                ,NC,28502-0188,Public       ,297,709,1006,996,2141,3137
00294100,LENOIR-RHYNE UNIVERSITY                 ,NC,28603-0000,Private      ,205,182,387,2964,1187,4151
00294200,LIVINGSTONE COLLEGE                     ,NC,28144-5298,Private      ,286,172,458,2050,666,2716
00294300,LOUISBURG COLLEGE                       ,NC,27549-2398,Private      ,203,44,247,1181,226,1407
00294400,MARS HILL COLLEGE                       ,NC,28754-0000,Private      ,166,83,249,2172,475,2647
00294500,MEREDITH COLLEGE                        ,NC,27607-5298,Private      ,134,157,291,2166,961,3127
00294600,METHODIST UNIVERSITY                    ,NC,28311-1420,Private      ,270,462,732,3055,1829,4884
00294700,MITCHELL COMMUNITY COLLEGE              ,NC,28677-5264,Public       ,269,437,706,1134,1717,2851
00294800,MONTREAT COLLEGE                        ,NC,28757-1267,Private      ,69,128,197,610,643,1253
00294900,UNIVERSITY OF MOUNT OLIVE               ,NC,28365-1299,Private      ,143,946,1089,1488,3492,4980
00295000,NORTH CAROLINA CENTRAL UNIVERSITY       ,NC,27707-3198,Public       ,768,1129,1897,10115,7155,17270
00295100,NORTH CAROLINA WESLEYAN COLLEGE         ,NC,27804-8699,Private      ,112,417,529,1582,1861,3443
00295300,WILLIAM PEACE UNIVERSITY                ,NC,27604-1194,Private      ,154,169,323,1441,723,2164
00295400,UNIV OF NORTH CAROLINA AT PEMBROKE      ,NC,28372-1510,Public       ,670,946,1616,7134,4134,11268
00295500,PFEIFFER UNIVERSITY                     ,NC,28109-0000,Private      ,99,332,431,989,1147,2136
00295600,PIEDMONT INTERNATIONAL UNIVERSITY       ,NC,27101-5025,Private      ,37,95,132,172,386,558
00295700,QUEENS UNIVERSITY OF CHARLOTTE          ,NC,28274-0001,Private      ,238,512,750,2302,1978,4280
00295800,ROCKINGHAM COMMUNITY COLLEGE            ,NC,27375-0000,Public       ,141,271,412,774,1187,1961
00296000,SALEM COLLEGE                           ,NC,27108-0000,Private      ,63,197,260,1004,728,1732
00296100,SANDHILLS COMMUNITY COLLEGE             ,NC,28374-8283,Public       ,458,824,1282,1580,2612,4192
00296200,SHAW UNIVERSITY                         ,NC,27601-2393,Private      ,294,383,677,2534,1745,4279
00296300,SOUTHEASTERN BAPTIST THEOL SEMINARY     ,NC,27588-0000,Private      ,17,42,59,150,244,394
00296400,SOUTHEASTERN COMMUNITY COLLEGE          ,NC,28472-5422,Public       ,229,376,605,664,954,1618
00296800,ST AUGUSTINES COLLEGE                   ,NC,27610-2298,Private      ,178,157,335,1465,665,2130
00297000,SURRY COMMUNITY COLLEGE                 ,NC,27017-0304,Public       ,188,383,571,1260,1454,2714
00297200,NORTH CAROLINA STATE UNIV-RALEIGH       ,NC,27695-7001,Public       ,1033,1367,2400,28012,10221,38233
00297300,GASTON COLLEGE                          ,NC,28034-1499,Public       ,574,1085,1659,2223,3772,5995
00297400,UNIVERSITY OF N C-CHAPEL HILL           ,NC,27514-0000,Public       ,947,1427,2374,26773,12228,39001
00297500,UNIVERSITY OF NC AT CHARLOTTE           ,NC,28223-0001,Public       ,1893,2261,4154,26731,13175,39906
00297600,UNIVERSITY OF N C - GREENSBORO          ,NC,27412-0001,Public       ,1120,1527,2647,17328,10274,27602
00297800,WAKE FOREST UNIV - UNDERGRADUATE        ,NC,27109-7246,Private      ,189,88,277,7960,464,8424
00297801,WAKE FOREST UNIV - SCH OF MEDICINE      ,NC,27157-1090,Private      ,18,51,69,114,1224,1338
00297803,WAKE FOREST GRAD SCHOOLS OF BUSINESS    ,NC,27109-7659,Private      ,7,115,122,64,662,726
00297805,WAKE FOREST UNIV - SCH OF LAW           ,NC,27109-7206,Private      ,3,57,60,36,1133,1169
00297806,WAKE FOREST UNIV - GRAD A&S/DIVINITY    ,NC,27109-7246,Private      ,6,138,144,42,736,778
00297900,WARREN WILSON COLLEGE                   ,NC,28815-0000,Private      ,69,75,144,1142,354,1496
00298000,WAYNE COMMUNITY COLLEGE                 ,NC,27533-0000,Public       ,361,836,1197,1303,2511,3814
00298100,WESTERN CAROLINA UNIVERSITY             ,NC,28723-9731,Public       ,610,608,1218,10484,4061,14545
00298200,WESTERN PIEDMONT COMMUNITY COLLEGE      ,NC,28655-4504,Public       ,269,373,642,1011,1311,2322
00298300,WILKES COMMUNITY COLLEGE                ,NC,28697-2100,Public       ,198,286,484,1057,1186,2243
00298400,UNIVERSITY OF N C-WILMINGTON            ,NC,28403-3297,Public       ,1016,1190,2206,15126,6122,21248
00298500,WINGATE UNIVERSITY                      ,NC,28174-0159,Private      ,309,220,529,4668,1455,6123
00298600,WINSTON-SALEM STATE UNIVERSITY          ,NC,27102-0000,Public       ,425,733,1158,7476,4512,11988
00398100,UNC SCHOOL OF THE ARTS                  ,NC,27127-2188,Public       ,104,76,180,1521,473,1994
00403300,ASHEVILLE BUNCOMBE TECH CMTY CLG        ,NC,28801-4897,Public       ,665,1318,1983,2347,4288,6635
00406200,PITT COMMUNITY COLLEGE                  ,NC,28590-0000,Public       ,884,1747,2631,4251,6909,11160
00483500,CALDWELL COMMUNITY CLG & TECH INST      ,NC,28638-2626,Public       ,267,460,727,1356,1866,3222
00483800,GUILFORD TECHNICAL COMMUNITY CLG        ,NC,27282-0309,Public       ,1065,2299,3364,5727,10882,16609
00484400,WAKE TECHNICAL COMMUNITY COLLEGE        ,NC,27603-5696,Public       ,1405,3099,4504,9776,16173,25949
00484500,WILSON COMMUNITY COLLEGE                ,NC,27893-3310,Public       ,190,625,815,641,1771,2412
00499201,MILLER-MOTTE TECHNICAL COLLEGE - MILLER-,NC,27511-9209,Proprietary  ,36,202,238,81,515,596
00499202,MILLER-MOTTE TECHNICAL COLLEGE - MILLER-,NC,27604-6072,Proprietary  ,94,386,480,285,1146,1431
00499203,MILLER-MOTTE TECHNICAL COLLEGE - FAYETTE,NC,28311-7651,Proprietary  ,97,651,748,244,1655,1899
00499205,MILLER-MOTTE TECHNICAL COLLEGE - MILLER-,NC,28540-5901,Proprietary  ,45,328,373,122,953,1075
00531600,COASTAL CAROLINA COMMUNITY COLLEGE      ,NC,28546-6816,Public       ,416,1575,1991,1527,4398,5925
00531700,FORSYTH TECHNICAL COMMUNITY COLLEGE     ,NC,27103-5197,Public       ,737,1755,2492,3703,7139,10842
00531800,CATAWBA VALLEY COMMUNITY COLLEGE        ,NC,28602-8302,Public       ,440,712,1152,2324,2904,5228
00532000,CAPE FEAR COMMUNITY COLLEGE             ,NC,28401-3910,Public       ,1149,1765,2914,4189,5510,9699
00544700,RANDOLPH COMMUNITY COLLEGE              ,NC,27204-1009,Public       ,233,456,689,1165,1822,2987
00544800,DURHAM TECHNICAL CMNTY COLLEGE          ,NC,27703-5023,Public       ,525,1401,1926,2066,5173,7239
00544900,CENTRAL CAROLINA COMMUNITY COLLEGE      ,NC,27330-9000,Public       ,434,1030,1464,1672,3537,5209
00546300,ALAMANCE COMMUNITY COLLEGE              ,NC,27253-0000,Public       ,457,875,1332,1734,3080,4814
00546400,RICHMOND COMMUNITY COLLEGE              ,NC,28345-4522,Public       ,287,648,935,811,1736,2547
00575400,ROWAN-CABARRUS COMMUNITY COLLEGE        ,NC,28146-8357,Public       ,750,1360,2110,2186,4188,6374
00647700,CABARRUS COLLEGE OF HEALTH SCIENCES     ,NC,28025-0000,Private      ,57,159,216,362,728,1090
00647800,MERCY HOSP SCH OF NURSING               ,NC,28207-0000,Public       ,35,114,149,126,432,558
00648300,WATTS SCHOOL OF NURSING                 ,NC,27704-0000,Private      ,19,62,81,86,296,382
00679900,CRAVEN COMMUNITY COLLEGE                ,NC,28562-0000,Public       ,269,877,1146,952,2861,3813
00703100,PAMLICO COMMUNITY COLLEGE               ,NC,28529-0000,Public       ,28,125,153,68,318,386
00764000,FAYETTEVILLE TECHNICAL CMTY COLLEGE     ,NC,28303-0236,Public       ,1103,3780,4883,3652,12503,16155
00768700,JAMES SPRUNT COMMUNITY COLLEGE          ,NC,28349-0398,Public       ,101,239,340,404,890,1294
00781400,BROOKSTONE COLLEGE OF BUSINESS          ,NC,28262-1294,Proprietary  ,13,51,64,77,331,408
00781401,BROOKSTONE COLLEGE OF BUSINESS          ,NC,27409-0000,Proprietary  ,3,24,27,36,198,234
00789200,SAMPSON COMMUNITY COLLEGE               ,NC,28328-0000,Public       ,146,268,414,563,1001,1564
00798500,SOUTH PIEDMONT COMMUNITY COLLEGE        ,NC,28135-9703,Public       ,230,450,680,766,1433,2199
00798600,HALIFAX COMMUNITY COLLEGE               ,NC,27890-0089,Public       ,160,302,462,504,854,1358
00798700,BLADEN COMMUNITY COLLEGE                ,NC,28332-0266,Public       ,219,445,664,512,1146,1658
00798800,MARTIN COMMUNITY COLLEGE                ,NC,27892-8307,Public       ,52,175,227,221,533,754
00808100,CARTERET COMMUNITY COLLEGE              ,NC,28557-2989,Public       ,164,314,478,570,1227,1797
00808200,CLEVELAND COMMUNITY COLLEGE             ,NC,28150-0000,Public       ,253,638,891,840,1892,2732
00808300,HAYWOOD COMMUNITY COLLEGE               ,NC,28721-0000,Public       ,126,330,456,487,1154,1641
00808500,MCDOWELL TECHNICAL COMMUNITY CLG        ,NC,28752-8728,Public       ,106,238,344,306,630,936
00808700,MONTGOMERY COMMUNITY COLLEGE            ,NC,27371-0787,Public       ,85,177,262,291,582,873
00846600,SOUTHWESTERN COMMUNITY COLLEGE          ,NC,28779-8581,Public       ,131,296,427,806,1349,2155
00855700,NASH COMMUNITY COLLEGE                  ,NC,27804-0488,Public       ,445,966,1411,1357,2868,4225
00855800,BEAUFORT COUNTY COMMUNITY COLLEGE       ,NC,27889-7889,Public       ,120,346,466,586,1402,1988
00861200,ROBESON COMMUNITY COLLEGE               ,NC,28359-2151,Public       ,351,710,1061,1070,2206,3276
00861300,ROANOKE-CHOWAN COMMUNITY COLLEGE        ,NC,27910-9522,Public       ,83,239,322,274,601,875
00885500,EDGECOMBE COMMUNITY COLLEGE             ,NC,27886-9399,Public       ,309,1013,1322,758,2883,3641
00933600,JOHNSTON COMMUNITY COLLEGE              ,NC,27577-0000,Public       ,319,675,994,1539,2645,4184
00943000,TRI-COUNTY COMMUNITY COLLEGE            ,NC,28906-7919,Public       ,86,213,299,285,604,889
00964600,PIEDMONT COMMUNITY COLLEGE              ,NC,27573-1197,Public       ,125,296,421,436,837,1273
00968400,BLUE RIDGE COMMUNITY COLLEGE            ,NC,28731-9624,Public       ,211,372,583,689,1257,1946
00974701,GORDON-CONWELL THEO SEM - CHARLOTTE     ,NC,28273-0000,Private      ,2,56,58,7,210,217
00990300,VANCE-GRANVILLE CMTY COLLEGE            ,NC,27536-0917,Public       ,367,829,1196,1033,2264,3297
01019804,ECPI UNIVERSITY - GREENSBORO            ,NC,27409-9048,Proprietary  ,38,210,248,208,785,993
01019805,ECPI UNIVERSITY - CHARLOTTE             ,NC,28208-5886,Proprietary  ,96,421,517,320,1527,1847
01019810,ECPI UNIVERSITY - RALEIGH               ,NC,27613-7387,Proprietary  ,88,386,474,310,1240,1550
01019812,ECPI UNIVERSITY - CONCORD               ,NC,28262-0000,Proprietary  ,29,127,156,110,452,562
01026400,SOUTH COLLEGE                           ,NC,28803-3152,Proprietary  ,46,240,286,150,651,801
01119400,STANLY COMMUNITY COLLEGE                ,NC,28001-7458,Public       ,211,636,847,755,1962,2717
01119700,MAYLAND COMMUNITY COLLEGE               ,NC,28777-2777,Public       ,90,125,215,359,406,765
01179900,PAUL MITCHELL THE SCHOOL FAYETTEVILLE   ,NC,28303-5364,Proprietary  ,34,111,145,106,399,505
01192600,LEON'S BEAUTY SCHOOL                    ,NC,27403-2812,Proprietary  ,42,72,114,134,266,400
01303918,SOUTH UNIVERSITY - THE ART INSTITUTE OF ,NC,28217-4536,Proprietary  ,277,296,573,1117,982,2099
02056500,MITCHELL'S HAIR STYLING ACADEMY         ,NC,27893-0000,Proprietary  ,4,27,31,28,74,102
02056501,MITCHELL'S HAIR STYLING ACADEMY - MITCHE,NC,27606-3326,Proprietary  ,17,48,65,57,172,229
02158414,HARRISON COLLEGE - THE CHEF'S ACADEMY - ,NC,27560-0000,Proprietary  ,28,59,87,125,240,365
02170700,BRUNSWICK COMMUNITY COLLEGE             ,NC,28422-0000,Public       ,163,245,408,620,909,1529
02205000,COLLEGE OF WILMINGTON                   ,NC,28403-0000,Proprietary  ,66,192,258,261,538,799
02210400,FAYETTEVILLE BEAUTY COLLEGE             ,NC,28303-0000,Proprietary  ,15,81,96,66,341,407
02227800,MITCHELL'S HAIR STYLING ACADEMY         ,NC,27534-0000,Proprietary  ,5,23,28,23,70,93
02280900,MID-ATLANTIC CHRISTIAN UNIVERSITY       ,NC,27909-0000,Private      ,34,51,85,200,138,338
02326203,KAPLAN CAREER INSTITUTE - KAPLAN COLLEGE,NC,28212-6830,Proprietary  ,69,363,432,203,1213,1416
02560600,PINNACLE INSTITUTE OF COSMETOLOGY       ,NC,28115-8020,Proprietary  ,8,27,35,29,76,105
02614201,MILLER-MOTTE BUSINESS COLLEGE           ,NC,28403-0000,Proprietary  ,151,1417,1568,396,4172,4568
02614205,MILLER - MOTTE TECHNICAL COLLEGE - MILLE,NC,27834-5052,Proprietary  ,53,291,344,163,801,964
03009500,WINSTON-SALEM BARBER SCHOOL             ,NC,27107-0000,Proprietary  ,11,51,62,56,113,169
03064400,REGENCY BEAUTY INSTITUTE                ,NC,27127-0000,Proprietary  ,21,57,78,87,233,320
03089300,HERITAGE BIBLE COLLEGE                  ,NC,28335-0000,Private      ,6,20,26,21,74,95
03104200,CAROLINAS COLLEGE OF HEALTH SCIENCE     ,NC,28232-2861,Public       ,85,291,376,462,1197,1659
03109000,LIVING ARTS COLLEGE                     ,NC,27614-7076,Proprietary  ,72,131,203,368,495,863
03361300,MEDICAL ARTS MASSAGE SCHOOL             ,NC,27616-6453,Proprietary  ,22,93,115,51,306,357
03513400,APEX SCHOOL OF THEOLOGY                 ,NC,27703-8024,Private      ,15,492,507,26,1268,1294
03555300,SOUTHEASTERN INSTITUTE                  ,NC,28217-0000,Proprietary  ,38,170,208,91,478,569
03570300,CAROLINA CHRISTIAN COLLEGE              ,NC,27105-3241,Private      ,1,34,35,27,117,144
03663300,HOOD THEOLOGICAL SEMINARY               ,NC,28144-5768,Private      ,2,64,66,5,166,171
03748500,DURHAM BEAUTY ACADEMY                   ,NC,27707-3569,Proprietary  ,13,78,91,50,163,213
03777300,PAUL MITCHELL THE SCHOOL GASTONIA       ,NC,28054-0460,Proprietary  ,69,135,204,203,353,556
03827300,CHARLOTTE CHRISTIAN COLLEGE AND THEOLOGI,NC,28205-1648,Private      ,7,77,84,30,246,276
04073300,JUNG TAO SCHOOL OF CLASSICAL CHINESE MED,NC,28679-9657,Private      ,0,4,4,0,51,51
04101300,CAROLINA SCHOOL OF BROADCASTING         ,NC,28214-8085,Proprietary  ,20,65,85,104,264,368
04115700,REGINA'S COLLEGE OF BEAUTY              ,NC,28110-2831,Proprietary  ,16,67,83,42,153,195
04120300,HEALTH AND STYLE INSTITUTE              ,NC,27265-3114,Proprietary  ,40,138,178,105,334,439
04129400,CENTER FOR MASSAGE & NATURAL HEALTH     ,NC,28787-8331,Proprietary  ,3,22,25,15,72,87
04140700,AVEDA INSTITUTE CHAPEL HILL             ,NC,27516-2559,Proprietary  ,43,78,121,175,257,432
04143500,CHARLOTTE SCHOOL OF LAW                 ,NC,28208-2816,Proprietary  ,15,490,505,83,1842,1925
04146400,DAOIST TRADITIONS COLLEGE OF CHINESE MED,NC,28801-1060,Proprietary  ,0,48,48,9,106,115
04149300,PARK WEST BARBER SCHOOL                 ,NC,27701-4022,Proprietary  ,51,266,317,152,726,878
04154200,CAROLINA COLLEGE OF BIBLICAL STUDIES    ,NC,29303-5157,Private      ,11,79,90,24,251,275
04172800,BODY THERAPY INSTITUTE                  ,NC,27344-6728,Proprietary  ,6,27,33,18,59,77
04173000,SHEPHERDS THEOLOGICAL SEMINARY          ,NC,27518-9316,Private      ,2,8,10,3,25,28
04173700,GRACE COLLEGE OF DIVINITY               ,NC,28314-2343,Private      ,13,46,59,39,150,189
04178100,CAROLINA COLLEGE OF HAIR DESIGN         ,NC,28802-1232,Proprietary  ,7,25,32,29,106,135
04204700,PAUL MITCHELL THE SCHOOL RALEIGH        ,NC,27612-7358,Proprietary  ,43,58,101,122,200,322
04206500,MYCOMPUTERCAREER.COM                    ,NC,27606-3365,Proprietary  ,20,215,235,70,646,716
04214600,GRACE COLLEGE OF BARBERING              ,NC,28513-7178,Private      ,3,9,12,10,31,41
04219100,ALEXANDER PAUL INSTITUTE OF HAIR DESIGN ,NC,27858-3344,Proprietary  ,12,13,25,39,59,98
04227600,SHERRILL'S UNIVERSITY OF BARBER & COSMET,NC,27610-2431,Proprietary  ,13,62,75,45,191,236
04228400,BEYOND MEASURE BARBERING INSTITUTE      ,NC,27302-2323,Proprietary  ,2,23,25,11,63,74
00298800,BISMARCK STATE COLLEGE                  ,ND,58501-1299,Public       ,345,416,761,1659,1248,2907
00298900,DICKINSON STATE UNIVERSITY              ,ND,58601-4896,Public       ,114,112,226,769,468,1237
00299000,UNIVERSITY OF JAMESTOWN                 ,ND,58405-3401,Private      ,89,61,150,985,208,1193
00299100,LAKE REGION STATE COLLEGE               ,ND,58301-1598,Public       ,77,129,206,378,393,771
00299200,UNIVERSITY OF MARY                      ,ND,58504-9652,Private      ,180,303,483,1692,1148,2840
00299300,MAYVILLE STATE UNIVERSITY               ,ND,58257-1299,Public       ,100,99,199,688,332,1020
00299400,MINOT STATE UNIVERSITY                  ,ND,58707-0001,Public       ,174,273,447,1415,1251,2666
00299500,DAKOTA COLLEGE AT BOTTINEAU             ,ND,58318-1159,Public       ,68,55,123,326,204,530
00299600,NORTH DAKOTA STATE CLG OF SCIENCE       ,ND,58076-0002,Public       ,396,241,637,1637,636,2273
00299700,NORTH DAKOTA STATE UNIV - FARGO         ,ND,58102-0000,Public       ,1263,680,1943,10049,2925,12974
00299702,NORTH DAKOTA STATE UNIV NURSING         ,ND,58501-4425,Public       ,0,0,0,3,4,7
00300500,UNIVERSITY OF NORTH DAKOTA              ,ND,58202-8193,Public       ,1023,1128,2151,8165,5177,13342
00300700,WILLISTON STATE COLLEGE                 ,ND,58802-1326,Public       ,65,107,172,299,389,688
00300800,VALLEY CITY STATE UNIVERSITY            ,ND,58072-0000,Public       ,100,104,204,762,343,1105
00775600,JOSEF'S SCHOOL OF HAIR DESIGN INC       ,ND,58102-4977,Proprietary  ,12,27,39,53,66,119
00869408,RASMUSSEN COLLEGE - FARGO               ,ND,58103-7196,Proprietary  ,23,148,171,100,494,594
00869415,RASMUSSEN COLLEGE - BISMARCK            ,ND,58503-0000,Proprietary  ,10,28,38,32,172,204
01040600,JOSEF'S SCHOOL OF HAIR DESIGN           ,ND,58201-6394,Proprietary  ,10,33,43,38,89,127
01205900,TRINITY BIBLE COLLEGE                   ,ND,58436-7150,Private      ,23,16,39,215,78,293
01229500,JZ TREND ACADEMY PAUL MITCHELL PARTNER S,ND,58501-0000,Proprietary  ,11,6,17,25,33,58
02188200,SITTING BULL COLLEGE                    ,ND,58538-9701,Public       ,38,141,179,80,295,375
02236500,LITTLE HOOP COMMUNITY COLLEGE           ,ND,58335-0000,Public       ,15,91,106,32,160,192
02242900,UNITED TRIBES TECHNICAL COLLEGE         ,ND,58504-0000,Private      ,61,217,278,198,571,769
02298200,HEADQUARTERS ACADEMY OF HAIR DESIGN     ,ND,58701-0000,Proprietary  ,2,24,26,16,64,80
02301100,TURTLE MTN CMNTY COLG-FIN AID OFC       ,ND,58316-0000,Private      ,81,182,263,222,400,622
02553700,FORT BERTHOLD COMMUNITY COLLEGE         ,ND,58763-0000,Public       ,42,119,161,68,179,247
03087200,MOLER BARBER CLG OF HAIRSTYLING         ,ND,58103-0000,Proprietary  ,1,5,6,4,21,25
04031300,SALON PROFESSIONAL ACADEMY (THE)        ,ND,58103-3337,Proprietary  ,19,20,39,72,64,136
04139400,HAIR ACADEMY (THE)                      ,ND,58501-4929,Proprietary  ,9,9,18,44,32,76
04223500,LYNNES WELDING TRAINING                 ,ND,58102-4018,Proprietary  ,5,15,20,25,51,76
00301005,ANTIOCH UNIV/SEATTLE                    ,WA,98121-0000,Private      ,9,142,151,87,1112,1199
00376900,BELLEVUE COLLEGE                        ,WA,98007-6484,Public       ,534,1198,1732,5121,6821,11942
00377000,BIG BEND COMMUNITY COLLEGE              ,WA,98837-3299,Public       ,134,346,480,1151,1562,2713
00377100,CENTRAL WASHINGTON UNIVERSITY           ,WA,98926-7495,Public       ,767,848,1615,12899,6402,19301
00377200,CENTRALIA COLLEGE                       ,WA,98531-4099,Public       ,147,374,521,1221,1959,3180
00377300,CLARK COLLEGE                           ,WA,98663-3598,Public       ,627,1339,1966,4872,7413,12285
00377400,COLUMBIA BASIN COLLEGE                  ,WA,99301-3379,Public       ,365,841,1206,3348,4185,7533
00377500,EASTERN WASHINGTON UNIVERSITY           ,WA,99004-2447,Public       ,622,793,1415,13569,7397,20966
00377600,EVERETT COMMUNITY COLLEGE               ,WA,98201-1352,Public       ,408,1188,1596,3717,6265,9982
00377700,HERITAGE UNIVERSITY                     ,WA,98948-9562,Private      ,45,194,239,772,1411,2183
00377800,GONZAGA UNIVERSITY                      ,WA,99258-0083,Private      ,228,652,880,8052,3504,11556
00377900,GRAYS HARBOR COLLEGE                    ,WA,98520-7599,Public       ,136,326,462,815,1532,2347
00378000,GREEN RIVER COMMUNITY COLLEGE           ,WA,98092-3622,Public       ,411,1010,1421,3347,4880,8227
00378100,HIGHLINE COMMUNITY COLLEGE              ,WA,98198-9800,Public       ,396,1001,1397,3573,5702,9275
00378200,LOWER COLUMBIA COLLEGE                  ,WA,98632-0310,Public       ,171,634,805,1191,2853,4044
00378300,NORTHWEST UNIVERSITY                    ,WA,98083-0000,Private      ,182,333,515,1565,1330,2895
00378400,OLYMPIC COLLEGE                         ,WA,98337-1600,Public       ,307,1068,1375,2058,5144,7202
00378500,PACIFIC LUTHERAN UNIVERSITY             ,WA,98447-0003,Private      ,185,265,450,4830,2354,7184
00378600,PENINSULA COLLEGE                       ,WA,98362-6660,Public       ,91,289,380,665,1598,2263
00378700,SEATTLE CENTRAL COMMUNITY COLLEGE       ,WA,98122-2413,Public       ,362,1249,1611,3335,6784,10119
00378703,SEATTLE VOCATIONAL INSTITUTE            ,WA,98144-0000,Public       ,26,173,199,133,603,736
00378800,SEATTLE PACIFIC UNIVERSITY              ,WA,98119-1997,Private      ,188,307,495,7810,2964,10774
00379000,SEATTLE UNIVERSITY                      ,WA,98122-1090,Private      ,493,576,1069,10009,6386,16395
00379100,SHORELINE COMMUNITY COLLEGE             ,WA,98133-5696,Public       ,292,749,1041,2702,4491,7193
00379200,SKAGIT VALLEY COLLEGE                   ,WA,98273-5899,Public       ,248,681,929,1824,3195,5019
00379300,SPOKANE COMMUNITY COLLEGE               ,WA,99207-5399,Public       ,455,1516,1971,4136,8516,12652
00379400,ST MARTIN'S UNIVERSITY                  ,WA,98503-7500,Private      ,50,195,245,1462,1301,2763
00379600,TACOMA COMMUNITY COLLEGE                ,WA,98466-6100,Public       ,418,1576,1994,4225,9385,13610
00379700,UNIVERSITY OF PUGET SOUND               ,WA,98416-1039,Private      ,192,206,398,5530,1785,7315
00379800,UNIVERSITY OF WASHINGTON                ,WA,98195-1122,Public       ,1397,2474,3871,42547,28949,71496
00379900,WALLA WALLA UNIVERSITY                  ,WA,99324-1198,Private      ,196,103,299,1908,719,2627
00380000,WASHINGTON STATE UNIVERSITY             ,WA,99164-1035,Public       ,1121,1498,2619,30412,14196,44608
00380100,WENATCHEE VALLEY COLLEGE                ,WA,98801-1799,Public       ,237,462,699,1769,2114,3883
00380200,WESTERN WASHINGTON UNIVERSITY           ,WA,98225-5946,Public       ,822,560,1382,18623,5325,23948
00380300,WHITMAN COLLEGE                         ,WA,99362-2067,Private      ,31,17,48,2872,157,3029
00380400,WHITWORTH UNIVERSITY                    ,WA,99251-0001,Private      ,141,225,366,4427,1513,5940
00380500,YAKIMA VALLEY COMMUNITY COLLEGE         ,WA,98907-2520,Public       ,329,723,1052,2902,4281,7183
00499900,BELLINGHAM TECHNICAL COLLEGE            ,WA,98225-0000,Public       ,214,553,767,1238,2709,3947
00500000,PIERCE COLLEGE                          ,WA,98498-1919,Public       ,487,1554,2041,3549,7698,11247
00500100,EDMONDS COMMUNITY COLLEGE               ,WA,98036-5999,Public       ,287,794,1081,2605,4439,7044
00500600,WALLA WALLA COMMUNITY COLLEGE           ,WA,99362-9267,Public       ,195,443,638,1898,2341,4239
00530600,BATES TECHNICAL COLLEGE                 ,WA,98405-0000,Public       ,157,793,950,1083,3513,4596
00537200,SOUTH PUGET SOUND COMMUNITY COLLEGE     ,WA,98512-6292,Public       ,239,856,1095,2219,4468,6687
00537300,LAKE WASHINGTON TECHNICAL COLLEGE       ,WA,98034-8505,Public       ,134,419,553,845,2250,3095
00575200,CLOVER PARK TECHNICAL COLLEGE           ,WA,98499-0000,Public       ,198,1001,1199,1515,5284,6799
00815500,EVERGREEN STATE COLLEGE (THE)           ,WA,98505-0002,Public       ,220,475,695,3946,4198,8144
00907901,EVEREST COLLEGE                         ,WA,98684-6950,Private      ,28,113,141,185,434,619
00938700,PERRY TECHNICAL INSTITUTE               ,WA,98903-1239,Private      ,116,201,317,849,1028,1877
00954400,SPOKANE FALLS COMMUNITY COLLEGE         ,WA,99224-5204,Public       ,471,1173,1644,4481,6139,10620
00970400,NORTH SEATTLE COMMUNITY COLLEGE         ,WA,98103-3599,Public       ,212,943,1155,1916,5085,7001
00970600,SOUTH SEATTLE COMMUNITY COLLEGE         ,WA,98106-1499,Public       ,261,760,1021,2411,4263,6674
00973900,GLEN DOW ACAD OF HAIR DESIGN            ,WA,99201-0209,Proprietary  ,22,76,98,115,238,353
01036400,WHATCOM COMMUNITY COLLEGE               ,WA,98226-8003,Public       ,274,574,848,2222,2968,5190
01043400,RENTON TECHNICAL COLLEGE                ,WA,98056-0000,Public       ,166,610,776,1200,3092,4292
01148100,DIVERS INSTITUTE OF TECHNOLOGY          ,WA,98107-0000,Proprietary  ,41,178,219,193,560,753
01231500,CORNISH COLLEGE OF THE ARTS             ,WA,98121-4604,Private      ,50,64,114,1444,510,1954
01249600,TONI & GUY HAIRDRESSING ACADEMY         ,WA,98133-5615,Proprietary  ,16,20,36,46,74,120
01302200,CITY UNIVERSITY OF SEATTLE              ,WA,98005-0000,Private      ,32,481,513,324,2069,2393
01309400,BELLINGHAM BEAUTY SCHOOL                ,WA,98226-5515,Proprietary  ,0,0,0,15,11,26
02105300,EVERGREEN BEAUTY AND BARBER COLLEGE     ,WA,98007-3722,Proprietary  ,23,53,76,76,180,256
02106700,TRINITY LUTHERAN COLLEGE                ,WA,98201-3569,Private      ,36,27,63,360,136,496
02180000,NORTHWEST INDIAN COLLEGE                ,WA,98226-9278,Public       ,41,274,315,170,826,996
02184200,PAROBA COLLEGE OF COSMETOLOGY           ,WA,98208-0000,Proprietary  ,18,68,86,55,181,236
02202200,STYLEMASTERS COLLEGE OF HAIR DESIGN     ,WA,98632-0000,Proprietary  ,8,41,49,30,133,163
02203300,GENE JUAREZ BEAUTY SCHOOLS              ,WA,98043-5427,Proprietary  ,56,98,154,282,392,674
02222900,INTERNATIONAL AIR & HOSPITALITY ACADEMY ,WA,98661-4835,Proprietary  ,85,165,250,291,597,888
02236800,PROFESSIONAL BEAUTY SCHOOL              ,WA,98902-0000,Proprietary  ,5,29,34,50,121,171
02242500,BASTYR UNIVERSITY                       ,WA,98028-0000,Private      ,25,144,169,239,1792,2031
02291300,ART INSTITUTE OF SEATTLE                ,WA,98121-1622,Proprietary  ,195,339,534,1718,1710,3428
02300100,EVEREST COLLEGE                         ,WA,98367-1835,Private      ,22,97,119,100,349,449
02300103,EVEREST COLLEGE - EVERETT               ,WA,98208-2610,Private      ,37,175,212,167,592,759
02300104,EVEREST COLLEGE - TACOMA                ,WA,98402-3004,Private      ,82,264,346,360,1184,1544
02326500,INTERFACE COLLEGE                       ,WA,99201-4326,Proprietary  ,8,46,54,47,176,223
02331400,NORTHWEST HAIR ACADEMY                  ,WA,98273-0000,Proprietary  ,8,27,35,30,84,114
02331402,NORTHWEST HAIR ACADEMY - EVERETT        ,WA,98204-0000,Proprietary  ,0,0,0,24,54,78
02331404,NORTHWEST HAIR ACADEMY - YAKIMA         ,WA,98901-2305,Proprietary  ,3,19,22,46,102,148
02504900,ACADEMY OF HAIR DESIGN (THE)            ,WA,98801-0000,Proprietary  ,6,26,32,31,85,116
02541900,BJ'S BEAUTY AND BARBER COLLEGE          ,WA,98409-0000,Proprietary  ,19,74,93,66,289,355
02602100,NORTHWEST COLLEGE OF ART & DESIGN       ,WA,98370-8625,Proprietary  ,19,7,26,197,73,270
02606200,EVEREST COLLEGE                         ,WA,98055-2990,Private      ,42,130,172,195,526,721
02617500,EVEREST COLLEGE                         ,WA,98133-9018,Private      ,20,97,117,179,397,576
03031406,INTERNATIONAL ACADEMY OF DESIGN & TECH  ,WA,98188-3319,Proprietary  ,24,56,80,178,336,514
03065000,LUCAS MARC ACADEMY                      ,WA,99352-9700,Proprietary  ,22,64,86,71,167,238
03071800,ITT TECHNICAL INSTITUTE                 ,WA,99216-1589,Proprietary  ,68,279,347,305,1107,1412
03071805,ITT TECHNICAL INSTITUTE - SEATTLE       ,WA,98168-3346,Proprietary  ,96,579,675,459,1814,2273
03099000,CORTIVA INSTITUTE - SEATTLE             ,WA,98109-5474,Proprietary  ,23,106,129,94,320,414
03110800,BAKKE GRADUATE UNIVERSITY               ,WA,98104-1222,Private      ,3,8,11,16,63,79
03139500,MONTESSORI SCHOOLS OF WASHINGTON        ,WA,98203-6600,Private      ,2,15,17,6,30,36
03280300,SEATTLE INST OF ORIENTAL MEDICINE       ,WA,98115-0000,Proprietary  ,2,20,22,41,134,175
03283300,NORTHWEST HVAC/R ASSOCIATION & TRAINING ,WA,99207-2125,Private      ,7,40,47,32,120,152
03466400,SEATTLE SCHOOL OF THEOLOGY AND PSYCHOLOG,WA,98121-1177,Private      ,8,95,103,86,454,540
03483500,CASCADIA COMMUNITY COLLEGE              ,WA,98011-9510,Public       ,198,282,480,1439,1376,2815
03490400,EMIL FRIES PIANO HOSPITAL & TRAININ     ,WA,98661-4323,Private      ,0,6,6,4,20,24
03670301,TONI&GUY HAIRDRESSING ACADEMY -         ,WA,98225-4526,Proprietary  ,17,27,44,71,116,187
03689400,FAITH EVANGELICAL COLLEGE & SEMINARY    ,WA,98407-2607,Private      ,7,91,98,26,366,392
03724300,DIGIPEN INSTITUTE OF TECHNOLOGY         ,WA,98052-5170,Proprietary  ,87,81,168,1265,492,1757
03917300,EVERGREEN BEAUTY AND BARBER COLLEGE     ,WA,98208-3759,Proprietary  ,49,120,169,144,390,534
03932500,TOTAL COSMETOLOGY TRAINING CENTER       ,WA,99217-6231,Proprietary  ,6,52,58,49,168,217
04120000,SUNNYSIDE BEAUTY ACADEMY                ,WA,98944-8711,Proprietary  ,3,3,6,10,30,40
04127200,VICTORIA'S ACADEMY OF COSMETOLOGY       ,WA,99336-3826,Proprietary  ,9,61,70,61,174,235
04130500,PACIFIC NORTHWEST UNIV OF HEALTH SCIENCE,WA,98901-1471,Private      ,4,46,50,47,667,714
04130800,CASCADE BEAUTY COLLEGE                  ,WA,98002-5504,Proprietary  ,7,19,26,38,98,136
04132800,INLAND MASSAGE INSTITUTE                ,WA,99218-5016,Proprietary  ,8,35,43,41,131,172
04149400,GARY MANUEL AVEDA INSTITUTE             ,WA,98122-3807,Proprietary  ,35,70,105,175,329,504
04155000,NORTHWEST SCHOOL OF WOODEN BOAT BUILDING,WA,98339-8706,Private      ,2,18,20,13,92,105
04161200,PINCHOT UNIVERSITY                      ,WA,98104-2617,Private      ,1,29,30,14,110,124
04170100,SUMMIT SALON ACADEMY                    ,WA,98409-7360,Proprietary  ,22,76,98,109,294,403
04172900,ACADEMY OF COSMETOLOGY                  ,WA,99354-2651,Proprietary  ,0,0,0,39,55,94
04188900,NORTHWEST INSTITUTE OF LITERARY ARTS    ,WA,98249-0000,Private      ,1,5,6,5,34,39
04191900,PAUL MITCHELL THE SCHOOL SPOKANE        ,WA,99037-5041,Proprietary  ,27,71,98,152,246,398
04223600,ACADEMY OF INTERACTIVE ENTERTAINMENT    ,WA,98109-4623,Private      ,29,35,64,275,224,499
04231000,STUDIO BEAUTY SCHOOL                    ,WA,99205-3357,Proprietary  ,9,38,47,54,114,168
00340100,BROWN UNIVERSITY                        ,RI,02912-9127,Private      ,205,56,261,18501,900,19401
00340101,BROWN UNIVERSITY - GRADUATE SCHOOL      ,RI,02912-1827,Private      ,1,78,79,62,1311,1373
00340102,BROWN MEDICAL SCHOOL                    ,RI,02912-0000,Private      ,8,17,25,59,594,653
00340200,BRYANT UNIVERSITY                       ,RI,02917-1284,Private      ,143,81,224,5852,527,6379
00340400,JOHNSON & WALES UNIVERSITY              ,RI,02903-3703,Private      ,836,667,1503,18801,4695,23496
00340600,PROVIDENCE COLLEGE                      ,RI,02918-0001,Private      ,81,150,231,8139,912,9051
00340700,RHODE ISLAND COLLEGE                    ,RI,02908-1991,Public       ,313,572,885,8276,4682,12958
00340800,COMMUNITY COLLEGE OF RI - WARWICK       ,RI,02906-0000,Public       ,1445,2118,3563,8587,10443,19030
00340900,RHODE ISLAND SCHOOL OF DESIGN           ,RI,02903-2784,Private      ,131,96,227,2743,980,3723
00341000,ROGER WILLIAMS UNIVERSITY               ,RI,02809-2921,Private      ,96,191,287,8743,1578,10321
00341100,SALVE REGINA UNIVERSITY                 ,RI,02840-4192,Private      ,36,99,135,4198,626,4824
00341400,UNIVERSITY OF RHODE ISLAND              ,RI,02881-0000,Public       ,866,672,1538,23607,4166,27773
00659100,ST. JOSEPH HOSP SCH OF NURSING          ,RI,02904-5199,Private      ,6,39,45,66,291,357
00784500,NEW ENGLAND INSTITUTE OF TECHNOLOGY     ,RI,02886-0000,Private      ,279,485,764,2503,2685,5188
01246116,LINCOLN TECHNICAL INSTITUTE - LINCOLN   ,RI,02865-4211,Proprietary  ,46,165,211,320,726,1046
02531802,PAUL MITCHELL THE SCHOOL-CRANSTON       ,RI,02920-0000,Proprietary  ,42,37,79,111,125,236
02584400,NEW ENGLAND TRACTOR TRAILER TRAINING SCH,RI,02860-1752,Proprietary  ,67,464,531,112,894,1006
03080000,NEWPORT SCHOOL OF HAIRDRESSING          ,RI,02860-4038,Proprietary  ,2,11,13,6,37,43
03732300,INTERNATIONAL YACHT RESTORATION SCH     ,RI,02840-6720,Private      ,7,18,25,41,51,92
04141200,TONI & GUY HAIRDRESSING ACADEMY         ,RI,02920-0000,Proprietary  ,28,31,59,104,103,207
04246000,MKG BEAUTY & BUSINESS                   ,RI,02920-4358,Proprietary  ,15,18,33,32,48,80
00294102,LENOIR-RHYNE UNIVERSITY - LUTHERAN THEOL,SC,29203-5863,Private      ,3,7,10,18,76,94
00341700,ALLEN UNIVERSITY                        ,SC,29204-1085,Private      ,251,153,404,1009,573,1582
00341800,ANDERSON UNIVERSITY                     ,SC,29621-4035,Private      ,202,297,499,3518,1350,4868
00341900,CHARLESTON SOUTHERN UNIVERSITY          ,SC,29406-2160,Private      ,352,503,855,4768,2465,7233
00342000,BENEDICT COLLEGE                        ,SC,29204-1086,Private      ,535,382,917,3440,1654,5094
00342100,BOB JONES UNIVERSITY                    ,SC,29614-1000,Proprietary  ,260,88,348,2589,372,2961
00342200,SOUTHERN WESLEYAN UNIVERSITY            ,SC,29630-1020,Private      ,87,337,424,976,1478,2454
00342300,THE CITADEL                             ,SC,29409-0002,Public       ,262,299,561,2982,1166,4148
00342400,CLAFLIN UNIVERSITY                      ,SC,29115-4498,Private      ,284,253,537,2791,1126,3917
00342500,CLEMSON UNIVERSITY                      ,SC,29634-0001,Public       ,1534,793,2327,22069,4061,26130
00342600,UNIV OF SC AT SUMTER                    ,SC,29150-2498,Public       ,215,253,468,853,715,1568
00342700,COKER COLLEGE                           ,SC,29550-3797,Private      ,115,202,317,1217,892,2109
00342800,COLLEGE OF CHARLESTON                   ,SC,29424-0100,Public       ,1003,680,1683,12257,3057,15314
00342900,COLUMBIA INTERNATIONAL UNIVERSITY       ,SC,29203-1599,Private      ,77,158,235,631,599,1230
00343000,COLUMBIA COLLEGE                        ,SC,29203-5998,Private      ,100,496,596,1177,1983,3160
00343100,CONVERSE COLLEGE                        ,SC,29302-1931,Private      ,58,105,163,1192,597,1789
00343200,ERSKINE COLLEGE                         ,SC,29639-0000,Private      ,49,12,61,822,56,878
00343201,ERSKINE THEOLOGICAL SEMINARY            ,SC,29639-0000,Private      ,3,17,20,7,88,95
00343400,FURMAN UNIVERSITY                       ,SC,29613-5253,Private      ,210,121,331,3749,470,4219
00343500,LANDER UNIVERSITY                       ,SC,29649-2099,Public       ,288,163,451,3630,798,4428
00343600,LIMESTONE COLLEGE                       ,SC,29340-3799,Private      ,218,545,763,2231,2823,5054
00343800,MEDICAL UNIV OF SOUTH CAROLINA - FA     ,SC,29425-1760,Public       ,54,380,434,397,3479,3876
00343900,MORRIS COLLEGE                          ,SC,29150-3599,Private      ,166,165,331,1054,539,1593
00344000,NEWBERRY COLLEGE                        ,SC,29108-2197,Private      ,75,57,132,1800,322,2122
00344100,NORTH GREENVILLE COLLEGE                ,SC,29688-1892,Private      ,212,184,396,2701,702,3403
00344500,PRESBYTERIAN COLLEGE                    ,SC,29325-2503,Private      ,92,56,148,1687,418,2105
00344600,SOUTH CAROLINA STATE UNIVERSITY         ,SC,29117-4427,Public       ,482,469,951,3937,1897,5834
00344700,SPARTANBURG METHODIST COLLEGE           ,SC,29301-5899,Private      ,135,58,193,1356,242,1598
00344800,UNIVERSITY OF SOUTH CAROLINA            ,SC,29208-3999,Public       ,2515,2049,4564,31059,12508,43567
00344900,UNIVERSITY OF SOUTH CAROLINA AIKEN      ,SC,29801-6399,Public       ,429,394,823,3600,1658,5258
00345000,UNIV OF SC AT BEAUFORT                  ,SC,29902-0000,Public       ,269,284,553,2363,1219,3582
00345100,COASTAL CAROLINA UNIVERSITY             ,SC,29528-0000,Public       ,1238,636,1874,15020,3041,18061
00345300,UNIV OF SC AT LANCASTER                 ,SC,29721-0889,Public       ,236,208,444,1066,689,1755
00345400,UNIV OF SC SYSTEM SALKEHATCHIE          ,SC,29810-0617,Public       ,160,181,341,667,530,1197
00345500,VOORHEES COLLEGE                        ,SC,29042-0000,Private      ,95,68,163,720,278,998
00345600,WINTHROP UNIVERSITY                     ,SC,29733-0001,Public       ,587,427,1014,6698,2162,8860
00345700,WOFFORD COLLEGE                         ,SC,29303-3663,Private      ,100,48,148,2701,214,2915
00399000,FLORENCE-DARLINGTON TECH COLLEGE        ,SC,29501-0548,Public       ,927,1885,2812,2983,5416,8399
00399100,GREENVILLE TECHNICAL COLLEGE            ,SC,29607-2439,Public       ,2092,3041,5133,7202,9518,16720
00399200,PIEDMONT TECHNICAL COLLEGE              ,SC,29648-1467,Public       ,816,1645,2461,2346,4444,6790
00399300,MIDLANDS TECHNICAL COLLEGE              ,SC,29202-0000,Public       ,1767,2658,4425,7104,9945,17049
00399400,SPARTANBURG COMMUNITY COLLEGE           ,SC,29305-0000,Public       ,857,1126,1983,3148,3751,6899
00399500,CENTRAL CAROLINA TECHNICAL COLLEGE      ,SC,29150-2499,Public       ,645,1344,1989,1768,3519,5287
00399600,YORK TECHNICAL COLLEGE                  ,SC,29730-3395,Public       ,935,1389,2324,2936,4123,7059
00492000,TRIDENT TECHNICAL COLLEGE               ,SC,29423-8067,Public       ,2413,4608,7021,6462,12471,18933
00492300,CLINTON JR COLLEGE                      ,SC,29730-5152,Private      ,68,84,152,155,182,337
00492400,FORREST COLLEGE                         ,SC,29624-2405,Proprietary  ,8,65,73,36,208,244
00492500,HORRY-GEORGETOWN TECH COLLEGE           ,SC,29526-9521,Public       ,896,1479,2375,3806,5711,9517
00492600,TRI-COUNTY TECHNICAL COLLEGE            ,SC,29670-9133,Public       ,820,870,1690,4232,3033,7265
00492700,UNIV OF SC AT UNION                     ,SC,29379-0729,Public       ,52,73,125,245,266,511
00499204,MILLER-MOTTE TECHNICAL COLLEGE - CONWAY ,SC,29526-9508,Proprietary  ,104,421,525,249,1033,1282
00536300,DENMARK TECHNICAL COLLEGE               ,SC,29042-0000,Public       ,208,502,710,489,1416,1905
00681500,ORANGEBURG-CALHOUN TECHNICAL COLG       ,SC,29118-8299,Public       ,543,828,1371,1598,2346,3944
00695100,UNIVERSITY OF SOUTH CAROLINA UPSTATE    ,SC,29303-9972,Public       ,802,733,1535,6158,3138,9296
00760200,NORTHEASTERN TECHNICAL COLLEGE          ,SC,29520-7015,Public       ,175,304,479,603,951,1554
00922600,FRANCIS MARION UNIVERSITY               ,SC,29501-0000,Public       ,571,459,1030,4485,1899,6384
00932200,WILLIAMSBURG TECHNICAL COLLEGE          ,SC,29556-4197,Public       ,89,213,302,247,517,764
00991000,TECHNICAL COLLEGE OF THE LOWCOUNTRY     ,SC,29902-5441,Public       ,258,758,1016,1021,2510,3531
00991100,UNIV OF SC-REGIONAL CAMPUSES ADMIN      ,SC,29208-0001,Public       ,19,59,78,212,273,485
01005600,AIKEN TECHNICAL COLLEGE                 ,SC,29802-0696,Public       ,413,810,1223,1571,2804,4375
01019806,ECPI UNIVERSITY - GREENVILLE            ,SC,29615-4232,Proprietary  ,35,218,253,110,698,808
01019809,ECPI UNIVERSITY - CHARLESTON            ,SC,29420-4264,Proprietary  ,30,225,255,94,636,730
01019811,ECPI UNIVERSITY - COLUMBIA              ,SC,29210-6467,Proprietary  ,17,143,160,56,441,497
01179901,PAUL MITCHELL THE SCHOOL COLUMBIA       ,SC,29201-3126,Proprietary  ,43,69,112,151,260,411
01179902,PAUL MITCHELL THE SCHOOL CHARLESTON     ,SC,29418-6993,Proprietary  ,36,71,107,121,196,317
01179903,PAUL MITCHELL THE SCHOOL FAYETTEVILLE - ,SC,29607-0000,Proprietary  ,18,53,71,90,155,245
01209200,KENNETH SHULER SCHOOL OF COSMETOLOGY    ,SC,29732-2169,Proprietary  ,43,96,139,140,369,509
01303907,SOUTH UNIVERSITY                        ,SC,29203-6400,Proprietary  ,88,646,734,384,2301,2685
02063700,SHERMAN CLG STRAIGHT CHIROPRACTIC       ,SC,29316-0000,Private      ,2,49,51,17,484,501
02338600,CHARZANNE BEAUTY COLLEGE                ,SC,29649-0000,Proprietary  ,6,26,32,18,62,80
02341100,KENNETH SHULER SCHOOL OF COSMETOLOGY & N,SC,29210-0000,Proprietary  ,74,202,276,224,625,849
02356600,CHARLESTON COSMETOLOGY INSTITUTE        ,SC,29420-0000,Proprietary  ,22,57,79,56,127,183
02552400,ACADEMY OF HAIR TECHNOLOGY              ,SC,29615-2363,Proprietary  ,15,32,47,46,137,183
02567600,SUMTER BEAUTY COLLEGE                   ,SC,29150-0000,Proprietary  ,10,27,37,26,85,111
02614202,MILLER - MOTTE TECHNICAL COLLEGE - NORTH,SC,29406-9239,Proprietary  ,71,420,491,177,1000,1177
03010614,VIRGINIA COLLEGE - GOLF ACADEMY OF AMERI,SC,29579-0000,Proprietary  ,13,28,41,82,123,205
03010617,VIRGINIA COLLEGE - GREENVILLE           ,SC,29607-7200,Proprietary  ,26,176,202,118,586,704
03010620,VIRGINIA COLLEGE - CHARLESTON           ,SC,29406-4999,Proprietary  ,20,141,161,112,480,592
03010621,VIRGINIA COLLEGE - COLUMBIA             ,SC,29223-7527,Proprietary  ,38,185,223,133,684,817
03052300,KENNETH SHULER SCH COSM & HAIR DESG     ,SC,29841-2013,Proprietary  ,52,111,163,150,371,521
03293300,STRAND COLLEGE OF HAIR DESIGN           ,SC,29572-4310,Proprietary  ,9,35,44,28,89,117
03304300,CENTURA COLLEGE                         ,SC,29406-9235,Proprietary  ,29,191,220,81,476,557
03555400,SOUTHEASTERN INSTITUTE                  ,SC,29406-0000,Proprietary  ,20,75,95,61,224,285
03709301,EDWARD VIA VIRGINIA COLLEGE OF OSTEOPATH,SC,29303-3639,Private      ,3,31,34,13,698,711
03746300,LEGRAND INSTITUTE OF COSMETOLOGY        ,SC,29020-0000,Proprietary  ,6,15,21,16,27,43
03746400,SOUTHEASTERN INSTITUTE                  ,SC,29210-0000,Proprietary  ,25,108,133,65,302,367
03768400,STYLETRENDS BARBER AND HAIRSTYLING ACADE,SC,29730-4511,Proprietary  ,3,24,27,9,47,56
04083300,MARION COUNTY TECHNICAL EDUCATION CENTER,SC,29571-0000,Public       ,7,30,37,30,143,173
04096300,CHARLESTON SCHOOL OF LAW                ,SC,29402-0535,Proprietary  ,7,146,153,30,741,771
04158100,AIKEN SCHOOL OF COSMETOLOGY             ,SC,29801-4554,Proprietary  ,15,32,47,45,99,144
04166900,COSMETIC ARTS INSTITUTE                 ,SC,29488-4216,Proprietary  ,12,22,34,27,40,67
04172600,SALON 496 BARBER ACADEMY                ,SC,29607-2548,Proprietary  ,11,19,30,24,74,98
04192600,PALMETTO BEAUTY SCHOOL                  ,SC,29307-1424,Proprietary  ,12,28,40,31,73,104
04202900,JOLEI'S HAIR INSTITUTE                  ,SC,29114-9337,Proprietary  ,0,0,0,0,9,9
04239000,B-UNIQUE BEAUTY AND BARBER ACADEMY      ,SC,29607-2314,Proprietary  ,1,3,4,1,3,4
04243500,BARBER TECH ACADEMY                     ,SC,29115-6069,Proprietary  ,5,18,23,5,18,23
04244100,CONSTRUCTION TRAINING CENTER            ,SC,29015-9083,Proprietary  ,1,1,2,1,1,2
00345800,AUGUSTANA COLLEGE                       ,SD,57197-0001,Private      ,160,86,246,1495,279,1774
00345900,BLACK HILLS STATE UNIVERSITY            ,SD,57799-9670,Public       ,341,394,735,2059,1449,3508
00346100,DAKOTA WESLEYAN UNIVERSITY              ,SD,57301-4398,Private      ,65,52,117,722,307,1029
00346300,DAKOTA STATE UNIVERSITY                 ,SD,57042-1799,Public       ,189,217,406,1330,928,2258
00346500,MOUNT MARTY COLLEGE                     ,SD,57078-3724,Private      ,61,83,144,479,323,802
00346600,NORTHERN STATE UNIVERSITY               ,SD,57401-7198,Public       ,121,132,253,1446,662,2108
00346700,PRESENTATION COLLEGE                    ,SD,57401-1299,Private      ,66,103,169,495,501,996
00346900,UNIVERSITY OF SIOUX FALLS               ,SD,57105-1699,Private      ,69,106,175,1324,527,1851
00347000,SOUTH DAKOTA SCH OF MINES & TECH        ,SD,57701-3995,Public       ,234,201,435,2074,639,2713
00347100,SOUTH DAKOTA STATE UNIVERSITY           ,SD,57007-2298,Public       ,1188,651,1839,8068,2676,10744
00347400,UNIVERSITY OF SOUTH DAKOTA              ,SD,57069-2390,Public       ,778,751,1529,5316,3744,9060
00405600,SIOUX FALLS SEMINARY                    ,SD,57105-2729,Private      ,2,39,41,3,77,80
00405700,NATIONAL AMERICAN UNIVERSITY            ,SD,57701-3692,Proprietary  ,191,2453,2644,484,8847,9331
00405707,NATIONAL AMERICAN UNIVERSITY - SIOUX FAL,SD,57108-4293,Proprietary  ,13,99,112,50,584,634
00492900,MCKENNAN HOSP-RADOLOGICAL TECH          ,SD,57101-0000,Private      ,1,8,9,13,23,36
00530900,LAKE AREA TECHNICAL INSTITUTE           ,SD,57201-0730,Public       ,210,155,365,1253,563,1816
00598700,AVERA SACRED HEART HOSPITAL SCHOOL OF RA,SD,57078-3899,Private      ,0,4,4,13,9,22
00776400,SOUTHEAST TECHNICAL INST                ,SD,57107-0000,Public       ,287,411,698,1228,1244,2472
00828400,MITCHELL TECHNICAL INSTITUTE            ,SD,57301-9931,Public       ,168,106,274,764,353,1117
01013800,STEWART SCHOOL                          ,SD,57104-0000,Proprietary  ,17,28,45,86,80,166
01014804,COLORADO TECHNICAL UNIVERSITY           ,SD,57108-2272,Proprietary  ,6,50,56,32,131,163
01017000,WESTERN DAKOTA TECHNICAL INSTITUTE      ,SD,57701-4018,Public       ,89,274,363,407,798,1205
01147700,SANFORD MEDICAL CENTER                  ,SD,57117-5039,Private      ,2,8,10,19,31,50
01465900,OGLALA LAKOTA COLLEGE                   ,SD,57752-0490,Public       ,114,585,699,275,1267,1542
02137100,BLACK HILLS BEAUTY COLLEGE              ,SD,57701-0000,Proprietary  ,25,38,63,82,100,182
02143700,SINTE GLESKA UNIVERSITY                 ,SD,57570-0000,Public       ,53,282,335,98,451,549
02144600,KILIAN COMMUNITY COLLEGE                ,SD,57103-7020,Private      ,31,82,113,78,213,291
02277300,SISSETON WAHPETON COLLEGE               ,SD,57262-0000,Public       ,20,75,95,29,106,135
02297800,HEADLINES ACADEMY                       ,SD,57701-2733,Proprietary  ,14,31,45,53,103,156
00347700,AQUINAS COLLEGE                         ,TN,37205-2086,Private      ,33,100,133,318,516,834
00347800,AUSTIN PEAY STATE UNIVERSITY            ,TN,37044-0002,Public       ,806,1703,2509,9086,7564,16650
00347900,BELMONT UNIVERSITY                      ,TN,37212-3757,Private      ,553,575,1128,8413,3386,11799
00348000,BETHEL UNIVERSITY                       ,TN,38201-1705,Private      ,144,1312,1456,2135,6332,8467
00348100,CARSON - NEWMAN UNIVERSITY              ,TN,37760-2204,Private      ,233,276,509,3865,1254,5119
00348200,CHRISTIAN BROTHERS UNIVERSITY           ,TN,38104-5581,Private      ,199,404,603,2648,1814,4462
00348300,COLUMBIA STATE COMMUNITY COLLEGE        ,TN,38401-5653,Public       ,512,786,1298,4497,3035,7532
00348500,CUMBERLAND UNIVERSITY                   ,TN,37087-3554,Private      ,102,210,312,1606,1110,2716
00348600,LIPSCOMB UNIVERSITY                     ,TN,37204-3951,Private      ,304,636,940,4137,2641,6778
00348700,EAST TENNESSEE STATE UNIV - MAIN CAMPUS ,TN,37614-2857,Public       ,1160,1319,2479,13004,7608,20612
00348701,EAST TENNESSEE STATE UNIV - MEDICINE    ,TN,37614-1708,Public       ,21,50,71,350,654,1004
00348709,EAST TENNESSEE STATE UNIV - PHARMACY    ,TN,37614-1704,Public       ,8,58,66,143,442,585
00349000,FISK UNIVERSITY                         ,TN,37208-3045,Private      ,124,141,265,1987,742,2729
00349200,FREED-HARDEMAN UNIVERSITY               ,TN,38340-2399,Private      ,162,215,377,1692,924,2616
00349400,HIWASSEE COLLEGE                        ,TN,37354-4001,Private      ,42,33,75,492,193,685
00349500,JOHNSON UNIVERSITY                      ,TN,37998-9775,Private      ,124,165,289,1179,713,1892
00349600,KING UNIVERSITY                         ,TN,37620-2699,Private      ,134,532,666,1483,2887,4370
00349900,LANE COLLEGE                            ,TN,38301-4598,Private      ,245,243,488,2042,1008,3050
00350000,LEE UNIVERSITY                          ,TN,37320-0000,Private      ,455,502,957,4343,1797,6140
00350100,LEMOYNE-OWEN COLLEGE                    ,TN,38126-6510,Private      ,197,486,683,1837,2210,4047
00350200,LINCOLN MEMORIAL UNIVERSITY             ,TN,37752-7920,Private      ,159,582,741,1999,3857,5856
00350400,MARTIN METHODIST COLLEGE                ,TN,38478-2799,Private      ,50,79,129,1112,441,1553
00350500,MARYVILLE COLLEGE                       ,TN,37804-5907,Private      ,99,74,173,1937,371,2308
00350600,MEHARRY MEDICAL COLLEGE                 ,TN,37208-0000,Private      ,10,104,114,134,1291,1425
00350700,MEMPHIS COLLEGE OF ART                  ,TN,38104-2764,Private      ,72,75,147,929,472,1401
00350900,UNIVERSITY OF MEMPHIS (THE)             ,TN,38152-4611,Public       ,1707,2925,4632,18741,16099,34840
00351000,MIDDLE TENNESSEE STATE UNIV             ,TN,37130-0000,Public       ,1935,2243,4178,23023,12218,35241
00351100,MILLIGAN COLLEGE                        ,TN,37682-4001,Private      ,54,94,148,1142,591,1733
00351105,MILLIGAN COLLEGE - JOHNSON CITY         ,TN,37601-9483,Private      ,0,4,4,4,33,37
00351700,SOUTHERN COLLEGE OF OPTOMETRY           ,TN,38104-2222,Private      ,2,25,27,58,653,711
00351800,SOUTHERN ADVENTIST UNIVERSITY           ,TN,37315-0370,Private      ,218,171,389,2688,1054,3742
00351900,RHODES COLLEGE                          ,TN,38112-1690,Private      ,244,131,375,3364,621,3985
00352200,TENNESSEE STATE UNIVERSITY              ,TN,37209-1561,Public       ,889,1637,2526,11911,8548,20459
00352300,TENNESSEE TECHNOLOGICAL UNIV            ,TN,38505-0001,Public       ,900,687,1587,11038,3397,14435
00352400,TENNESSEE TEMPLE UNIVERSITY             ,TN,37404-3587,Private      ,10,28,38,257,305,562
00352500,TENNESSEE WESLEYAN COLLEGE              ,TN,37371-0040,Private      ,81,67,148,1257,586,1843
00352600,TREVECCA NAZARENE UNIVERSITY            ,TN,37210-2877,Private      ,163,541,704,1925,2007,3932
00352700,TUSCULUM COLLEGE                        ,TN,37743-0001,Private      ,130,274,404,1932,1389,3321
00352800,UNION UNIVERSITY                        ,TN,38305-3697,Private      ,170,569,739,2592,2824,5416
00352900,UNIVERSITY OF TENNESSEE-CHATTANOOGA     ,TN,37403-2598,Public       ,1069,916,1985,15091,5090,20181
00353000,UNIVERSITY OF TENNESSEE-KNOXVILLE       ,TN,37996-0150,Public       ,2133,1636,3769,30197,9883,40080
00353006,UNIVERSITY OF TENNESSEE-HEALTH SCI CTR  ,TN,38103-0000,Public       ,63,421,484,710,3911,4621
00353100,UNIVERSITY OF TENNESSEE-MARTIN          ,TN,38238-0002,Public       ,568,660,1228,7329,3310,10639
00353400,UNIVERSITY OF THE SOUTH                 ,TN,37383-1000,Private      ,79,15,94,2712,133,2845
00353500,VANDERBILT UNIVERSITY                   ,TN,37240-0001,Private      ,512,651,1163,19901,6853,26754
00353501,VANDERBILT UNIV MED CTR ALLIEDHEAL      ,TN,37232-5510,Private      ,20,74,94,248,581,829
00353600,BRYAN COLLEGE                           ,TN,37321-7000,Private      ,92,107,199,1055,726,1781
00399800,CHATTANOOGA STATE COMMUNITY COLLEGE     ,TN,37406-1097,Public       ,1042,2122,3164,7403,8444,15847
00399900,CLEVELAND STATE COMMUNITY COLLEGE       ,TN,37312-2858,Public       ,203,537,740,2640,2406,5046
00402500,TENNESSEE COLLEGE OF APPLIED TECHNOLOGY ,TN,37919-2327,Public       ,116,387,503,1260,2151,3411
00402600,TENNESSEE COLLEGE OF APPLIED TECHNOLOGY ,TN,38555-4142,Public       ,38,91,129,387,494,881
00461700,NATIONAL COLLEGE                        ,TN,37211-6605,Proprietary  ,23,234,257,187,1122,1309
00493400,DAYMAR INSTITUTE                        ,TN,37217-1056,Proprietary  ,24,161,185,95,486,581
00493401,DAYMAR INSTITUTE - CLARKSVILLE          ,TN,37040-6718,Proprietary  ,51,339,390,227,1085,1312
00493404,DAYMAR INSTITUTE - MURFREESBORO         ,TN,37128-5508,Proprietary  ,35,155,190,133,449,582
00493700,JACKSON STATE COMMUNITY COLLEGE         ,TN,38301-3797,Public       ,286,712,998,3949,3437,7386
00493800,SOUTH COLLEGE                           ,TN,37909-3323,Proprietary  ,76,516,592,762,2298,3060
00494700,WEST TENNESSEE BUSINESS COLLEGE         ,TN,38301-3256,Proprietary  ,18,103,121,133,484,617
00528000,TENNESSEE COLLEGE OF APPLIED TECHNOLOGY ,TN,38019-0249,Public       ,37,109,146,218,407,625
00528100,TENNESSEE COLLEGE OF APPLIED TECHNOLOGY ,TN,37643-6054,Public       ,47,195,242,515,848,1363
00528200,TENNESSEE COLLEGE OF APPLIED TECHNOLOGY-,TN,37074-2032,Public       ,22,71,93,357,343,700
00528300,TENNESSEE COLLEGE OF APPLIED TECHNOLOGY ,TN,38059-1198,Public       ,36,135,171,269,505,774
00530700,TENNESSEE COLLEGE OF APPLIED TECHNOLOGY-,TN,37110-1322,Public       ,33,83,116,314,371,685
00535100,TENNESSEE COLLEGE OF APPLIED TECHNOLOGY ,TN,37813-2094,Public       ,55,191,246,673,1027,1700
00535200,TENNESSEE COLLEGE OF APPLIED TECHNOLOGY-,TN,38201-1620,Public       ,18,56,74,193,260,453
00535300,TENNESSEE COLLEGE OF APPLIED TECHNOLOGY-,TN,38570-1291,Public       ,35,78,113,436,402,838
00535400,TENNESSEE COLLEGE OF APPLIED TECHNOLOGY-,TN,38301-9609,Public       ,57,247,304,599,1108,1707
00535600,TENNESSEE COLLEGE OF APPLIED TECHNOLOGY ,TN,38462-2201,Public       ,25,82,107,355,388,743
00535700,TENNESSEE COLLEGE OF APPLIED TECHNOLOGY ,TN,38327-3402,Public       ,20,96,116,204,355,559
00535800,TENNESSEE COLLEGE OF APPLIED TECHNOLOGY ,TN,37371-0848,Public       ,27,60,87,416,398,814
00535900,TENNESSEE COLLEGE OF APPLIED TECHNOLOGY ,TN,37209-4515,Public       ,110,472,582,981,2037,3018
00536000,TENNESSEE COLLEGE OF APPLIED TECHNOLOGY-,TN,38105-3604,Public       ,139,567,706,1372,2666,4038
00537800,NORTHEAST STATE COMMUNITY COLLEGE       ,TN,37617-0246,Public       ,431,851,1282,4203,3861,8064
00537900,TENNESSEE COLLEGE OF APPLIED TECHNOLOGY-,TN,37160-3697,Public       ,73,145,218,550,653,1203
00683500,DYERSBURG STATE COMMUNITY COLLEGE       ,TN,38024-0000,Public       ,211,480,691,2097,2175,4272
00683600,MOTLOW STATE COMMUNITY COLLEGE          ,TN,37388-7972,Public       ,434,615,1049,5058,2900,7958
00732941,ITT TECHNICAL INSTITUTE                 ,TN,37932-3343,Proprietary  ,198,825,1023,837,2896,3733
00732958,ITT TECHNICAL INSTITUTE                 ,TN,37214-3717,Proprietary  ,123,472,595,620,1966,2586
00743900,FOUNTAINHEAD COLLEGE OF TECHNOLOGY      ,TN,37918-0000,Proprietary  ,19,98,117,194,450,644
00778200,TENNESSEE COLLEGE OF APPLIED TECHNOLOGY ,TN,37055-2556,Public       ,59,186,245,600,877,1477
00778300,MIDDLE TENNESSEE SCH OF ANESTHESIA      ,TN,37116-0000,Private      ,2,51,53,26,181,207
00793803,NASHVILLE AUTO DIESEL COLLEGE - NASHVILL,TN,37206-3210,Proprietary  ,252,129,381,1842,697,2539
00814500,NASHVILLE STATE TECH CMNTY COLLEGE      ,TN,37209-0000,Public       ,785,2010,2795,7037,9315,16352
00865500,GENESIS CAREER COLLEGE                  ,TN,38501-1959,Proprietary  ,40,127,167,136,320,456
00885900,JOHN A GUPTON COLLEGE                   ,TN,37203-2934,Private      ,13,29,42,112,174,286
00886300,WALTERS STATE COMMUNITY COLLEGE         ,TN,37813-6899,Public       ,277,669,946,5140,3550,8690
00946400,TENNESSEE COLLEGE OF APPLIED TECHNOLOGY-,TN,38478-4541,Public       ,26,86,112,283,334,617
00956700,TENNESSEE SCHOOL OF BEAUTY              ,TN,37921-3303,Proprietary  ,29,108,137,204,359,563
00971000,TENNESSEE COLLEGE OF APPLIED TECHNOLOGY ,TN,37756-4149,Public       ,22,63,85,139,208,347
00991200,VOLUNTEER STATE COMMUNITY COLLEGE       ,TN,37066-3188,Public       ,619,1047,1666,6032,4335,10367
00991400,ROANE STATE COMMUNITY COLLEGE           ,TN,37748-8664,Public       ,309,860,1169,4853,4206,9059
01032600,TENNESSEE COLLEGE OF APPLIED TECHNOLOGY ,TN,37748-5849,Public       ,37,60,97,314,375,689
01043900,SOUTHWEST TENNESSEE COMMUNITY COLLG     ,TN,38104-3322,Public       ,1204,2926,4130,9887,12023,21910
01046000,AMERICAN BAPTIST THEOLOGICAL SEMINA     ,TN,37207-4994,Private      ,4,55,59,61,227,288
01052900,MEMPHIS THEOLOGICAL SEMINARY            ,TN,38104-0000,Private      ,4,92,96,33,330,363
01070000,TENNESSEE COLLEGE OF APPLIED TECHNOLOGY-,TN,37757-2461,Public       ,17,43,60,228,296,524
01155300,WM R MOORE COLLEGE OF TECHNOLOGY        ,TN,38104-0000,Private      ,37,96,133,203,370,573
01216400,TENNESSEE COLLEGE OF APPLIED TECHNOLOGY ,TN,38063-7359,Public       ,24,84,108,101,248,349
01269300,PELLISSIPPI STATE COMMUNITY COLLEGE     ,TN,37933-0990,Public       ,751,1363,2114,8358,5871,14229
02069303,VATTEROTT COLLEGE -                     ,TN,38016-5877,Proprietary  ,46,142,188,142,528,670
02092800,TENNESSEE COLLEGE OF APPLIED TECHNOLOGY ,TN,38075-0489,Public       ,35,88,123,205,300,505
02103500,TENNESSEE COLLEGE OF APPLIED TECHNOLOGY ,TN,37129-3311,Public       ,83,256,339,774,1043,1817
02106400,O'MORE COLLEGE OF DESIGN                ,TN,37064-0000,Private      ,16,20,36,176,91,267
02125300,NASHVILLE CLG OF MEDICAL CAREERS        ,TN,37115-0000,Proprietary  ,9,60,69,44,180,224
02153100,JON NAVE UNIVERSITY OF COSMETOLOGY      ,TN,37013-3347,Proprietary  ,24,53,77,95,209,304
02157100,CONCORDE CAREER COLLEGE                 ,TN,38137-0000,Proprietary  ,162,710,872,800,2696,3496
02160307,INTERNATIONAL ACADEMY OF DESIGN & TECH  ,TN,37212-0000,Proprietary  ,3,32,35,102,139,241
02188300,PENTECOSTAL THEOLOGICAL SEMINARY        ,TN,37320-0000,Private      ,2,70,72,8,297,305
02204200,"CHATTANOOGA COLLEGE - MEDICAL, DENTAL AN",TN,37411-0000,Proprietary  ,45,221,266,259,787,1046
02237900,TENNESSEE COLLEGE OF APPLIED TECHNOLOGY-,TN,38242-5023,Public       ,35,101,136,231,483,714
02255000,KNOXVILLE INSTITUTE OF HAIR DESIGN      ,TN,37917-0000,Proprietary  ,7,52,59,74,188,262
02257400,ARNOLD'S BEAUTY SCHOOL                  ,TN,38358-0000,Proprietary  ,13,23,36,54,85,139
02275500,REUBEN-ALLEN COLLEGE                    ,TN,37922-0000,Proprietary  ,28,80,108,101,251,352
02278700,MR WAYNES SCH OF UNISEX HAIR DESIGN     ,TN,38501-0000,Proprietary  ,10,15,25,43,52,95
02293900,VOLUNTEER BEAUTY ACADEMY-NASHVILLE      ,TN,37115-2112,Proprietary  ,5,23,28,17,55,72
02294000,VOLUNTEER BEAUTY ACADEMY-DYERSBURG      ,TN,38024-1622,Proprietary  ,5,19,24,31,67,98
02326200,KAPLAN CAREER INSTITUTE                 ,TN,37212-5318,Proprietary  ,46,294,340,206,1059,1265
02326300,MEDVANCE INSTITUTE                      ,TN,38501-4305,Proprietary  ,22,105,127,84,273,357
02335900,VOLUNTEER BEAUTY ACADEMY-NASHVILLE      ,TN,37209-3033,Proprietary  ,6,43,49,70,138,208
02539800,QUEEN CITY COLLEGE                      ,TN,37042-0000,Proprietary  ,12,82,94,69,302,371
02540000,TENNESSEE ACADEMY OF COSMETOLOGY        ,TN,38133-0000,Proprietary  ,23,120,143,177,372,549
02578200,NOSSI COLLEGE OF ART                    ,TN,37115-5138,Proprietary  ,27,46,73,400,294,694
02595000,FAYETTEVILLE BEAUTY SCHOOL              ,TN,37334-2909,Proprietary  ,6,27,33,31,60,91
02599710,VATTEROTT COLLEGE - MEMPHIS             ,TN,38132-1714,Proprietary  ,80,336,416,389,1469,1858
02609204,VATTEROTT COLLEGE - VATTEROTT CAREER COL,TN,38133-4727,Proprietary  ,61,229,290,303,853,1156
02614200,MILLER MOTTE BUSINESS COLLEGE           ,TN,37040-6023,Proprietary  ,45,214,259,200,817,1017
02614203,MILLER - MOTTE TECHNICAL COLLEGE - CHATT,TN,37421-7220,Proprietary  ,46,267,313,237,829,1066
02614204,MILLER - MOTTE TECHNICAL COLLEGE - MADIS,TN,37072-1870,Proprietary  ,39,150,189,119,463,582
03001800,FREE WILL BAPTIST BIBLE COLLEGE         ,TN,37205-2498,Private      ,60,31,91,257,117,374
03008800,FRANKLIN ACADEMY                        ,TN,37312-3939,Private      ,5,37,42,29,96,125
03010606,VIRGINIA COLLEGE - SCH OF BUSNSS & HLTH ,TN,37411-5600,Proprietary  ,28,205,233,198,914,1112
03024900,TENNESSEE ACADEMY OF COSMETOLOGY        ,TN,38125-3442,Proprietary  ,25,106,131,226,393,619
03026517,REMINGTON COLLEGE - MEMPHIS             ,TN,38132-2107,Private      ,55,223,278,390,978,1368
03061100,GENESIS CAREER COLLEGE OF LEBANON       ,TN,37087-2718,Proprietary  ,29,69,98,76,176,252
03079100,NORTH CENTRAL INSTITUTE                 ,TN,37042-3116,Proprietary  ,10,48,58,60,180,240
03088800,"WATKINS COLLEGE OF ART, DESIGN & FILM   ",TN,37228-1306,Private      ,33,48,81,548,255,803
03126900,STYLES & PROFILES BEAUTY COLLEGE        ,TN,38375-2109,Proprietary  ,2,8,10,12,25,37
03253300,PAUL MITCHELL THE SCHOOL MEMPHIS        ,TN,38133-4067,Proprietary  ,21,62,83,124,191,315
03355400,RICHMONT GRADUATE UNIVERSITY            ,TN,37404-0000,Private      ,0,53,53,11,230,241
03440300,BAPTIST MEMORIAL COLLEGE OF HEALTH      ,TN,38104-3104,Private      ,85,349,434,1141,2151,3292
03480303,FORTIS INSTITUTE - NASHVILLE            ,TN,37211-1536,Proprietary  ,36,197,233,111,556,667
03513500,WILLIAMSON CHRISTIAN COLLEGE            ,TN,37067-8237,Private      ,6,9,15,42,51,93
03647300,NEW CONCEPTS SCHOOL OF COSMETOLOGY      ,TN,37311-7373,Proprietary  ,2,21,23,24,59,83
03683300,INTERNATIONAL BARBER & STYLE COLLEGE    ,TN,37209-2205,Proprietary  ,12,57,69,47,131,178
03701300,MEMPHIS INSTITUTE OF BARBERING          ,TN,38107-4334,Proprietary  ,33,99,132,179,362,541
03774400,SHEAR ACADEMY                           ,TN,38555-4177,Proprietary  ,0,13,13,20,51,71
03830300,SAE INSTITUTE OF TECHNOLOGY             ,TN,37203-4310,Proprietary  ,71,120,191,264,393,657
03840300,OXFORD GRADUATE SCHOOL                  ,TN,37321-6736,Private      ,0,7,7,7,32,39
03841300,CAREER BEAUTY COLLEGE                   ,TN,38464-3634,Proprietary  ,3,13,16,16,53,69
03920300,INSTITUTE OF HAIR DESIGN                ,TN,38310-1801,Proprietary  ,4,8,12,25,37,62
03930300,BUCHANAN BEAUTY COLLEGE                 ,TN,37160-2741,Proprietary  ,8,28,36,37,76,113
03982300,VISIBLE SCHOOL - MUSIC AND WORSHIPS ARTS,TN,38104-5814,Private      ,15,32,47,147,126,273
04035300,TENNESSEE CAREER INSTITUTE              ,TN,38401-6335,Proprietary  ,19,61,80,110,181,291
04124100,ELITE COLLEGE OF COSMETOLOGY            ,TN,38351-1431,Proprietary  ,5,21,26,27,63,90
04142000,AUSTIN'S BEAUTY COLLEGE                 ,TN,37040-3107,Proprietary  ,6,31,37,20,78,98
04157200,LOVE BEAUTY SCHOOL                      ,TN,37355-2950,Proprietary  ,4,18,22,28,43,71
04165000,MERIDIAN INSTITUTE OF SURGICAL ASSISTING,TN,37080-0758,Proprietary  ,1,99,100,11,383,394
04174600,NASHVILLE BARBER AND STYLE ACADEMY      ,TN,37208-2826,Proprietary  ,8,51,59,54,150,204
04203600,FRANKLIN HAIR ACADEMY SCHOOL OF COSMETOL,TN,37064-2126,Proprietary  ,1,10,11,1,10,11
04210200,MID-SOUTH CHRISTIAN COLLEGE             ,TN,38118-3151,Private      ,10,41,51,72,165,237
04213800,SALON PROFESSIONAL ACADEMY (THE)        ,TN,37214-2163,Proprietary  ,14,41,55,82,113,195
04215200,VIBE BARBER COLLEGE                     ,TN,38107-2538,Proprietary  ,5,41,46,58,155,213
04223900,MIND BODY INSTITUTE                     ,TN,37214-1012,Proprietary  ,3,28,31,24,124,148
04236400,SANDRA ACADEMY OF SALON SERVICES        ,TN,37825-7239,Proprietary  ,4,23,27,13,56,69
04238600,GOULD'S ACADEMY                         ,TN,38119-5317,Proprietary  ,36,83,119,116,212,328
04240700,IMAGE MAKER BEAUTY INSTITUTE            ,TN,37075-4488,Proprietary  ,4,4,8,4,4,8
00353700,ABILENE CHRISTIAN UNIVERSITY            ,TX,79699-3701,Private      ,492,419,911,6297,1569,7866
00353900,ALVIN COMMUNITY COLLEGE                 ,TX,77511-4807,Public       ,358,749,1107,1422,2420,3842
00354000,AMARILLO COLLEGE                        ,TX,79109-2446,Public       ,896,1826,2722,3520,5412,8932
00354100,ANGELO STATE UNIVERSITY                 ,TX,76909-5069,Public       ,700,768,1468,6135,3098,9233
00354300,AUSTIN COLLEGE                          ,TX,75090-4440,Private      ,87,50,137,2175,270,2445
00354400,AUSTIN PRESBYTERIAN THEOLOGICAL SEM     ,TX,78705-5797,Private      ,0,16,16,2,139,141
00354500,BAYLOR UNIVERSITY                       ,TX,76798-7048,Private      ,1151,723,1874,25264,4780,30044
00354600,COASTAL BEND COLLEGE                    ,TX,78102-2197,Public       ,469,657,1126,1680,1866,3546
00354900,BLINN COLLEGE                           ,TX,77833-4098,Public       ,1908,1191,3099,14399,5005,19404
00355300,CISCO JUNIOR COLLEGE                    ,TX,76437-9803,Public       ,498,730,1228,1824,2121,3945
00355400,CLARENDON COLLEGE                       ,TX,79226-0000,Public       ,166,246,412,494,587,1081
00355600,COMMONWEALTH INST OF FUNERAL SVC        ,TX,77090-5918,Private      ,21,118,139,77,430,507
00355700,CONCORDIA UNIVERSITY TEXAS              ,TX,78726-4141,Private      ,226,723,949,1686,2518,4204
00355800,NORTH CENTRAL TEXAS COLLEGE             ,TX,76240-4699,Public       ,926,1282,2208,3641,4628,8269
00356000,DALLAS BAPTIST UNIVERSITY               ,TX,75211-9299,Private      ,543,1162,1705,3484,3617,7101
00356100,CEDAR VALLEY COLLEGE                    ,TX,75134-0000,Public       ,572,1429,2001,2186,4139,6325
00356200,DALLAS THEOLOGICAL SEM                  ,TX,75204-0000,Private      ,12,187,199,33,813,846
00356300,DEL MAR COLLEGE                         ,TX,78404-3897,Public       ,1140,1985,3125,4961,6893,11854
00356400,EAST TEXAS BAPTIST UNIVERSITY           ,TX,75670-1423,Private      ,113,114,227,1704,481,2185
00356500,TEXAS A&M UNIVERSITY - COMMERCE         ,TX,75429-3011,Public       ,936,2134,3070,7354,8012,15366
00356600,EPISCOPAL THEOLOGICAL SEMINARY OF THE SO,TX,78705-3128,Private      ,1,21,22,2,62,64
00356800,FRANK PHILLIPS COLLEGE                  ,TX,79008-0000,Public       ,130,216,346,383,498,881
00357000,GRAYSON COUNTY COLLEGE                  ,TX,75020-8299,Public       ,535,1068,1603,1603,2851,4454
00357100,HARDIN-SIMMONS UNIVERSITY               ,TX,79698-6050,Private      ,226,214,440,1917,920,2837
00357200,TRINITY VALLEY COMMUNITY COLLEGE        ,TX,75751-2734,Public       ,501,984,1485,2336,3601,5937
00357300,HILL COLLEGE                            ,TX,76645-2711,Public       ,227,375,602,1024,1156,2180
00357301,HILL COLLEGE                            ,TX,76031-0000,Public       ,268,553,821,977,1635,2612
00357400,HOWARD COUNTY JUNIOR COLLEGE DISTRICT   ,TX,79720-0213,Public       ,288,590,878,1230,1906,3136
00357500,HOWARD PAYNE UNIVERSITY                 ,TX,76801-2715,Private      ,139,105,244,1489,402,1891
00357600,HOUSTON BAPTIST UNIVERSITY              ,TX,77074-3298,Private      ,463,752,1215,5643,3391,9034
00357700,HUSTON - TILLOTSON UNIVERSITY           ,TX,78702-2795,Private      ,206,287,493,1176,1124,2300
00357800,UNIVERSITY OF THE INCARNATE WORD        ,TX,78209-6398,Private      ,567,1306,1873,6802,6687,13489
00357900,JACKSONVILLE COLLEGE                    ,TX,75766-4759,Private      ,47,65,112,266,208,474
00358000,KILGORE COLLEGE                         ,TX,75662-3299,Public       ,650,1057,1707,2778,3539,6317
00358100,LAMAR UNIVERSITY-BEAUMONT               ,TX,77710-0042,Public       ,1108,3159,4267,8530,10270,18800
00358200,LAREDO COMMUNITY COLLEGE                ,TX,78040-4395,Public       ,1428,984,2412,5793,2990,8783
00358300,LEE COLLEGE                             ,TX,77520-4796,Public       ,460,1000,1460,1936,3431,5367
00358400,LETOURNEAU UNIVERSITY                   ,TX,75607-0000,Private      ,170,597,767,1557,2024,3581
00358600,LUBBOCK CHRISTIAN UNIVERSITY            ,TX,79407-2099,Private      ,230,338,568,1575,1376,2951
00358800,UNIVERSITY OF MARY HARDIN-BAYLOR        ,TX,76513-2599,Private      ,270,307,577,5450,1730,7180
00359000,MCLENNAN COMMUNITY COLLEGE              ,TX,76708-1498,Public       ,815,1717,2532,4284,5942,10226
00359100,MCMURRY UNIVERSITY                      ,TX,79697-0001,Private      ,177,172,349,1392,603,1995
00359200,MIDWESTERN STATE UNIVERSITY             ,TX,76308-2099,Public       ,551,664,1215,5190,2887,8077
00359300,NAVARRO COLLEGE                         ,TX,75110-4818,Public       ,1189,1808,2997,4555,5172,9727
00359400,UNIVERSITY OF NORTH TEXAS               ,TX,76203-5017,Public       ,3313,3599,6912,33415,17404,50819
00359500,OBLATE SCHOOL OF THEOLOGY               ,TX,78216-0000,Private      ,3,12,15,12,47,59
00359600,ODESSA COLLEGE                          ,TX,79764-7127,Public       ,409,824,1233,1511,2505,4016
00359800,OUR LADY OF THE LAKE UNIVERSITY         ,TX,78207-4689,Private      ,197,990,1187,3962,3872,7834
00359900,UNIVERSITY OF TEXAS - PAN AMERICAN      ,TX,78541-2999,Public       ,1495,2389,3884,22409,12630,35039
00360000,PANOLA COLLEGE                          ,TX,75633-2397,Public       ,268,617,885,1045,1845,2890
00360100,PARIS JR COLLEGE                        ,TX,75460-6298,Public       ,570,905,1475,1943,2509,4452
00360200,PAUL QUINN COLLEGE                      ,TX,75241-4398,Private      ,87,184,271,675,661,1336
00360300,RANGER COLLEGE                          ,TX,76470-3298,Public       ,172,212,384,716,686,1402
00360305,RANGER COLLEGE-STEPHENVILE BEAUTY COLLEG,TX,76401-5136,Public       ,30,42,72,143,124,267
00360400,RICE UNIVERSITY                         ,TX,77251-1892,Private      ,396,544,940,11272,2844,14116
00360600,SAM HOUSTON STATE UNIVERSITY            ,TX,77340-0000,Public       ,2372,2173,4545,22461,10125,32586
00360700,ALAMO CMTY CLG DISTRICT PROGRAM         ,TX,78207-0000,Public       ,166,322,488,1396,1878,3274
00360800,ST PHILLIPS COLLEGE                     ,TX,78203-2098,Public       ,916,2343,3259,5483,8999,14482
00360900,SAN JACINTO CLG-CENTRAL-NORTH-SOUTH     ,TX,77501-0000,Public       ,2595,4313,6908,10520,13825,24345
00361000,SCHREINER UNIVERSITY                    ,TX,78028-5697,Private      ,73,109,182,1451,489,1940
00361100,SOUTH PLAINS COLLEGE                    ,TX,79336-6504,Public       ,1084,1393,2477,4902,4822,9724
00361200,UNIV OF HOUSTON-DOWNTOWN                ,TX,77002-1001,Public       ,1731,4268,5999,12522,18225,30747
00361300,SOUTHERN METHODIST UNIVERSITY           ,TX,75275-0181,Private      ,482,949,1431,8271,4894,13165
00361400,SOUTHWEST TEXAS JR COLLEGE              ,TX,78801-6221,Public       ,658,791,1449,2486,2325,4811
00361500,TEXAS STATE UNIVERSITY--SAN MARCOS      ,TX,78666-4602,Public       ,3015,2167,5182,40012,14588,54600
00361600,SOUTHWESTERN ASSEMBLIES OF GOD UNIV     ,TX,75165-2397,Private      ,331,339,670,1639,1124,2763
00361800,SOUTHWESTERN CHRISTIAN COLLEGE          ,TX,75160-3400,Private      ,61,50,111,160,130,290
00361900,SOUTHWESTERN ADVENTIST UNIVERSITY       ,TX,76059-1922,Private      ,113,89,202,812,367,1179
00362000,SOUTHWESTERN UNIVERSITY                 ,TX,78626-6111,Private      ,105,61,166,2498,332,2830
00362100,ST EDWARDS UNIVERSITY                   ,TX,78704-0000,Private      ,222,373,595,6053,2228,8281
00362300,ST MARY'S UNIV OF SAN ANTONIO           ,TX,78228-8500,Private      ,235,481,716,4810,3062,7872
00362400,STEPHEN F AUSTIN STATE UNIVERSITY       ,TX,75962-0001,Public       ,1591,1194,2785,14867,4896,19763
00362500,SUL ROSS STATE UNIVERSITY               ,TX,79832-0113,Public       ,272,551,823,1975,1806,3781
00362600,TARRANT COUNTY COLLEGE                  ,TX,76102-6599,Public       ,4366,8469,12835,19385,28907,48292
00362700,TEMPLE COLLEGE                          ,TX,76504-7435,Public       ,542,1494,2036,2212,4517,6729
00362800,TEXARKANA COLLEGE                       ,TX,75599-0001,Public       ,343,939,1282,1280,2843,4123
00363000,PRAIRIE VIEW A&M UNIVERSITY             ,TX,77446-2967,Public       ,1100,1351,2451,11392,5841,17233
00363100,TARLETON STATE UNIVERSITY               ,TX,76402-0000,Public       ,1049,1137,2186,10457,5899,16356
00363200,TEXAS A&M UNIVERSITY                    ,TX,77843-1246,Public       ,3420,1908,5328,50992,14417,65409
00363208,TEXAS A&M UNIVERSITY - BRYAN            ,TX,77807-3260,Public       ,0,0,0,45,49,94
00363400,TEXAS STATE TECHNICAL CLG AT WACO       ,TX,76705-1695,Public       ,1006,1651,2657,3785,4278,8063
00363410,TEXAS STATE TECHNICAL COLLEGE - HARLINGE,TX,78550-3697,Public       ,668,799,1467,3999,3151,7150
00363412,TEXAS STATE TECHNICAL COLLEGE - SWEETWAT,TX,79556-4108,Public       ,85,211,296,510,960,1470
00363416,TEXAS STATE TECHNICAL COLLEGE - MARSHALL,TX,75672-7404,Public       ,123,162,285,468,493,961
00363500,TEXAS CHIROPRACTIC COLLEGE              ,TX,77505-1699,Private      ,3,58,61,13,330,343
00363600,TEXAS CHRISTIAN UNIVERSITY              ,TX,76129-0001,Private      ,783,694,1477,13581,4005,17586
00363700,JARVIS CHRISTIAN COLLEGE                ,TX,75765-1470,Private      ,196,173,369,771,428,1199
00363800,TEXAS COLLEGE                           ,TX,75702-4500,Private      ,273,309,582,1051,892,1943
00363900,TEXAS A&M UNIVERSITY-KINGSVILLE         ,TX,78363-8203,Public       ,868,1546,2414,10926,7410,18336
00364100,TEXAS LUTHERAN UNIVERSITY               ,TX,78155-5999,Private      ,259,91,350,2039,372,2411
00364200,TEXAS SOUTHERN UNIVERSITY               ,TX,77004-4598,Public       ,1557,2974,4531,11282,12009,23291
00364400,TEXAS TECH UNIVERSITY                   ,TX,79409-2011,Public       ,3056,2356,5412,30229,11550,41779
00364500,TEXAS WESLEYAN UNIVERSITY               ,TX,76105-1536,Private      ,221,467,688,2152,2868,5020
00364600,TEXAS WOMAN'S UNIVERSITY                ,TX,76204-5587,Public       ,801,1911,2712,9853,12247,22100
00364700,TRINITY UNIVERSITY                      ,TX,78212-7200,Private      ,202,169,371,3630,920,4550
00364800,TYLER JUNIOR COLLEGE                    ,TX,75701-3436,Public       ,1502,1765,3267,8118,6497,14615
00365100,UNIVERSITY OF DALLAS                    ,TX,75062-4799,Private      ,145,324,469,2567,1360,3927
00365200,UNIVERSITY OF HOUSTON                   ,TX,77204-2010,Public       ,3927,5485,9412,35198,26345,61543
00365400,UNIVERSITY OF ST THOMAS                 ,TX,77006-4626,Private      ,211,664,875,1839,2458,4297
00365600,UNIVERSITY OF TEXAS-ARLINGTON           ,TX,76019-0000,Public       ,2131,5920,8051,24056,30137,54193
00365800,UNIVERSITY OF TEXAS-AUSTIN              ,TX,78713-7758,Public       ,2467,2168,4635,47818,18195,66013
00365900,UT HEALTH CENTER-SAN ANTONIO            ,TX,78229-3900,Public       ,134,432,566,1344,4118,5462
00366100,UNIVERSITY OF TEXAS-EL PASO             ,TX,79968-0629,Public       ,2078,3245,5323,18388,13899,32287
00366200,VICTORIA COLLEGE                        ,TX,77901-4494,Public       ,405,796,1201,1643,2442,4085
00366300,WAYLAND BAPTIST UNIVERSITY              ,TX,79072-6998,Private      ,268,1189,1457,1332,3534,4866
00366400,WEATHERFORD COLLEGE                     ,TX,76086-5699,Public       ,403,897,1300,2277,3161,5438
00366500,WEST TEXAS A&M UNIVERSITY               ,TX,79016-0000,Public       ,816,1101,1917,6647,4381,11028
00366800,WHARTON COUNTY JR COLLEGE               ,TX,77488-3298,Public       ,795,810,1605,3506,2751,6257
00366900,WILEY COLLEGE                           ,TX,75670-5199,Private      ,233,295,528,919,789,1708
00400300,CENTRAL TEXAS COLLEGE                   ,TX,76540-4199,Public       ,808,5662,6470,2949,16646,19595
00407221,NORTHWOOD UNIVERSITY                    ,TX,75104-0000,Private      ,22,124,146,92,471,563
00445300,EL CENTRO COLLEGE                       ,TX,75202-3604,Public       ,909,3020,3929,4911,10489,15400
00450303,EVEREST COLLEGE - FORT WORTH SOUTH      ,TX,76115-1407,Private      ,73,297,370,244,945,1189
00494900,BAYLOR COLLEGE OF MEDICINE              ,TX,77030-0000,Private      ,158,273,431,895,2022,2917
00495100,UNIV OF TEXAS HEALTH SCIENCE CENTER     ,TX,77225-0000,Public       ,126,647,773,1172,4389,5561
00495200,UNIV OF TEXAS MEDICAL BRANCH            ,TX,77550-0000,Public       ,112,438,550,923,2940,3863
00497200,GALVESTON COLLEGE                       ,TX,77550-7447,Public       ,265,477,742,1007,1600,2607
00497700,SOUTH TEXAS COLLEGE OF LAW              ,TX,77002-0000,Private      ,19,158,177,111,1754,1865
00660600,BAPTIST HS SCHOOL OF HEALTH PROFESSIONS ,TX,78229-3234,Proprietary  ,39,266,305,289,1349,1638
00661200,COVENANT SCH OF NSG & ALLIED HEALTH     ,TX,79410-0000,Private      ,29,92,121,178,437,615
00666100,ANGELINA COLLEGE                        ,TX,75902-0000,Public       ,595,1046,1641,2267,3068,5335
00694100,DALLAS CHRISTIAN COLLEGE                ,TX,75234-7229,Private      ,94,133,227,366,493,859
00709600,COLLEGE OF THE MAINLAND                 ,TX,77591-2499,Public       ,327,853,1180,1202,2745,3947
00728700,BRAZOSPORT COLLEGE                      ,TX,77566-3199,Public       ,356,443,799,1395,1754,3149
00732907,ITT TECHNICAL INSTITUTE                 ,TX,77063-3751,Proprietary  ,86,341,427,364,1087,1451
00732913,ITT TECHNICAL INSTITUTE                 ,TX,76011-3919,Proprietary  ,122,476,598,360,1427,1787
00732975,ITT TECHNICAL INSTITUTE                 ,TX,78249-3303,Proprietary  ,73,287,360,332,966,1298
00793804,LINCOLN COLLEGE OF TECHNOLOGY - GRAND PR,TX,75052-7605,Proprietary  ,133,165,298,684,616,1300
00849800,MIMS CLASSIC BEAUTY COLLEGE             ,TX,78216-0000,Proprietary  ,3,30,33,34,76,110
00850300,MOUNTAIN VIEW COLLEGE                   ,TX,75211-6599,Public       ,920,1707,2627,4224,5725,9949
00850400,RICHLAND COLLEGE                        ,TX,75243-2199,Public       ,1407,2596,4003,5911,8372,14283
00851000,EASTFIELD COLLEGE                       ,TX,75150-2099,Public       ,1121,2194,3315,4829,7162,11991
00907905,EVEREST COLLEGE                         ,TX,75206-5209,Private      ,84,366,450,296,1205,1501
00908200,INTERNATIONAL BUSINESS COLLEGE          ,TX,79903-0000,Proprietary  ,37,112,149,127,299,426
00916300,SAN ANTONIO COLLEGE                     ,TX,78212-4299,Public       ,2032,4179,6211,12240,16761,29001
00946600,KAPLAN COLLEGE                          ,TX,78216-1899,Proprietary  ,78,328,406,282,1083,1365
00946607,KAPLAN COLLEGE - MCALLEN                ,TX,78503-1622,Proprietary  ,108,201,309,381,567,948
00946609,KAPLAN COLLEGE - CAREER CENTERS OF TEXAS,TX,78416-9900,Proprietary  ,78,240,318,200,746,946
00946610,KAPLAN COLLEGE - CAREER CENTERS OF TEXAS,TX,76103-2310,Proprietary  ,65,250,315,188,761,949
00954900,WESTERN TEXAS COLLEGE                   ,TX,79549-9501,Public       ,140,138,278,600,365,965
00965100,TEXAS A&M INTERNATIONAL UNIVERSITY      ,TX,78041-1900,Public       ,716,873,1589,6825,3203,10028
00974100,UNIVERSITY OF TEXAS AT DALLAS           ,TX,75083-0000,Public       ,1228,1897,3125,14345,9650,23995
00976800,UNIVERSITY OF NORTH TEXAS HEALTH SCIENCE,TX,76107-2699,Public       ,61,281,342,476,2915,3391
00979700,MIDLAND COLLEGE                         ,TX,79705-6397,Public       ,412,819,1231,1557,2396,3953
00982802,EVEREST INSTITUTE- AUSTIN               ,TX,78754-0000,Private      ,52,221,273,178,672,850
00993000,UNIVERSITY OF TEXAS-PERMIAN BASIN       ,TX,79762-0001,Public       ,490,979,1469,2482,3250,5732
01001900,UNIV OF TEXAS SOUTHWESTERN MED CTR      ,TX,75390-9096,Public       ,55,242,297,382,2100,2482
01006000,VERNON COLLEGE                          ,TX,76384-4092,Public       ,259,654,913,1213,2288,3501
01011500,UNIVERSITY OF TEXAS-SAN ANTONIO         ,TX,78249-0600,Public       ,2384,2914,5298,35210,16700,51910
01013000,WADE COLLEGE                            ,TX,75207-3199,Proprietary  ,28,80,108,185,309,494
01038700,EL PASO COMMUNITY COLLEGE               ,TX,79998-0000,Public       ,2669,3689,6358,15224,13610,28834
01050900,HALLMARK COLLEGE OF AERONAUTICS         ,TX,78214-0000,Private      ,64,303,367,228,882,1110
01062400,LIGHTHOUSE CAREER INSTITUTE             ,TX,75231-5033,Private      ,0,4,4,4,41,45
01063300,HOUSTON COMMUNITY COLLEGE               ,TX,77002-0000,Public       ,5947,15093,21040,23155,47283,70438
01067400,TEXAS TECH U HEALTH SCIENCES CENTER     ,TX,79430-0000,Public       ,174,688,862,1582,5302,6884
01076100,DALLAS INSTITUTE OF FUNERAL SERVICE     ,TX,75227-4314,Private      ,18,103,121,93,344,437
01114500,LONE STAR COLLEGE SYSTEM                ,TX,77073-3499,Public       ,6278,11906,18184,23498,37654,61152
01116100,TEXAS A&M UNIV CORPUS CHRISTI           ,TX,78412-5599,Public       ,1320,1512,2832,13739,6243,19982
01116300,UNIVERSITY OF TEXAS AT TYLER            ,TX,75799-6699,Public       ,752,1497,2249,5606,6274,11880
01171100,UNIVERSITY OF HOUSTON-CLEAR LAKE        ,TX,77058-1002,Public       ,543,1746,2289,3529,7617,11146
01201500,AUSTIN COMMUNITY COLLEGE                ,TX,78752-4390,Public       ,2517,4817,7334,15768,19228,34996
01202000,VICTORIA BEAUTY COLLEGE                 ,TX,77901-6233,Proprietary  ,12,60,72,41,135,176
01226800,BALDWIN BEAUTY SCHOOL #5                ,TX,78704-4785,Proprietary  ,26,91,117,117,293,410
01229700,LAREDO BEAUTY COLLEGE                   ,TX,78040-1051,Proprietary  ,37,68,105,116,195,311
01248200,ATI TECHNICAL TRAINING CENTER           ,TX,75235-4622,Proprietary  ,7,74,81,74,255,329
01248209,ATI CAREER TRAINING CENTER - GARLAND    ,TX,75041-2497,Proprietary  ,1,20,21,15,68,83
01248210,ATI CAREER TRAINING CENTER - WACO       ,TX,76711-1682,Proprietary  ,5,55,60,65,150,215
01248300,COSMETOLOGY CAREER CENTER-A PAUL MITCHEL,TX,75006-2567,Proprietary  ,174,308,482,490,718,1208
01248800,INTERNATIONAL BEAUTY COLLEGE NO 3       ,TX,75040-0000,Proprietary  ,2,19,21,16,68,84
01276400,METROPLEX BEAUTY SCHOOL                 ,TX,75149-0000,Proprietary  ,6,37,43,22,113,135
01293000,CHARLES & SUE'S SCH OF HAIR DESIGN      ,TX,77801-0000,Proprietary  ,19,25,44,62,88,150
01293200,TINT SCHOOL OF MAKEUP & COSMETOLOGY     ,TX,75061-4235,Proprietary  ,31,56,87,72,152,224
01300300,NEILSON BEAUTY COLLEGE                  ,TX,75208-4637,Proprietary  ,6,31,37,32,95,127
01301600,OGLE SCHOOL HAIR SKIN NAILS             ,TX,76013-7400,Proprietary  ,112,288,400,350,707,1057
01303912,SOUTH UNIVERSITY - THE ART INSTITUTE OF ,TX,75231-5993,Proprietary  ,200,262,462,1015,835,1850
01303915,SOUTH UNIVERSITY - AUSTIN               ,TX,78729-8101,Proprietary  ,34,249,283,215,813,1028
01323100,UNIVERSITY OF HOUSTON-VICTORIA          ,TX,77901-5731,Public       ,301,924,1225,3072,3744,6816
02058600,CONLEE'S COLLEGE OF COSMETOLOGY         ,TX,78028-0000,Proprietary  ,5,23,28,9,51,60
02077400,NORTH LAKE COLLEGE                      ,TX,75038-0000,Public       ,771,1758,2529,3175,5557,8732
02081400,ARLINGTON BAPTIST COLLEGE               ,TX,76012-0000,Private      ,58,84,142,252,303,555
02098300,WESTERN TECHNICAL COLLEGE               ,TX,79927-2105,Proprietary  ,201,488,689,892,1753,2645
02100200,BROOKHAVEN COLLEGE                      ,TX,75244-0000,Public       ,701,1659,2360,2930,5528,8458
02113610,AMERICAN INTERCONTINENTAL UNIV - HOUSTON,TX,77042-4516,Proprietary  ,48,369,417,190,1061,1251
02116008,SANFORD-BROWN COLLEGE - HOUSTON         ,TX,77042-8900,Proprietary  ,37,167,204,259,885,1144
02117100,ART INSTITUTE OF HOUSTON                ,TX,77056-0000,Proprietary  ,843,1168,2011,3720,3942,7662
02128302,INSTITUTE FOR BUSINESS & TECHNOLOGY - LA,TX,78230-2520,Proprietary  ,30,141,171,119,377,496
02144800,VET TECH INSTITUTE OF HOUSTON           ,TX,77027-9881,Proprietary  ,51,79,130,374,385,759
02176100,PIPO ACADEMY OF HAIR DESIGN             ,TX,79903-0000,Proprietary  ,10,42,52,49,115,164
02218300,SOUTHWEST SCHOOL OF BUSINESS & TECHNICAL,TX,78221-0000,Proprietary  ,22,83,105,75,224,299
02218305,SOUTHWEST SCHOOL OF BUSINESS AND TECHNIC,TX,78501-6053,Proprietary  ,9,28,37,47,89,136
02224600,TRI-STATE BEAUTY SCHOOL #1              ,TX,79915-0000,Proprietary  ,19,81,100,100,261,361
02230500,OGLE SCHOOL HAIR SKIN NAILS             ,TX,76132-3638,Proprietary  ,122,308,430,354,854,1208
02230600,OGLE SCHOOL HAIR SKIN NAILS             ,TX,76053-4650,Proprietary  ,84,185,269,196,454,650
02239100,CENTRAL TEXAS BEAUTY COLLEGE #2         ,TX,78664-4204,Proprietary  ,30,101,131,108,294,402
02248200,MILAN INSTITUTE OF COSMETOLOGY          ,TX,79103-0000,Proprietary  ,156,388,544,409,1072,1481
02250603,EVEREST COLLEGE - ARLINGTON             ,TX,76011-6630,Private      ,61,272,333,167,754,921
02254800,TEXAS VOCATIONAL SCHOOLS                ,TX,77901-0000,Proprietary  ,7,33,40,27,112,139
02259400,AMBERTON UNIVERSITY                     ,TX,75041-0000,Private      ,9,107,116,39,368,407
02261300,EVEREST INSTITUTE                       ,TX,78213-3841,Private      ,50,233,283,137,660,797
02261302,EVEREST INSTITUTE - HOUSTON GREENSPOINT ,TX,77060-3249,Private      ,94,325,419,241,949,1190
02261303,EVEREST INSTITUTE - HOUSTON HOBBY       ,TX,77087-2737,Private      ,73,217,290,179,680,859
02267100,EXPOSITO SCHOOL OF HAIR DESIGN          ,TX,79109-0000,Proprietary  ,8,22,30,22,71,93
02285900,UNIVERSITY OF COSMETOLOGY ARTS&SCI      ,TX,78504-0000,Proprietary  ,76,189,265,245,471,716
02298501,EVEREST COLLEGE- FORT WORTH             ,TX,76137-2472,Proprietary  ,0,0,0,67,292,359
02305300,PARKER COLLEGE OF CHIROPRACTIC          ,TX,75229-0000,Private      ,25,317,342,104,1327,1431
02306700,FORT WORTH BEAUTY SCHOOL                ,TX,76116-3299,Proprietary  ,23,103,126,84,285,369
02306809,SOUTH TEXAS VOCATIONAL TECHNICAL INSTITU,TX,78501-2400,Proprietary  ,98,151,249,373,450,823
02306810,SOUTH TEXAS VOCATIONAL TECHNICAL INSTITU,TX,78416-1141,Proprietary  ,64,162,226,144,475,619
02312200,TEXAS SCHOOL OF BUSINESS                ,TX,77073-6032,Proprietary  ,92,335,427,286,966,1252
02312202,TEXAS SCHOOL OF BUSINESS - FRIENDSWOOD C,TX,77546-8938,Proprietary  ,21,50,71,43,205,248
02313901,WESTWOOD COLLEGE - DALLAS               ,TX,75243-0000,Proprietary  ,9,85,94,84,286,370
02315400,NORTHEAST TEXAS COMMUNITY COLLEGE       ,TX,75456-0000,Public       ,465,720,1185,1545,1947,3492
02318200,"KD STUDIO, ACTOR'S CONSERVATORY         ",TX,75207-2111,Proprietary  ,35,55,90,173,199,372
02320200,HOUSTON GRADUATE SCHOOL OF THEOLOGY     ,TX,77092-0000,Private      ,2,90,92,13,249,262
02326000,SAN ANTONIO BEAUTY COLLEGE NO 3         ,TX,78217-0000,Proprietary  ,13,54,67,79,156,235
02331200,BAPTIST MISSIONARY ASSN THEOL SEM       ,TX,75766-0000,Private      ,4,36,40,8,86,94
02331300,INTERACTIVE LEARNING SYSTEMS            ,TX,77502-1201,Proprietary  ,10,99,109,26,220,246
02331301,INTERACTIVE LEARNING SYSTEMS            ,TX,77081-0000,Proprietary  ,39,286,325,93,617,710
02331304,INTERACTIVE LEARNING SYSTEMS            ,TX,77060-0000,Proprietary  ,14,69,83,36,181,217
02341300,PALO ALTO COLLEGE                       ,TX,78224-0000,Public       ,966,1735,2701,5932,6591,12523
02348500,LAMAR STATE COLLEGE-PORT ARTHUR         ,TX,77640-0000,Public       ,239,445,684,1014,1532,2546
02357700,PAUL MITCHELL THE SCHOOL                ,TX,77043-3412,Proprietary  ,99,230,329,340,708,1048
02358200,LAMAR STATE COLLEGE-ORANGE              ,TX,77630-0000,Public       ,290,621,911,886,1698,2584
02361400,COLLIN COUNTY COMMUNITY COLLEGE         ,TX,75071-0000,Public       ,1921,2968,4889,8095,10183,18278
02362000,UNIVERSAL TECHNICAL INSTITUTE           ,TX,77073-0000,Proprietary  ,1304,1493,2797,10885,8641,19526
02362800,AUSTIN GRADUATE SCHOOL OF THEOLOGY      ,TX,78752-1333,Private      ,2,27,29,20,92,112
02521200,ARLINGTON CAREER INSTITUTE              ,TX,75050-0000,Proprietary  ,24,117,141,66,353,419
02521800,SEGUIN BEAUTY SCHOOL                    ,TX,78155-0000,Proprietary  ,12,18,30,36,70,106
02527500,HOUSTON TRAINING SCHOOLS                ,TX,77029-0000,Proprietary  ,60,485,545,139,770,909
02530700,SEBRING CAREER SCHOOLS                  ,TX,77083-1510,Proprietary  ,13,85,98,25,117,142
02548800,SOUTH TEXAS VO-TECH INSTITUTE           ,TX,78596-0000,Proprietary  ,83,106,189,247,262,509
02548802,SOUTH TEXAS VOCATIONAL TECHNICAL INSTITU,TX,78520-8710,Proprietary  ,66,82,148,264,270,534
02555400,UNIV OF TX MD ANDERSON CANCER CTR       ,TX,77030-0000,Public       ,45,156,201,270,663,933
02568100,TEXAS BARBER COLLEGE                    ,TX,77063-3949,Proprietary  ,36,179,215,104,445,549
02568101,TEXAS BARBER COLLEGES & HAIRSTYLING SCHO,TX,75228-3841,Proprietary  ,31,105,136,72,277,349
02568106,TEXAS BARBER COLLEGES & HAIRSTYLING SCHO,TX,77009-0000,Proprietary  ,26,142,168,86,348,434
02568107,TEXAS BARBER COLLEGES & HAIRSTYLING SCHO,TX,77063-3951,Proprietary  ,23,124,147,76,331,407
02568108,TEXAS BARBER COLLEGES & HAIRSTYLING SCHO,TX,75241-1327,Proprietary  ,28,120,148,83,308,391
02568109,TEXAS BARBER COLLEGES & HAIRSTYLING SCHO,TX,77301-4407,Proprietary  ,0,0,0,0,4,4
02569300,LE CORDON BLEU COLLEGE OF CULINARY ARTS ,TX,78758-3647,Proprietary  ,189,487,676,941,2144,3085
02572000,COMPUTER CAREER CENTER                  ,TX,79925-2021,Proprietary  ,137,383,520,499,1382,1881
02572004,COMPUTER CAREER CENTER - AMARILLO CAMPUS,TX,79101-2404,Proprietary  ,27,148,175,58,357,415
02572005,COMPUTER CAREER CENTER - LUBBOCK CAMPUS ,TX,79414-3517,Proprietary  ,42,198,240,97,472,569
02572008,VISTA COLLEGE - BEAUMONT                ,TX,77701-3717,Proprietary  ,51,287,338,141,753,894
02572009,VISTA COLLEGE - LONGVIEW                ,TX,75604-1905,Proprietary  ,56,241,297,124,710,834
02572011,VISTA COLLEGE - KILLEEN                 ,TX,76541-7436,Proprietary  ,80,461,541,204,1395,1599
02572012,VISTA COLLEGE - COLLEGE STATION         ,TX,77840-5107,Proprietary  ,86,241,327,257,712,969
02591100,CAREER POINT COLLEGE                    ,TX,78201-2027,Proprietary  ,158,1328,1486,336,2654,2990
02591900,KAPLAN COLLEGE                          ,TX,79907-1525,Proprietary  ,87,296,383,361,916,1277
02591905,KAPLAN COLLEGE - BROWNSVILLE            ,TX,78521-9905,Proprietary  ,58,92,150,197,335,532
02596500,ATI CAREER TRAINING CENTER              ,TX,76180-1599,Proprietary  ,4,35,39,16,89,105
02596503,ATI- CAREER TRAINING CENTER - HOUSTON (#,TX,77029-1978,Proprietary  ,6,72,78,39,207,246
02596600,ATI-CAREER TRAINING CENTER              ,TX,75220-4443,Proprietary  ,3,62,65,26,181,207
02596601,ATI CAREER TRAINING CENTER - RICHARDSON ,TX,75081-1948,Proprietary  ,4,25,29,15,65,80
02596602,ATI CAREER TRAINING CENTER - DALLAS (STE,TX,75247-6103,Proprietary  ,12,111,123,58,336,394
02600200,OCEAN CORPORATION (THE)                 ,TX,77099-3479,Proprietary  ,41,244,285,147,711,858
02604700,CENTER FOR ADVANCED LEGAL STUDIES       ,TX,77098-0000,Proprietary  ,11,165,176,36,511,547
02606202,EVEREST COLLEGE - EVEREST INSTITUTE - BI,TX,77036-8014,Private      ,95,369,464,299,1133,1432
02615000,SANFORD-BROWN COLLEGE                   ,TX,75247-6931,Proprietary  ,16,121,137,150,632,782
03009400,SW SCH BUS & TECH CAREERS               ,TX,78212-2840,Proprietary  ,11,38,49,36,116,152
03010604,VIRGINIA COLLEGE - VIRGINIA COLLEGE AT A,TX,78723-0000,Proprietary  ,20,148,168,146,568,714
03011800,UNIVERSITY OF COSMETOLOGY ARTS & SCIENCE,TX,78226-1194,Proprietary  ,15,55,70,102,162,264
03019800,PCI HEALTH TRAINING CENTER              ,TX,75247-4720,Proprietary  ,53,181,234,171,541,712
03019801,PCI HEALTH TRAINING CENTER - RICHARDSON ,TX,75081-2321,Proprietary  ,29,58,87,86,186,272
03021500,SW SCH BUS & TECH CAREERS               ,TX,78852-4859,Proprietary  ,39,60,99,175,203,378
03025000,TEXAS COLLEGE OF COSMETOLOGY            ,TX,79605-2001,Proprietary  ,24,94,118,88,266,354
03025001,TEXAS COLLEGE OF COSMETOLOGY - SAN ANGEL,TX,76903-4708,Proprietary  ,11,29,40,40,109,149
03026500,REMINGTON COLLEGE - HOUSTON CAMPUS      ,TX,77082-1849,Private      ,537,1652,2189,1603,5549,7152
03026501,REMINGTON COLLEGE - NORTH HOUSTON CAMPUS,TX,77067-1849,Private      ,48,210,258,184,629,813
03026506,REMINGTON COLLEGE - FT. WORTH CAMPUS    ,TX,76112-1280,Private      ,70,282,352,276,948,1224
03028800,CIRCLE J BEAUTY SCHOOL                  ,TX,77587-3714,Proprietary  ,0,0,0,34,63,97
03030608,UTAH COLLEGE OF MASSAGE THERAPY - TEXAS ,TX,75801-4848,Proprietary  ,28,90,118,76,243,319
03030609,UTAH COLLEGE OF MASSAGE THERAPY - TEXAS ,TX,77040-6307,Proprietary  ,39,118,157,89,301,390
03031408,INTERNATIONAL ACADEMY OF DESIGN & TECHNO,TX,78229-2263,Proprietary  ,15,52,67,120,326,446
03032300,SCHOOL OF AUTOMOTIVE MACHINISTS         ,TX,77055-1803,Proprietary  ,30,87,117,141,305,446
03035200,TINT SCHOOL OF MAKEUP & COSMETOLOGY     ,TX,75229-3734,Proprietary  ,23,84,107,99,293,392
03035300,SOUTHERN CAREERS INSTITUTE              ,TX,78704-5252,Proprietary  ,394,1247,1641,735,2498,3233
03035301,SOUTHERN CAREERS INSTITUTE-PHARR        ,TX,78577-2118,Proprietary  ,67,205,272,130,387,517
03035302,SOUTHERN CAREERS INSTITUTE - CORPUS CHRI,TX,78414-2904,Proprietary  ,60,258,318,125,566,691
03035303,SOUTHERN CAREERS INSTITUTE - SAN ANTONIO,TX,78221-4351,Proprietary  ,15,64,79,62,189,251
03035305,SOUTHERN CAREERS INSTITUTE - BROWNSVILLE,TX,78520-8680,Proprietary  ,8,31,39,112,131,243
03035306,SOUTHERN CAREERS INSTITUTE - HARLINGEN  ,TX,78550-7911,Proprietary  ,19,49,68,85,141,226
03035308,SOUTHERN CAREERS INSTITUTE - SAN ANTONIO,TX,78238-4114,Proprietary  ,41,226,267,108,486,594
03061800,STAR COLLEGE OF COSMETOLOGY             ,TX,75702-8214,Proprietary  ,18,59,77,84,225,309
03064600,UNIVERSITY OF TEXAS AT BROWNSVILLE      ,TX,78520-4993,Public       ,631,1025,1656,5821,4940,10761
03073402,ITT TECHNICAL INSTITUTE                 ,TX,75080-2208,Proprietary  ,0,1,1,0,3,3
03103400,SOUTH TEXAS COLLEGE                     ,TX,78501-6699,Public       ,2800,3690,6490,15474,11386,26860
03108700,ROYAL BEAUTY CAREERS                    ,TX,77069-4611,Proprietary  ,9,19,28,50,185,235
03115800,KAPLAN COLLEGE                          ,TX,78238-4203,Proprietary  ,52,300,352,207,984,1191
03115802,KAPLAN COLLEGE - LAREDO                 ,TX,78041-6181,Proprietary  ,72,106,178,200,290,490
03115803,KAPLAN COLLEGE - BEAUMONT               ,TX,77706-3706,Proprietary  ,42,157,199,100,457,557
03115804,KAPLAN COLLEGE - LUBBOCK                ,TX,79401-2601,Proprietary  ,32,140,172,87,434,521
03128100,COLLEGE OF HEALTH CARE PROFESSIONS (THE),TX,77092-8108,Proprietary  ,273,864,1137,837,3003,3840
03144300,NATIONAL BEAUTY COLLEGE                 ,TX,75043-4046,Proprietary  ,8,26,34,16,70,86
03153300,AMER COLL OF ACUPUNCTURE & O.M.         ,TX,77063-4104,Proprietary  ,3,65,68,18,165,183
03156400,AOMA                                    ,TX,78745-1479,Proprietary  ,2,50,52,17,233,250
03159300,ARLINGTON MEDICAL INSTITUTE             ,TX,76006-2317,Proprietary  ,23,121,144,140,386,526
03170300,TEXAS A&M UNIVERSITY-TEXARKANA          ,TX,75503-5518,Public       ,184,529,713,1516,1904,3420
03179500,TEXAS HEALTH AND SCIENCE UNIVERSITY     ,TX,78704-6748,Proprietary  ,38,100,138,321,547,868
03237400,FARIS TECHNICAL INSTITUTE               ,TX,77627-3829,Proprietary  ,0,6,6,1,11,12
03272300,KAPLAN COLLEGE                          ,TX,75234-7288,Proprietary  ,85,391,476,281,1264,1545
03272303,KAPLAN COLLEGE - ARLINGTON              ,TX,76010-8121,Proprietary  ,45,269,314,159,824,983
03275300,TOUCH OF CLASS SCHOOL OF COSM           ,TX,75402-6314,Proprietary  ,20,50,70,45,137,182
03276300,ACADEMY OF HAIR DESIGN                  ,TX,75901-4900,Proprietary  ,20,73,93,55,194,249
03277300,ACADEMY OF HAIR DESIGN                  ,TX,77701-4650,Proprietary  ,10,53,63,34,140,174
03303300,NORTHWEST EDUCATIONAL CENTER            ,TX,77092-7055,Proprietary  ,24,170,194,47,313,360
03371300,TONI&GUY HAIRDRESSING ACADEMY           ,TX,75006-0000,Proprietary  ,47,68,115,127,188,315
03372300,NORTHWEST VISTA COLLEGE                 ,TX,78251-4217,Public       ,1665,2364,4029,10149,9647,19796
03400300,CAREER QUEST                            ,TX,78229-3539,Proprietary  ,27,115,142,70,360,430
03412300,ADVANCED BARBER COLLEGE & HAIR DESI     ,TX,78596-0000,Proprietary  ,28,78,106,95,174,269
03416500,DALLAS NURSING INSTITUTE                ,TX,75243-5502,Private      ,53,418,471,273,1339,1612
03422300,MILAN INSTITUTE                         ,TX,78238-3327,Proprietary  ,218,640,858,597,1631,2228
03422400,COLLEGE OF BIBLICAL STUDIES-HOUSTON     ,TX,77036-3211,Private      ,25,297,322,90,893,983
03424400,MEDVANCE INSTITUTE                      ,TX,77057-7386,Proprietary  ,59,199,258,146,586,732
03426300,COLLEGE OF HEALTH CARE PROFESSIONS (THE),TX,78752-3630,Proprietary  ,59,214,273,255,773,1028
03480304,FORTIS COLLEGE - FORTIS INSTITUTE       ,TX,75050-2342,Proprietary  ,23,122,145,62,356,418
03520300,LUBBOCK HAIR ACADEMY                    ,TX,79410-3524,Proprietary  ,16,33,49,45,115,160
03542300,CONCORDE CAREER INSTITUTE               ,TX,76011-4016,Proprietary  ,89,333,422,287,1175,1462
03556400,KUSSAD INSTITUTE OF COURT REPORTING     ,TX,78704-5712,Proprietary  ,1,4,5,7,15,22
03573300,AVIATION INSTITUTE OF MAINTENANCE       ,TX,75062-6303,Proprietary  ,51,197,248,143,475,618
03610300,MJ'S BEAUTY ACADEMY INC                 ,TX,75224-0000,Proprietary  ,22,89,111,64,196,260
03612400,VALLEY GRANDE INSTITUTE FOR ACADEMI     ,TX,78596-0000,Private      ,29,99,128,108,295,403
03627300,LAMAR INSTITUTE OF TECHNOLOGY           ,TX,77705-4142,Public       ,511,794,1305,1851,2513,4364
03680300,JAY'S TECHNICAL INSTITUTE               ,TX,77031-3509,Proprietary  ,13,83,96,36,160,196
03682400,DALLAS BARBER & STYLIST COLLEGE         ,TX,75231-0000,Proprietary  ,34,184,218,109,525,634
03714300,TREND BARBER COLLEGE                    ,TX,77071-2104,Proprietary  ,21,147,168,62,325,387
03723300,CULINARY INST ALAIN & MARIE LENOTRE     ,TX,77022-4322,Proprietary  ,87,192,279,264,583,847
03727600,AUGUSTE ESCOFFIER SCHOOL OF CULINARY ART,TX,78752-0000,Proprietary  ,66,114,180,352,370,722
03733300,BAPTIST UNIVERSITY OF THE AMERICAS      ,TX,78224-1336,Private      ,33,78,111,102,280,382
03922300,SOUTH TEXAS BARBER COLLEGE              ,TX,78415-3463,Proprietary  ,18,30,48,44,107,151
03944400,PROFESSIONAL CAREERS INSTITUTE          ,TX,77036-2252,Proprietary  ,9,49,58,28,135,163
03944401,PROFESSIONAL CAREERS INSTITUTE          ,TX,77090-3914,Proprietary  ,0,0,0,18,61,79
03970300,HANDS ON THERAPY                        ,TX,75149-2294,Proprietary  ,10,48,58,33,132,165
03987300,TEXAS HEALTH SCHOOL                     ,TX,77079-2106,Proprietary  ,46,181,227,250,592,842
04036300,SOUTHEAST TEXAS CAREER INSTITUTE        ,TX,77656-8601,Proprietary  ,9,64,73,23,120,143
04045300,NORTHWEST BEAUTY SCHOOL                 ,TX,77091-1208,Proprietary  ,18,76,94,58,196,254
04045400,MAI-TRIX BEAUTY COLLEGE                 ,TX,77040-0000,Proprietary  ,8,18,26,40,118,158
04082300,PROFESSIONAL CAREER TRAINING INSTITUTE  ,TX,77090-0000,Proprietary  ,12,113,125,39,297,336
04089400,CCI TRAINING CENTER                     ,TX,76011-4857,Proprietary  ,10,84,94,30,248,278
04117900,CHAMPION BEAUTY COLLEGE                 ,TX,77069-4611,Proprietary  ,12,101,113,65,284,349
04121800,CRISWELL COLLEGE                        ,TX,75246-1537,Private      ,23,73,96,100,318,418
04125400,ACADEMY AT AUSTIN (THE)                 ,TX,78660-3287,Proprietary  ,32,48,80,91,150,241
04125500,MANUEL AND THERESA'S SCHOOL OF HAIR DESI,TX,77803-3236,Proprietary  ,15,20,35,33,62,95
04129800,MEDIATECH INSTITUTE DALLAS              ,TX,75039-3105,Proprietary  ,39,82,121,146,247,393
04129801,MEDIATECH INSTITUTE - AUSTIN            ,TX,78704-8933,Proprietary  ,24,46,70,85,162,247
04129802,MEDIATECH INSTITUTE - HOUSTON           ,TX,77042-4712,Proprietary  ,25,92,117,75,228,303
04131700,SOUTHWEST CAREER COLLEGE                ,TX,79925-6230,Proprietary  ,306,744,1050,1022,1945,2967
04136500,PCCENTER                                ,TX,75115-4214,Proprietary  ,5,17,22,17,55,72
04138500,CARDIOTECH ULTRASOUND SCHOOL            ,TX,77099-1440,Proprietary  ,19,136,155,90,432,522
04142300,AVEDA INSTITUTE SAN ANTONIO             ,TX,78215-1260,Proprietary  ,62,165,227,248,459,707
04146700,AVIATION INSTITUTE OF MAINTENANCE       ,TX,77061-4004,Proprietary  ,43,134,177,132,370,502
04146800,SOUTH TEXAS TRAINING CENTER             ,TX,78586-7721,Proprietary  ,30,62,92,61,150,211
04152700,ASTRODOME CAREER CENTERS                ,TX,77054-2678,Proprietary  ,8,64,72,29,145,174
04154800,DUVALL'S SCHOOL OF COSMETOLOGY          ,TX,76021-4159,Proprietary  ,11,20,31,33,65,98
04155800,ADVANCED BEAUTY COLLEGE                 ,TX,75061-1918,Proprietary  ,3,33,36,22,75,97
04158500,TEXAS BEAUTY COLLEGE                    ,TX,76117-3201,Proprietary  ,6,24,30,12,44,56
04160700,AVENUE FIVE INSTITUTE                   ,TX,78757-7000,Proprietary  ,29,99,128,129,328,457
04165800,SALON PROFESSIONAL ACADEMY (THE)        ,TX,75067-2348,Proprietary  ,12,34,46,33,79,112
04168700,LAWYER'S ASSISTANT SCHOOL OF DALLAS     ,TX,75201-2829,Proprietary  ,15,116,131,59,340,399
04168800,ABC BEAUTY ACADEMY                      ,TX,75042-8682,Proprietary  ,10,26,36,26,75,101
04169000,SALON & SPA INSTITUTE                   ,TX,78521-1727,Proprietary  ,10,38,48,26,79,105
04169100,DIAMONDS COSMETOLOGY COLLEGE            ,TX,75090-2657,Proprietary  ,4,23,27,16,62,78
04177900,BUCKNER BARBER SCHOOL                   ,TX,75217-1775,Proprietary  ,13,56,69,41,158,199
04178200,VOGUE COLLEGE - SAN ANTONIO             ,TX,78201-5035,Proprietary  ,14,60,74,63,162,225
04178300,VOGUE BEAUTY ACADEMY                    ,TX,78238-4402,Proprietary  ,12,72,84,71,165,236
04178400,VOGUE COLLEGE - MCALLEN                 ,TX,78501-1945,Proprietary  ,30,86,116,111,168,279
04179500,NORTH AMERICAN UNIVERSITY               ,TX,77038-1221,Private      ,37,79,116,288,283,571
04184800,EXCEL LEARNING CENTER                   ,TX,79907-1400,Proprietary  ,61,245,306,119,426,545
04187800,CYBERTEX INSTITUTE OF TECHNOLOGY        ,TX,78752-3825,Proprietary  ,22,140,162,61,349,410
04193000,RGV CAREERS AN INSTITUTE FOR HIGHER LEAR,TX,78577-2106,Proprietary  ,23,112,135,61,327,388
04205200,WADE GORDON HAIRDRESSING ACADEMY        ,TX,79121-0548,Proprietary  ,24,49,73,72,142,214
04206501,MYCOMPUTERCAREER.COM - DALLAS           ,TX,75062-8173,Proprietary  ,10,184,194,25,462,487
04206502,MYCOMPUTERCAREER.COM - HOUSTON          ,TX,77056-6764,Proprietary  ,26,252,278,66,495,561
04213300,SPA PROFESSIONALS ACADEMY (THE)         ,TX,78504-2569,Proprietary  ,7,34,41,33,71,104
04215000,TOTAL TRANSFORMATION INSTITUTE OF COSMET,TX,78666-8115,Proprietary  ,9,17,26,48,56,104
04215400,GRACE SCHOOL OF THEOLOGY                ,TX,77384-4894,Private      ,5,52,57,11,123,134
04219700,GEMINI SCHOOL OF VISUAL ARTS & COMMUNICA,TX,78613-2642,Proprietary  ,3,7,10,20,26,46
04222600,HEATHCARE INSTITUTE (THE)               ,TX,78201-5035,Proprietary  ,26,102,128,111,296,407
04224100,COSMETOLOGY ACADEMY OF TEXARKANA        ,TX,75503-4855,Proprietary  ,13,57,70,57,182,239
04226400,MT TRAINING CENTER                      ,TX,75051-3542,Proprietary  ,6,77,83,16,138,154
04229000,BARBER INSTITUTE OF TEXAS               ,TX,75602-3456,Proprietary  ,3,27,30,9,65,74
04229500,TEXAS A&M UNIVERSITY - CENTRAL TEXAS    ,TX,76549-5901,Public       ,318,1200,1518,1771,4548,6319
04231200,NEECEE'S COLLEGE OF COSMETOLOGY         ,TX,79605-4735,Proprietary  ,12,31,43,23,85,108
04231300,YAHWEH BEAUTY ACADEMY                   ,TX,76543-4153,Proprietary  ,5,58,63,29,148,177
04231900,ALAMO CITY BARBER COLLEGE               ,TX,78250-3227,Proprietary  ,40,123,163,155,400,555
04232400,EXCEL LEARNING CENTER - SAN ANTONIO     ,TX,78230-4823,Proprietary  ,24,102,126,43,208,251
04232900,PREPARING PEOPLE BARBER STYLING COLLEGE ,TX,75215-2415,Proprietary  ,9,122,131,17,186,203
04235900,BELLA COSMETOLOGY COLLEGE               ,TX,75494-2408,Proprietary  ,3,19,22,22,70,92
04236900,K&G 5 STAR BARBER COLLEGE               ,TX,77591-3689,Proprietary  ,3,19,22,11,57,68
04238200,LAREDO CHI ACADEMY BEAUTY SCHOOL        ,TX,78041-6540,Proprietary  ,19,38,57,70,111,181
04239700,"VOCATIONAL NURSING INSTITUTE, (THE)     ",TX,77065-5399,Private      ,18,183,201,77,492,569
04242100,UNIVERSITY OF NORTH TEXAS AT DALLAS     ,TX,75241-4600,Public       ,440,1332,1772,4473,6104,10577
04243900,UNIVERSITY OF TEXAS HEALTH SCIENCE CENTE,TX,75708-3154,Public       ,35,123,158,35,123,158
04248000,"RECORDING CONSERVATORY OF AUSTIN, (THE) ",TX,78730-3004,Proprietary  ,6,9,15,6,9,15
04249300,SALON BOUTIQUE ACADEMY                  ,TX,75001-4399,Proprietary  ,4,19,23,4,19,23
00367000,BRIGHAM YOUNG UNIVERSITY                ,UT,84602-8406,Private      ,2185,3854,6039,14557,12026,26583
00367100,DIXIE STATE COLLEGE OF UTAH             ,UT,84770-3876,Public       ,1165,1205,2370,6006,3862,9868
00367200,LDS BUSINESS COLLEGE                    ,UT,84101-3500,Private      ,356,488,844,1203,1180,2383
00367400,STEVENS HENAGER COLLEGE                 ,UT,84401-1420,Proprietary  ,714,5566,6280,1821,15935,17756
00367500,UNIVERSITY OF UTAH                      ,UT,84112-9055,Public       ,2233,3628,5861,15255,15870,31125
00367700,UTAH STATE UNIVERSITY                   ,UT,84322-1400,Public       ,2323,3472,5795,13988,12267,26255
00367800,SOUTHERN UTAH UNIVERSITY                ,UT,84720-2470,Public       ,811,1056,1867,5460,3305,8765
00367900,SNOW COLLEGE                            ,UT,84627-1299,Public       ,541,359,900,3182,1077,4259
00368000,WEBER STATE UNIVERSITY                  ,UT,84408-1136,Public       ,1487,3014,4501,7702,11192,18894
00368100,WESTMINSTER COLLEGE                     ,UT,84105-3697,Private      ,252,436,688,2588,1573,4161
00402700,UTAH VALLEY UNIVERSITY                  ,UT,84058-5999,Public       ,3020,5379,8399,11455,15182,26637
00522000,SALT LAKE COMMUNITY COLLEGE             ,UT,84123-0000,Public       ,2600,5124,7724,8417,14766,23183
00732953,ITT TECHNICAL INSTITUTE                 ,UT,84123-2500,Proprietary  ,90,393,483,273,1470,1743
00943300,SHERMAN KENDALL'S ACADEMY OF BEAUTY     ,UT,84106-1836,Proprietary  ,10,21,31,26,68,94
01009800,NEUMONT UNIVERSITY                      ,UT,84095-0000,Proprietary  ,48,18,66,820,123,943
01116500,UINTAH BASIN APPLIED TECHNOLOGY CLG     ,UT,84066-0000,Public       ,5,55,60,28,131,159
01116600,BROADVIEW UNIVERSITY                    ,UT,84088-4021,Proprietary  ,75,208,283,254,744,998
02078800,SHERMAN KENDALL'S ACADEMY OF BEAUTY     ,UT,84047-0000,Proprietary  ,7,9,16,11,25,36
02115400,BRIDGERLAND APPLIED TECHNOLOGY COLLEGE  ,UT,84321-0000,Public       ,78,208,286,404,753,1157
02156600,DAVIS APPLIED TECHNOLOGY COLLEGE        ,UT,84037-0000,Public       ,125,461,586,508,1458,1966
02178500,EAGLE GATE COLLEGE                      ,UT,84123-0000,Proprietary  ,32,289,321,101,825,926
02270800,AMERITECH COLLEGE                       ,UT,84604-6927,Proprietary  ,25,105,130,87,432,519
02270802,AMERITECH COLLEGE - DRAPER              ,UT,84020-6545,Proprietary  ,24,109,133,78,494,572
02298500,EVEREST COLLEGE                         ,UT,84119-2668,Proprietary  ,6,26,32,41,231,272
02346500,OGDEN-WEBER APPLIED TECHNOLOGY COLG     ,UT,84404-0000,Public       ,145,474,619,580,1710,2290
02360800,PROVO COLLEGE                           ,UT,84601-0000,Proprietary  ,73,180,253,175,552,727
02531800,PAUL MITCHELL THE SCHOOL - PROVO        ,UT,84606-0000,Proprietary  ,29,27,56,100,90,190
02556800,PAUL MITCHELL THE SCHOOL                ,UT,84117-7204,Proprietary  ,53,156,209,159,327,486
02556801,PAUL MITCHELL THE SCHOOL                ,UT,84780-0000,Proprietary  ,10,11,21,42,57,99
02572700,EVANS HAIRSTYLING COLLEGE               ,UT,84770-0000,Proprietary  ,13,9,22,33,31,64
02572800,VISTA COLLEGE                           ,UT,84015-0000,Proprietary  ,8,164,172,30,455,485
02573100,EVANS HAIRSTYLING COLLEGE OF CEDAR CITY ,UT,84720-0000,Proprietary  ,17,10,27,40,34,74
02612200,MARINELLO SCHOOL OF BEAUTY              ,UT,84604-1585,Proprietary  ,8,28,36,35,78,113
03030600,UTAH COLLEGE OF MASSAGE THERAPY         ,UT,84111-1606,Proprietary  ,34,94,128,114,304,418
03030601,UTAH CLG OF MASSAGE THER-PROVO CMPS     ,UT,84042-0000,Proprietary  ,22,37,59,44,96,140
03082100,MYOTHERAPY COLLEGE OF UTAH              ,UT,84115-2522,Proprietary  ,9,24,33,18,76,94
03108200,FRANCOIS D. COLLEGE OF HAIR SKIN & NAILS,UT,84070-2004,Proprietary  ,6,14,20,18,33,51
03110400,HAIRITAGE HAIR ACADEMY                  ,UT,84770-5233,Proprietary  ,10,11,21,36,28,64
03339400,WESTERN GOVERNORS UNIVERSITY            ,UT,84107-2533,Private      ,620,24757,25377,2149,72717,74866
03413300,MOUNTAINLAND APPLIED TECHNOLOGY COLLEGE ,UT,84043-0000,Public       ,80,183,263,256,600,856
03463300,CAREERS UNLIMITED                       ,UT,84058-0000,Proprietary  ,10,26,36,45,142,187
03467308,MARINELLO SCHOOL OF BEAUTY - OGDEN      ,UT,84405-1501,Proprietary  ,10,31,41,42,118,160
03467309,MARINELLO SCHOOL OF BEAUTY - LAYTON     ,UT,84041-3002,Proprietary  ,13,33,46,45,135,180
03617300,HEALING MOUNTAIN MASSAGE SCHOOL         ,UT,84102-4006,Proprietary  ,17,34,51,42,135,177
03829500,SKINWORKS SCHOOL OF ADVANCED SKINCARE   ,UT,84115-0000,Proprietary  ,5,29,34,26,98,124
03838300,NIGHTINGALE COLL. SCH. OF NURSING SCH. O,UT,84403-0000,Proprietary  ,11,160,171,46,454,500
03909300,PAUL MITCHELL THE SCHOOL LOGAN          ,UT,84323-4679,Proprietary  ,21,59,80,85,122,207
03921300,CAMEO COLLEGE OF ESSENTIAL BEAUTY       ,UT,84115-0000,Proprietary  ,25,101,126,79,244,323
04054300,SOUTHWEST APPLIED TECHNOLOGY COLLEGE    ,UT,84720-6608,Public       ,29,76,105,90,201,291
04072300,AVEDA INSTITUTE PROVO                   ,UT,84604-1008,Proprietary  ,27,23,50,85,80,165
04121700,DIXIE APPLIED TECHNOLOGY COLLEGE        ,UT,84770-3025,Public       ,69,128,197,280,365,645
04145500,SKIN SCIENCE INSTITUTE (THE)            ,UT,84115-0000,Proprietary  ,14,42,56,42,126,168
04153000,RENAISSANCE ACADEMIE                    ,UT,84604-0000,Proprietary  ,8,15,23,24,55,79
04161900,MANDALYN ACADEMY                        ,UT,84003-2161,Proprietary  ,9,32,41,20,67,87
04165500,ACAYDIA SCHOOL OF AESTHETICS            ,UT,84601-0000,Proprietary  ,13,30,43,34,63,97
04169900,AMERICAN BEAUTY ACADEMY                 ,UT,84651-0000,Proprietary  ,10,19,29,28,48,76
04173200,TAYLOR ANDREWS ACADEMY OF HAIR DESIGN   ,UT,84088-6577,Proprietary  ,28,74,102,69,146,215
04173201,TAYLOR ANDREWS ACADEMY -  OREM          ,UT,84004-1872,Proprietary  ,32,35,67,91,95,186
04183000,TOP NAILS & HAIR BEAUTY SCHOOL          ,UT,84118-0000,Proprietary  ,7,33,40,20,78,98
04184200,TAYLOR ANDREWS ACADEMY-ST. GEORGE       ,UT,84790-2139,Proprietary  ,24,36,60,77,92,169
04192700,BARBER SCHOOL (THE)                     ,UT,84047-3723,Proprietary  ,4,44,48,19,125,144
04193200,ROCKY MOUNTAIN UNIVERSITY OF HEALTH PROF,UT,84606-7312,Proprietary  ,4,145,149,27,469,496
04210300,MEDSPA ACADEMIES                        ,UT,84095-3519,Proprietary  ,12,43,55,50,128,178
04211500,BEAUTIFUL YOU SCHOOL OF NAIL TECHNOLOGY ,UT,84720-8360,Proprietary  ,6,7,13,18,28,46
04215700,COLE HOLLAND COLLEGE                    ,UT,84102-2959,Proprietary  ,6,16,22,19,54,73
04216800,BONNIE JOSEPH ACADEMY OF COSMETOLOGY & B,UT,84032-2044,Proprietary  ,0,3,3,2,10,12
04218300,MIDWIVES COLLEGE OF UTAH                ,UT,84106-2671,Private      ,9,56,65,32,273,305
00368200,BENNINGTON COLLEGE                      ,VT,05201-6001,Private      ,14,13,27,987,152,1139
00368300,CASTLETON STATE COLLEGE                 ,VT,05735-0000,Public       ,198,63,261,2850,405,3255
00368400,CHAMPLAIN COLLEGE                       ,VT,05401-3950,Private      ,160,500,660,4260,1789,6049
00368500,COLLEGE OF ST JOSEPH                    ,VT,05701-3899,Private      ,29,36,65,248,163,411
00368600,GODDARD COLLEGE                         ,VT,05667-0000,Private      ,11,119,130,59,632,691
00368700,GREEN MOUNTAIN COLLEGE                  ,VT,05764-1199,Private      ,73,100,173,757,302,1059
00368800,JOHNSON STATE COLLEGE                   ,VT,05656-9898,Public       ,115,184,299,1250,801,2051
00368900,LYNDON STATE COLLEGE                    ,VT,05851-0919,Public       ,99,46,145,1698,295,1993
00369000,MARLBORO COLLEGE                        ,VT,05344-0300,Private      ,5,20,25,293,94,387
00369100,MIDDLEBURY COLLEGE                      ,VT,05753-0000,Private      ,67,26,93,4274,531,4805
00369200,NORWICH UNIVERSITY                      ,VT,05663-1035,Private      ,147,434,581,3053,1466,4519
00369300,SOUTHERN VERMONT COLLEGE                ,VT,05201-6002,Private      ,42,26,68,568,149,717
00369400,ST MICHAELS COLLEGE                     ,VT,05439-0001,Private      ,74,44,118,4055,175,4230
00369600,UNIVERSITY OF VERMONT                   ,VT,05405-0160,Public       ,217,237,454,19540,2936,22476
00369700,VERMONT COLLEGE OF FINE ARTS            ,VT,05602-3128,Private      ,1,78,79,12,357,369
00369800,VERMONT TECHNICAL COLLEGE               ,VT,05061-0000,Public       ,110,130,240,1009,819,1828
00865800,O'BRIENS AVEDA INSTITUTE                ,VT,05403-7747,Proprietary  ,14,20,34,55,94,149
00886000,SIT                                     ,VT,05301-4801,Private      ,4,31,35,187,407,594
01116700,COMMUNITY COLLEGE OF VERMONT            ,VT,05676-0000,Public       ,505,1189,1694,1488,3313,4801
01193400,VERMONT LAW SCHOOL                      ,VT,05068-0000,Private      ,0,100,100,6,846,852
01218300,BURLINGTON COLLEGE                      ,VT,05401-8477,Private      ,18,37,55,179,140,319
02143500,STERLING COLLEGE                        ,VT,05827-0000,Private      ,11,13,24,143,65,208
02254000,NEW ENGLAND CULINARY INSTITUTE          ,VT,05602-0000,Proprietary  ,23,32,55,283,186,469
02532600,LANDMARK COLLEGE                        ,VT,05346-0000,Private      ,34,21,55,441,127,568
04146900,ADVANCED WELDING INSTITUTE              ,VT,05403-0000,Proprietary  ,14,9,23,52,33,85
00392800,CASPER COLLEGE                          ,WY,82601-4612,Public       ,248,417,665,1275,1316,2591
00392900,EASTERN WYOMING COLLEGE                 ,WY,82240-1603,Public       ,86,96,182,421,274,695
00393000,SHERIDAN COLLEGE                        ,WY,82801-9133,Public       ,207,337,544,986,983,1969
00393100,NORTHWEST COLLEGE                       ,WY,82435-1895,Public       ,129,160,289,737,477,1214
00393200,UNIVERSITY OF WYOMING                   ,WY,82071-2000,Public       ,907,965,1872,7202,4218,11420
00393300,WESTERN WYOMING COMMUNITY COLLEGE       ,WY,82902-0000,Public       ,197,241,438,885,887,1772
00728900,CENTRAL WYOMING COLLEGE                 ,WY,82501-0000,Public       ,84,214,298,514,651,1165
00915700,WYOTECH                                 ,WY,82072-9519,Private      ,83,129,212,545,427,972
00925900,LARAMIE COUNTY COMMUNITY CLG            ,WY,82007-3299,Public       ,323,598,921,1584,2118,3702
02211900,CHEEKS INTERNATIONAL ACDMY              ,WY,82001-0000,Proprietary  ,9,51,60,27,128,155
00393500,UNIV OF GUAM                            ,GU,96923-0000,Public       ,642,533,1175,2344,1687,4031
01536100,GUAM COMMUNITY COLLEGE                  ,GU,96921-0000,Public       ,383,338,721,1470,1360,2830
03438300,PACIFIC ISLANDS UNIVERSITY              ,GU,96913-2619,Private      ,42,35,77,69,103,172
00393600,PONTIFICAL CATHOLIC UNIV OF PR          ,PR,00717-0777,Private      ,1551,2470,4021,6149,4673,10822
00393700,UNIVERSITY OF THE SACRED HEART          ,PR,00914-0383,Private      ,798,825,1623,3146,1893,5039
00393800,INTER-AMER UNIV PR-CNTRL ADMN           ,PR,00936-0000,Private      ,1105,2259,3364,3172,4774,7946
00393803,INTER AMERICAN UNIVERSITY OF PUERTO RICO,PR,00683-0000,Private      ,1034,727,1761,3669,1580,5249
00393900,INTER AMERICAN UNIVERSITY OF PUERTO RICO,PR,00605-2000,Private      ,932,792,1724,3300,1613,4913
00394000,INTER AMERICAN UNIVERSITY OF PUERTO RICO,PR,00919-1293,Private      ,283,553,836,936,1086,2022
00394100,UNIVERSIDAD DEL ESTE                    ,PR,00984-2010,Private      ,2209,3463,5672,7233,7270,14503
00394200,UNIVERSITY OF PR-CENTRAL ADMINISTRATION ,PR,00936-4984,Public       ,56,51,107,390,180,570
00394300,UNIVERSITY OF PUERTO RICO - HUMACAO UNIV,PR,00791-4300,Public       ,311,103,414,3346,427,3773
00394400,UNIVERSITY OF PUERTO RICO - MAYAGUEZ    ,PR,00680-0000,Public       ,824,464,1288,9306,1833,11139
00501900,UNIV ADVENTISTA DE LAS ANTILLAS         ,PR,00681-0118,Private      ,259,190,449,974,522,1496
00502200,BAYAMON CENTRAL UNIVERSITY              ,PR,00960-0000,Private      ,200,348,548,971,912,1883
00502600,INTER AMERICAN UNIVERSITY OF PUERTO RICO,PR,00614-4050,Private      ,779,859,1638,3064,1958,5022
00502700,INTER AMERICAN UNIVERSITY OF PUERTO RICO,PR,00794-0517,Private      ,432,268,700,1654,614,2268
00502800,INTER AMERICAN UNIVERSITY OF PUERTO RICO,PR,00957-6257,Private      ,1035,590,1625,3896,1411,5307
00502900,INTER AMERICAN UNIVERSITY OF PUERTO RICO,PR,00715-1612,Private      ,971,1003,1974,3644,2240,5884
00710800,UNIVERSITY OF PUERTO RICO - RIO PIEDRAS ,PR,00931-3300,Public       ,1044,684,1728,9487,3025,12512
00720600,UNIVERSITY OF PUERTO RICO - CAYEY UNIVER,PR,00736-5534,Public       ,134,40,174,3303,335,3638
00722800,UNIVERSITY OF PUERTO RICO - ARECIBO     ,PR,00614-4010,Public       ,257,100,357,3793,512,4305
00890200,COLUMBIA CENTRO UNIVERSITARIO           ,PR,00726-0000,Proprietary  ,329,386,715,1164,988,2152
00965200,"UNIVERSITY OF PUERTO RICO, PONCE TECH UN",PR,00716-0000,Public       ,256,93,349,3465,419,3884
01056700,COLEGIO TECNOLOGICO DE SAN JUAN         ,PR,00918-2973,Public       ,216,255,471,758,795,1553
01072400,CARLOS ALBIZU UNIVERSITY                ,PR,00902-3711,Private      ,51,257,308,234,1290,1524
01081900,CONSERVATORIO DE MUSICA DE PUERTO RICO  ,PR,00907-3373,Public       ,69,48,117,306,111,417
01092200,UNIVERSITY OF PUERTO RICO - UTUADO      ,PR,00641-2500,Public       ,226,42,268,1460,180,1640
01097500,UNIVERSITY OF PUERTO RICO BAYAMON TECHNI,PR,00959-1911,Public       ,226,93,319,4291,572,4863
01120300,RYDER MEMORIAL HOSP SCH OF NURSING      ,PR,00792-0000,Private      ,3,3,6,13,9,22
01171900,UNIVERSIDAD DEL TURABO                  ,PR,00778-0000,Private      ,2448,4314,6762,8616,9818,18434
01194000,ICPR JUNIOR COLLEGE                     ,PR,00919-0000,Proprietary  ,508,653,1161,1107,1279,2386
01194100,AMERICAN UNIVERSITY OF PUERTO RICO      ,PR,00960-2037,Private      ,139,150,289,573,347,920
01194101,AMERICAN UNIVERSITY OF PUERTO RICO      ,PR,00674-0000,Private      ,175,177,352,644,392,1036
01212300,"UNIVERSITY OF PUERTO RICO, AGUADILLA REG",PR,00604-0160,Public       ,232,109,341,2903,435,3338
01252500,CARIBBEAN UNIVERSITY                    ,PR,00960-0493,Private      ,527,884,1411,2279,2252,4531
02063100,MBTI BUSINESS TRNG INSTITUTE            ,PR,00907-3917,Proprietary  ,536,1165,1701,1029,2604,3633
02100000,POLYTECHNIC UNIVERSITY OF PR            ,PR,00917-0000,Private      ,280,557,837,2047,2061,4108
02163300,UNIVERSIDAD CENTRAL DEL CARIBE          ,PR,00960-0000,Private      ,43,168,211,142,428,570
02165100,EDP COLLEGE OF PUERTO RICO              ,PR,00919-0000,Private      ,457,726,1183,1053,1581,2634
02166000,CENTER FOR ADVANCED STUDIES OF PUER     ,PR,00902-0000,Private      ,3,141,144,11,194,205
02166400,INSTITUTO DE BANCA Y COMERCIO           ,PR,00925-0000,Proprietary  ,2435,3386,5821,6302,9152,15454
02170300,INST EDUC TECNIA OCUP LA REINA          ,PR,00674-0000,Proprietary  ,146,160,306,173,200,373
02189100,CENTRO DE ESTUDIOS MULTIDISCIPLIN       ,PR,00926-0000,Proprietary  ,671,867,1538,1240,1386,2626
02189300,EMMA'S BEAUTY ACADEMY                   ,PR,00680-0000,Proprietary  ,77,26,103,232,83,315
02195400,MODERN HAIRSTYLING INSTITUTE            ,PR,00961-0000,Proprietary  ,348,159,507,595,263,858
02195500,MODERN HAIRSTYLING INSTITUTE            ,PR,00612-0000,Proprietary  ,1,3,4,10,8,18
02195800,LICEO E ARTE Y TECNOLGIA                ,PR,00919-0000,Proprietary  ,179,219,398,802,698,1500
02195900,MODERN HAIRSTYLING INSTITUTE            ,PR,00980-0000,Proprietary  ,5,3,8,11,7,18
02234900,ANTILLES SCHOOL OF TECH CAREERS         ,PR,00909-3006,Proprietary  ,112,223,335,255,388,643
02241904,COMMONWEALTH OF PR DEPT OF EDUC - ITPR R,PR,00655-0000,Public       ,163,116,279,457,300,757
02241907,COMMONWEALTH OF PR DEPT OF EDUC - ITPR R,PR,00928-0000,Public       ,172,134,306,525,317,842
02241908,COMMONWEALTH OF PR DEPT OF EDUC - ITPR R,PR,00732-0000,Public       ,103,84,187,414,242,656
02241909,COMMONWEALTH OF PR DEPT OF EDUC - TROQUE,PR,00959-0000,Public       ,5,3,8,73,14,87
02241910,COMMONWEALTH OF PR DEPT OF EDUC - ITPR R,PR,00701-1091,Public       ,31,9,40,599,209,808
02260600,NATIONAL COLLEGE OF BUSINESS & TECH     ,PR,00960-2036,Proprietary  ,973,2777,3750,3761,8719,12480
02260800,HUERTAS COLLEGE                         ,PR,00726-0000,Proprietary  ,313,472,785,773,837,1610
02282700,INTER AMERICAN UNIVERSITY OF PUERTO RICO,PR,00785-4004,Private      ,372,466,838,1221,994,2215
02282800,INTER AMERICAN UNIVERSITY OF PUERTO RICO,PR,00738-7003,Private      ,601,473,1074,1514,882,2396
02297700,AUTOMECA TECHNICAL COLLEGE              ,PR,00957-0000,Proprietary  ,504,350,854,1277,788,2065
02303800,AMERICAN EDUCATIONAL COLLEGE            ,PR,00961-0000,Proprietary  ,265,346,611,373,477,850
02335500,COLEGIO BIBLICO PENTECOSTAL DE PR       ,PR,00978-0000,Private      ,5,125,130,16,240,256
02340600,HUMACAO COMMUNITY COLLEGE               ,PR,00792-0000,Private      ,173,194,367,282,340,622
02343600,INSTITUTE OF BEAUTY CAREERS             ,PR,00613-0000,Proprietary  ,196,130,326,314,202,516
02460000,UNIVERSITY OF PUERTO RICO - MEDICAL SCIE,PR,00936-0000,Public       ,43,205,248,582,1398,1980
02482400,PONCE SCHOOL OF MEDICINE AND HEALTH SCIE,PR,00716-2347,Proprietary  ,3,116,119,47,856,903
02504500,INSTITUCION CHAVIANO DE MAYAGUEZ        ,PR,00708-0000,Proprietary  ,7,18,25,9,21,30
02505400,ATLANTIC COLLEGE                        ,PR,00970-0000,Private      ,645,198,843,1293,338,1631
02534900,PONCE PARAMEDICAL COLLEGE (POPAC)       ,PR,00731-0000,Proprietary  ,633,520,1153,1231,979,2210
02552300,COLEGIO MAYOR DE TECHNOLOGIA            ,PR,00714-0000,Proprietary  ,68,72,140,193,198,391
02562500,INTERNATIONAL TECHNICAL COLLEGE         ,PR,00918-0000,Proprietary  ,18,35,53,43,89,132
02569400,ESCUELA DE ARTES PLASTICAS              ,PR,00902-1112,Public       ,17,14,31,465,127,592
02570400,EDUCATIONAL TECHNICAL COLLEGE           ,PR,00925-3404,Proprietary  ,210,261,471,399,530,929
02576100,ESCUELA TECNICA DE ELECTRICIDAD         ,PR,00731-0000,Proprietary  ,61,101,162,185,210,395
02587500,UNIVERSIDAD METROPOLITANA               ,PR,00928-0000,Private      ,2153,4034,6187,6995,8357,15352
02588600,SEMINARIO EVANGELICO DE PUERTO RICO     ,PR,00925-0000,Private      ,0,34,34,2,61,63
02593700,HISPANIC AMERICAN COLLEGE               ,PR,00725-0000,Proprietary  ,118,136,254,174,195,369
03016000,UNIVERSITY OF PUERTO RICO CAROLINA REGIO,PR,00985-0000,Public       ,328,135,463,3498,556,4054
03021900,EDIC COLLEGE                            ,PR,00726-0000,Proprietary  ,495,512,1007,1353,1268,2621
03025500,MECH TECH COLLEGE                       ,PR,00725-6118,Proprietary  ,925,696,1621,2325,1355,3680
03025900,"LICEO DE ARTE, DISENOS Y COMERCIO       ",PR,00726-0000,Proprietary  ,82,130,212,200,321,521
03029700,"UNIVERSAL TECHNOLOGY CLG OF PR, INC     ",PR,00605-0000,Private      ,149,227,376,438,711,1149
03061900,COLEGIO TECHNOLOGICO Y COMERCIAL        ,PR,00602-0960,Proprietary  ,24,17,41,26,18,44
03068400,STAR BEAUTY ACADEMY                     ,PR,00961-6312,Proprietary  ,26,30,56,30,36,66
03070500,D'MART INSTITUTE                        ,PR,00794-3517,Proprietary  ,137,165,302,502,495,997
03075600,EMMA'S BEAUTY ACADEMY                   ,PR,00795-0000,Proprietary  ,135,93,228,261,159,420
03085700,PROFESSIONAL TECHNICAL INSTITUTION      ,PR,00960-7061,Proprietary  ,85,123,208,208,266,474
03104400,PROFESSIONAL ELECTRIC SCHOOL            ,PR,00674-1797,Proprietary  ,15,22,37,39,28,67
03106900,ESCUELA DE PERITOS ELECTRICITAS         ,PR,00662-0457,Proprietary  ,13,15,28,42,40,82
03112100,JOHN DEWEY COLLEGE                      ,PR,00915-9538,Private      ,524,1276,1800,1045,2327,3372
03112101,JOHN DEWEY COLLEGE                      ,PR,00986-0000,Private      ,94,189,283,211,465,676
03112102,JOHN DEWEY COLLEGE-BAYAMON CAMPUS       ,PR,00959-0000,Private      ,58,163,221,84,206,290
03112105,JOHN DEWEY COLLEGE - FAJARDO BRANCH     ,PR,00738-0738,Private      ,33,103,136,123,289,412
03112106,JOHN DEWEY COLLEGE - ARROYO BRANCH      ,PR,00714-0714,Private      ,15,37,52,49,94,143
03112107,JOHN DEWEY COLLEGE - JUANA DIAZ BRANCH  ,PR,00795-0000,Private      ,31,44,75,137,181,318
03112108,JOHN DEWEY COLLEGE - HATILLO CAMPUS     ,PR,00659-0000,Private      ,23,43,66,45,91,136
03112109,JOHN DEWEY COLLEGE - MANATI             ,PR,00674-0000,Private      ,119,221,340,285,418,703
03112110,DEWEY UNIVERSITY - MAYAGUEZ             ,PR,00682-0000,Private      ,40,58,98,56,84,140
03115900,TRINITY COLLEGE OF PUERTO RICO          ,PR,00734-0000,Private      ,65,95,160,116,161,277
03122500,ACADEMIA SERRANT INC.                   ,PR,00717-1568,Proprietary  ,118,114,232,229,207,436
03123100,GLOBELLE TECHNICAL INSTITUTE            ,PR,00693-4218,Proprietary  ,8,14,22,37,49,86
03124200,NOVA COLLEGE DE PUERTO RICO             ,PR,00960-4016,Proprietary  ,61,105,166,119,217,336
03157600,"COLEGIO DE CINEMATOGRAFIA, ARTES Y TELEV",PR,00961-6345,Proprietary  ,319,162,481,638,333,971
03177300,SAN JUAN BAUTISTA SCH OF MEDICINE       ,PR,00726-0000,Private      ,10,37,47,35,345,380
03336300,CENTURY COLLEGE                         ,PR,00603-0000,Proprietary  ,22,52,74,105,174,279
03414300,MONTECLARO                              ,PR,00745-9612,Private      ,7,6,13,17,15,32
03452300,INSTITUTO PRE-VOCACIONAL E INDUSTRI     ,PR,00613-1800,Private      ,52,151,203,57,156,213
03469300,IVAEM COLLEGE                           ,PR,00725-0000,Proprietary  ,21,41,62,78,75,153
03531300,UNIVERSIDAD PENTECOSTAL MIZPA           ,PR,00928-0966,Private      ,5,101,106,25,286,311
03544300,ATENAS COLLEGE                          ,PR,00674-0000,Private      ,243,224,467,1013,640,1653
03552300,LESTON COLLEGE                          ,PR,00961-6309,Proprietary  ,37,76,113,41,84,125
03608300,CARIBBEAN FORENSIC & TECHNICAL COLL     ,PR,00926-0000,Proprietary  ,20,25,45,31,48,79
03638300,ROSSLYN TRAINING ACADEMY OF COSMETOLOGY ,PR,00602-3225,Proprietary  ,15,23,38,17,28,45
03735400,"CHARLIES GUARD,DETECTIVE BUREAU&ACA     ",PR,00605-0000,Proprietary  ,19,33,52,23,38,61
03751300,ESCUELA HOTELERA DE SAN JUAN            ,PR,00917-0091,Proprietary  ,218,170,388,724,415,1139
03758300,BAYAMON COMMUNITY COLLEGE               ,PR,00960-0000,Proprietary  ,39,175,214,54,231,285
03781400,INDUSTRIAL TECHNICAL COLLEGE            ,PR,00792-0000,Proprietary  ,53,71,124,112,153,265
03785300,J.G. GUAYNABO TECHNICAL COLLEGE         ,PR,00960-0000,Proprietary  ,28,49,77,75,165,240
03800300,COLEGIO TECNICO DE ELECTRICIDAD GALLOSA ,PR,00602-0000,Proprietary  ,9,25,34,12,27,39
03800400,INSTITUTE OF BEAUTY OCCUPATIONS AND TECH,PR,00676-5071,Proprietary  ,19,30,49,68,106,174
03849300,AGUADILLA TECHNICAL COLLEGE             ,PR,00603-0000,Proprietary  ,20,25,45,51,69,120
03965400,MYRANGEL BEAUTY INSTITUTE               ,PR,00754-3917,Proprietary  ,41,74,115,90,108,198
04107300,CARIB TECHNOLOGICAL INSTITUTE           ,PR,00960-0000,Proprietary  ,0,0,0,4,3,7
04117200,INSTITUTO EDUCATIVO PREMIER             ,PR,00731-0000,Proprietary  ,123,179,302,198,250,448
04131600,LIBERTY TECHNICAL COLLEGE               ,PR,00737-1298,Proprietary  ,52,73,125,97,134,231
04164300,GLOBAL INSTITUTE                        ,PR,00725-6485,Proprietary  ,10,18,28,14,21,35
04176000,AMERICAN TECHNICAL INSTITUTE            ,PR,00957-0000,Proprietary  ,9,9,18,28,44,72
04240900,PPG TECHNICAL COLLEGE                   ,PR,00726-3164,Proprietary  ,59,65,124,151,114,265
04250900,INTER AMERICAN UNIVERSITY OF PUERTO RICO,PR,00936-8351,Private      ,3,104,107,26,340,366
04251000,INTER AMERICAN UNIVERSITY OF PUERTO RICO,PR,00957-6257,Private      ,1,0,1,1,0,1
04254200,INTER AMERICAN UNIVERSITY OF PUERTO RICO,PR,00683-9801,Private      ,0,6,6,0,6,6
00394600,UNIVERSITY OF THE VIRGIN ISLANDS        ,VI,00802-9990,Public       ,162,168,330,1311,716,2027
00394601,UNIV OF THE VIRGIN ISLANDS-ST CROIX     ,VI,00850-0000,Public       ,102,129,231,554,581,1135
00667700,MCGILL UNIVERSITY                       ,CN,00000-0000,Public       ,78,49,127,1447,342,1789
00667900,QUEEN'S UNIVERSITY AT KINGSTON          ,CN,00000-0000,Public       ,13,5,18,100,28,128
00668100,ST FRANCIS XAVIER UNIVERSITY            ,CN,00000-0000,Public       ,4,1,5,24,4,28
00668200,ST THOMAS UNIVERSITY                    ,CN,00000-0000,Public       ,3,3,6,24,9,33
00668300,UNIVERSITY OF GUELPH                    ,CN,00000-0000,Public       ,5,13,18,44,72,116
00668400,UNIVERSITY OF MANITOBA                  ,CN,00000-0000,Public       ,16,7,23,82,28,110
00668500,UNIVERSITY OF NEW BRUNSWICK (THE)       ,CN,00000-0000,Public       ,4,2,6,30,10,40
00668600,UNIVERSITY OF OTTAWA                    ,CN,00000-0000,Public       ,5,15,20,48,53,101
00668800,UNIVERSITY OF TORONTO                   ,CN,00000-0000,Public       ,29,40,69,441,314,755
00668900,UNIVERSITY OF WINDSOR                   ,CN,00000-0000,Public       ,2,13,15,21,32,53
00683700,UNIVERSITE LAVAL                        ,CN,00000-0000,Public       ,2,1,3,10,20,30
00683800,DALHOUSIE UNIVERSITY                    ,CN,00000-0000,Public       ,8,16,24,109,69,178
00685200,BISHOP'S UNIVERSITY                     ,CN,00000-0000,Private      ,9,3,12,50,10,60
00767900,YORK UNIVERSITY                         ,CN,00000-0000,Public       ,13,26,39,81,98,179
00787400,UNIVERSITY AT CALGARY (THE)             ,CN,00000-0000,Public       ,6,15,21,55,65,120
00814800,UNIVERSITY OF WINNIPEG                  ,CN,00000-0000,Public       ,2,3,5,18,13,31
00836300,MOUNT SAINT VINCENT UNIVERSITY          ,CN,00000-0000,Public       ,0,3,3,6,6,12
00836400,SAINT MARY'S UNIVERSITY                 ,CN,00000-0000,Public       ,4,2,6,22,13,35
00836500,CONCORDIA UNIVERSITY - SIR GEORGE W     ,CN,00000-0000,Public       ,27,27,54,322,148,470
00836600,UNIVERSITE DE MONTREAL                  ,CN,00000-0000,Public       ,5,16,21,22,68,90
00836800,CARLETON UNIVERSITY                     ,CN,00000-0000,Public       ,3,7,10,62,38,100
00836900,UNIVERSITY OF BRITISH COLUMBIA          ,CN,00000-0000,Public       ,70,68,138,879,375,1254
00837000,"SAFA, UNIVERSITY OF VICTORIA            ",CN,00000-0000,Public       ,11,17,28,176,80,256
00844400,SIMON FRASER UNIVERSITY                 ,CN,00000-0000,Public       ,6,10,16,133,82,215
00844600,UNIVERSITY OF WESTERN ONTARIO (THE)     ,CN,00000-0000,Public       ,2,14,16,46,59,105
00844900,ACADIA UNIVERSITY                       ,CN,00000-0000,Public       ,5,8,13,24,19,43
00858200,WILFRID LAURIER UNIVERSITY              ,CN,00000-0000,Public       ,2,3,5,15,16,31
00891300,LAKEHEAD UNIVERSITY                     ,CN,00000-0000,Public       ,1,0,1,3,6,9
00936700,UNIVERSITY OF PRINCE EDWARD ISLAND      ,CN,00000-0000,Public       ,3,18,21,17,93,110
00942100,BRANDON UNIVERSITY                      ,CN,00000-0000,Public       ,3,5,8,10,13,23
00948600,TRINITY WESTERN UNIVERSITY              ,CN,00000-0000,Private      ,6,6,12,124,45,169
00950000,MEMORIAL UNIVERSITY OF NEWFOUNDLAND     ,CN,00000-0000,Public       ,1,7,8,23,35,58
00950100,UNIVERSITY OF KING'S COLLEGE            ,CN,00000-0000,Public       ,2,0,2,21,4,25
00950300,MOUNT ALLISON UNIVERSITY                ,CN,00000-0000,Public       ,7,0,7,40,5,45
01022100,SAINT PAUL UNIVERSITY                   ,CN,00000-0000,Public       ,0,2,2,5,7,12
01045800,SHERIDAN COLLEGE OF APPLIED ARTS AN     ,CN,00000-0000,Public       ,5,4,9,58,22,80
01067500,REGENT COLLEGE                          ,CN,00000-0000,Private      ,0,10,10,4,54,58
01072000,RYERSON UNIVERSITY                      ,CN,00000-0000,Public       ,7,6,13,66,51,117
01172200,BRIERCREST BIBLE COLLEGE                ,CN,00000-0000,Private      ,2,2,4,7,3,10
01222800,HUMBER COLLEGE INSTITUTE OF TECHNOLOGY A,CN,00000-0000,Public       ,3,11,14,37,41,78
01227400,PROVIDENCE COLLEGE                      ,CN,00000-0000,Private      ,1,2,3,4,10,14
02102100,KINGSWOOD UNIVERSITY                    ,CN,00000-0000,Private      ,13,4,17,40,10,50
02116600,CANADIAN MEMORIAL CHIROPRACTIC COLL     ,CN,00000-0000,Private      ,0,2,2,0,4,4
02167000,PRAIRIE BIBLE INST                      ,CN,00000-0000,Private      ,2,2,4,17,3,20
02201100,COLUMBIA BIBLE COLLEGE                  ,CN,00000-0000,Private      ,1,4,5,10,12,22
02216400,TYNDALE COLLEGE & SEMINARY              ,CN,00000-0000,Private      ,1,3,4,8,14,22
02219200,UNIVERSITY OF SASKATCHEWAN              ,CN,00000-0000,Public       ,4,6,10,18,22,40
02324900,EMMANUEL BIBLE COLLEGE                  ,CN,00000-0000,Private      ,0,1,1,2,5,7
02338800,EMILY CARR UNIVERSITY OF ART AND DESIGN ,CN,00000-0000,Public       ,9,6,15,68,34,102
02577200,SALVATION ARMY WM & CATHERINE BOOTH     ,CN,00000-0000,Private      ,0,1,1,3,1,4
02593800,CONCORDIA UNIVERSITY COLLEGE            ,CN,00000-0000,Private      ,0,4,4,12,17,29
02611900,THE KING'S UNIVERSITY COLLEGE           ,CN,00000-0000,Private      ,2,3,5,5,9,14
03033800,UNIVERSITY COLLEGE OF CAPE BRETON       ,CN,00000-0000,Public       ,1,1,2,6,1,7
03078300,VANCOUVER SCHOOL OF THEOLOGY            ,CN,00000-0000,Private      ,0,1,1,1,4,5
03273300,CANADIAN COLLEGE OF NATUROPATHIC ME     ,CN,00000-0000,Private      ,1,14,15,7,43,50
03298300,ALBERTA COLLEGE OF ART & DESIGN         ,CN,00000-0000,Public       ,5,4,9,30,23,53
03332500,KWANTLEN UNIVERSITY COLLEGE             ,CN,00000-0000,Public       ,3,4,7,8,17,25
03335400,CANADIAN UNIVERSITY COLLEGE             ,CN,00000-0000,Private      ,4,5,9,34,16,50
03339300,ST. STEPHENS UNIVERSITY                 ,CN,00000-0000,Private      ,0,0,0,2,2,4
03348500,REDEEMER UNIVERSITY COLLEGE             ,CN,00000-0000,Private      ,3,2,5,7,7,14
03420300,HOLLAND COLLEGE                         ,CN,00000-0000,Public       ,2,1,3,11,3,14
03560400,NIAGARA COLLEGE-WELLAND CAMPUS          ,CN,00000-0000,Public       ,1,2,3,13,18,31
03613300,UNIV OF NORTHERN BRITISH COLUMBIA       ,CN,00000-0000,Public       ,2,3,5,12,10,22
03644400,CANADIAN MENNONITE UNIVERSITY           ,CN,00000-0000,Private      ,0,3,3,2,4,6
03846300,PACIFIC LIFE BIBLE COLLEGE              ,CN,00000-0000,Private      ,3,5,8,10,10,20
03847300,CRANDALL UNIVERSITY                     ,CN,00000-0000,Private      ,1,0,1,3,2,5
04075300,QUEST UNIVERSITY CANADA                 ,CN,00000-0000,Private      ,11,1,12,184,16,200
04123100,ATLANTIC SCHOOL OF THEOLOGY             ,CN,00000-0000,Public       ,0,4,4,2,9,11
04156700,AMBROSE UNIVERSITY COLLEGE              ,CN,00000-0000,Private      ,2,4,6,9,17,26
00814700,UNIVERSIDAD AUTONOMA DE GUADALAJARA     ,MX,00000-0000,Private      ,3,72,75,60,928,988
01041800,INST TEC Y DE ESTSUPER DE MONTERRE      ,MX,00000-0000,Private      ,3,12,15,64,59,123
01067600,UNIVERSIDAD DE MONTERREY                ,MX,00000-0000,Private      ,3,5,8,29,22,51
01302100,"UNIVERSIDAD DEL NORESTE, A.C.           ",MX,00000-0000,Private      ,2,1,3,7,15,22
02053300,CENTRO DE ESTUDIOS UNIVERSITARIOS D     ,MX,00000-0000,Private      ,2,16,18,19,46,65
03776500,"UNIVERSIDAD DE LA SALLE BAJIO, A.C.     ",MX,00000-0000,Private      ,1,24,25,5,65,70
04183900,CETYS UNIVERSIDAD                       ,MX,00000-0000,Private      ,18,28,46,125,93,218
01001000,AMERICAN SAMOA CMNTY COLLEGE            ,AS,96799-2609,Public       ,563,172,735,928,318,1246
01034300,COLLEGE OF MICRONESIA - FSM             ,FM,96941-0159,Public       ,999,525,1524,1511,708,2219
01100900,PALAU COMMUNITY COLLEGE                 ,PW,96940-0009,Public       ,173,70,243,603,235,838
03022400,COLLEGE OF THE MARSHALL ISLANDS         ,MH,96960-1258,Public       ,357,187,544,404,252,656
03033000,NORTHERN MARIANAS COLLEGE               ,MP,96950-0000,Public       ,244,116,360,803,376,1179
